n_clusters,n_singletons,n_non_singletons,n_seq_non_singletons,i_subsample_step,curr_subsample_step,n_new_clusters,n_new_samples,n_new_clusters_per_sample,n_new_seq_non_singleton,n_new_seq_non_singleton_per_sample,n_new_clusters_non_singleton,n_new_clusters_non_singleton_per_sample,i_subsample
100,100,0,0,1,100,NA,NA,NA,NA,NA,NA,NA,1
200,200,0,0,2,200,100,100,1,0,0,0,0,1
299,298,1,2,3,300,99,100,0.99,2,0.02,1,0.01,1
398,396,2,4,4,400,99,100,0.99,2,0.02,1,0.01,1
496,492,4,8,5,500,98,100,0.98,4,0.04,2,0.02,1
595,590,5,10,6,600,99,100,0.99,2,0.02,1,0.01,1
692,684,8,16,7,700,97,100,0.97,6,0.06,3,0.03,1
790,780,10,20,8,800,98,100,0.98,4,0.04,2,0.02,1
889,878,11,22,9,900,99,100,0.99,2,0.02,1,0.01,1
984,969,15,31,10,1000,95,100,0.95,9,0.09,4,0.04,1
1945,1903,42,97,11,2000,961,1000,0.961,66,0.066,27,0.027,1
2871,2774,97,226,12,3000,926,1000,0.926,129,0.129,55,0.055,1
3785,3626,159,374,13,4000,914,1000,0.914,148,0.148,62,0.062,1
4688,4471,217,529,14,5000,903,1000,0.903,155,0.155,58,0.058,1
5550,5250,300,750,15,6000,862,1000,0.862,221,0.221,83,0.083,1
6433,6052,381,948,16,7000,883,1000,0.883,198,0.198,81,0.081,1
7295,6820,475,1180,17,8000,862,1000,0.862,232,0.232,94,0.094,1
8147,7580,567,1420,18,9000,852,1000,0.852,240,0.24,92,0.092,1
8974,8297,677,1703,19,10000,827,1000,0.827,283,0.283,110,0.11,1
9807,9033,774,1967,20,11000,833,1000,0.833,264,0.264,97,0.097,1
10607,9723,884,2277,21,12000,800,1000,0.8,310,0.31,110,0.11,1
11415,10421,994,2579,22,13000,808,1000,0.808,302,0.302,110,0.11,1
12208,11095,1113,2905,23,14000,793,1000,0.793,326,0.326,119,0.119,1
13007,11770,1237,3230,24,15000,799,1000,0.799,325,0.325,124,0.124,1
13808,12480,1328,3520,25,16000,801,1000,0.801,290,0.29,91,0.091,1
14620,13186,1434,3814,26,17000,812,1000,0.812,294,0.294,106,0.106,1
15394,13835,1559,4165,27,18000,774,1000,0.774,351,0.351,125,0.125,1
16147,14450,1697,4550,28,19000,753,1000,0.753,385,0.385,138,0.138,1
16894,15051,1843,4949,29,20000,747,1000,0.747,399,0.399,146,0.146,1
17647,15663,1984,5337,30,21000,753,1000,0.753,388,0.388,141,0.141,1
18383,16258,2125,5742,31,22000,736,1000,0.736,405,0.405,141,0.141,1
19139,16881,2258,6119,32,23000,756,1000,0.756,377,0.377,133,0.133,1
19870,17481,2389,6519,33,24000,731,1000,0.731,400,0.4,131,0.131,1
20595,18063,2532,6937,34,25000,725,1000,0.725,418,0.418,143,0.143,1
21320,18651,2669,7349,35,26000,725,1000,0.725,412,0.412,137,0.137,1
22039,19220,2819,7780,36,27000,719,1000,0.719,431,0.431,150,0.15,1
22766,19808,2958,8192,37,28000,727,1000,0.727,412,0.412,139,0.139,1
23484,20394,3090,8606,38,29000,718,1000,0.718,414,0.414,132,0.132,1
24209,20981,3228,9019,39,30000,725,1000,0.725,413,0.413,138,0.138,1
24898,21544,3354,9456,40,31000,689,1000,0.689,437,0.437,126,0.126,1
25575,22055,3520,9945,41,32000,677,1000,0.677,489,0.489,166,0.166,1
26252,22565,3687,10435,42,33000,677,1000,0.677,490,0.49,167,0.167,1
26949,23108,3841,10892,43,34000,697,1000,0.697,457,0.457,154,0.154,1
27617,23631,3986,11369,44,35000,668,1000,0.668,477,0.477,145,0.145,1
28287,24143,4144,11857,45,36000,670,1000,0.67,488,0.488,158,0.158,1
28969,24680,4289,12320,46,37000,682,1000,0.682,463,0.463,145,0.145,1
29608,25154,4454,12846,47,38000,639,1000,0.639,526,0.526,165,0.165,1
30280,25685,4595,13315,48,39000,672,1000,0.672,469,0.469,141,0.141,1
30932,26186,4746,13814,49,40000,652,1000,0.652,499,0.499,151,0.151,1
31575,26655,4920,14345,50,41000,643,1000,0.643,531,0.531,174,0.174,1
32200,27102,5098,14898,51,42000,625,1000,0.625,553,0.553,178,0.178,1
32862,27608,5254,15392,52,43000,662,1000,0.662,494,0.494,156,0.156,1
33486,28061,5425,15939,53,44000,624,1000,0.624,547,0.547,171,0.171,1
34114,28521,5593,16479,54,45000,628,1000,0.628,540,0.54,168,0.168,1
34734,28991,5743,17009,55,46000,620,1000,0.62,530,0.53,150,0.15,1
35384,29509,5875,17491,56,47000,650,1000,0.65,482,0.482,132,0.132,1
36016,29964,6052,18036,57,48000,632,1000,0.632,545,0.545,177,0.177,1
36623,30404,6219,18596,58,49000,607,1000,0.607,560,0.56,167,0.167,1
37213,30826,6387,19174,59,50000,590,1000,0.59,578,0.578,168,0.168,1
37845,31293,6552,19707,60,51000,632,1000,0.632,533,0.533,165,0.165,1
38483,31792,6691,20208,61,52000,638,1000,0.638,501,0.501,139,0.139,1
39101,32250,6851,20750,62,53000,618,1000,0.618,542,0.542,160,0.16,1
39697,32672,7025,21328,63,54000,596,1000,0.596,578,0.578,174,0.174,1
40305,33125,7180,21875,64,55000,608,1000,0.608,547,0.547,155,0.155,1
40928,33591,7337,22409,65,56000,623,1000,0.623,534,0.534,157,0.157,1
41532,34025,7507,22975,66,57000,604,1000,0.604,566,0.566,170,0.17,1
42136,34451,7685,23549,67,58000,604,1000,0.604,574,0.574,178,0.178,1
42750,34893,7857,24107,68,59000,614,1000,0.614,558,0.558,172,0.172,1
43347,35339,8008,24661,69,60000,597,1000,0.597,554,0.554,151,0.151,1
43944,35781,8163,25219,70,61000,597,1000,0.597,558,0.558,155,0.155,1
44533,36211,8322,25789,71,62000,589,1000,0.589,570,0.57,159,0.159,1
45103,36598,8505,26402,72,63000,570,1000,0.57,613,0.613,183,0.183,1
45679,37004,8675,26996,73,64000,576,1000,0.576,594,0.594,170,0.17,1
46265,37435,8830,27565,74,65000,586,1000,0.586,569,0.569,155,0.155,1
46843,37834,9009,28166,75,66000,578,1000,0.578,601,0.601,179,0.179,1
47391,38210,9181,28790,76,67000,548,1000,0.548,624,0.624,172,0.172,1
47931,38576,9355,29424,77,68000,540,1000,0.54,634,0.634,174,0.174,1
48469,38935,9534,30065,78,69000,538,1000,0.538,641,0.641,179,0.179,1
49039,39347,9692,30653,79,70000,570,1000,0.57,588,0.588,158,0.158,1
49579,39715,9864,31285,80,71000,540,1000,0.54,632,0.632,172,0.172,1
50139,40141,9998,31859,81,72000,560,1000,0.56,574,0.574,134,0.134,1
50686,40514,10172,32486,82,73000,547,1000,0.547,627,0.627,174,0.174,1
51217,40869,10348,33131,83,74000,531,1000,0.531,645,0.645,176,0.176,1
51776,41271,10505,33729,84,75000,559,1000,0.559,598,0.598,157,0.157,1
52326,41648,10678,34352,85,76000,550,1000,0.55,623,0.623,173,0.173,1
52875,42041,10834,34959,86,77000,549,1000,0.549,607,0.607,156,0.156,1
53409,42409,11000,35591,87,78000,534,1000,0.534,632,0.632,166,0.166,1
53939,42766,11173,36234,88,79000,530,1000,0.53,643,0.643,173,0.173,1
54478,43140,11338,36860,89,80000,539,1000,0.539,626,0.626,165,0.165,1
55024,43519,11505,37481,90,81000,546,1000,0.546,621,0.621,167,0.167,1
55560,43875,11685,38125,91,82000,536,1000,0.536,644,0.644,180,0.18,1
56091,44221,11870,38779,92,83000,531,1000,0.531,654,0.654,185,0.185,1
56609,44551,12058,39449,93,84000,518,1000,0.518,670,0.67,188,0.188,1
57161,44952,12209,40048,94,85000,552,1000,0.552,599,0.599,151,0.151,1
57695,45309,12386,40691,95,86000,534,1000,0.534,643,0.643,177,0.177,1
58200,45626,12574,41374,96,87000,505,1000,0.505,683,0.683,188,0.188,1
58728,45986,12742,42014,97,88000,528,1000,0.528,640,0.64,168,0.168,1
59247,46331,12916,42669,98,89000,519,1000,0.519,655,0.655,174,0.174,1
59755,46651,13104,43349,99,90000,508,1000,0.508,680,0.68,188,0.188,1
60284,47011,13273,43989,100,91000,529,1000,0.529,640,0.64,169,0.169,1
60792,47343,13449,44657,101,92000,508,1000,0.508,668,0.668,176,0.176,1
61312,47688,13624,45312,102,93000,520,1000,0.52,655,0.655,175,0.175,1
61839,48028,13811,45972,103,94000,527,1000,0.527,660,0.66,187,0.187,1
62362,48391,13971,46609,104,95000,523,1000,0.523,637,0.637,160,0.16,1
62899,48768,14131,47232,105,96000,537,1000,0.537,623,0.623,160,0.16,1
63402,49110,14292,47890,106,97000,503,1000,0.503,658,0.658,161,0.161,1
63926,49480,14446,48520,107,98000,524,1000,0.524,630,0.63,154,0.154,1
64437,49812,14625,49188,108,99000,511,1000,0.511,668,0.668,179,0.179,1
64948,50154,14794,49846,109,100000,511,1000,0.511,658,0.658,169,0.169,1
65434,50456,14978,50544,110,101000,486,1000,0.486,698,0.698,184,0.184,1
65927,50769,15158,51231,111,102000,493,1000,0.493,687,0.687,180,0.18,1
66388,51063,15325,51937,112,103000,461,1000,0.461,706,0.706,167,0.167,1
66876,51387,15489,52613,113,104000,488,1000,0.488,676,0.676,164,0.164,1
67358,51694,15664,53306,114,105000,482,1000,0.482,693,0.693,175,0.175,1
67829,51992,15837,54008,115,106000,471,1000,0.471,702,0.702,173,0.173,1
68285,52265,16020,54735,116,107000,456,1000,0.456,727,0.727,183,0.183,1
68754,52549,16205,55451,117,108000,469,1000,0.469,716,0.716,185,0.185,1
69252,52875,16377,56125,118,109000,498,1000,0.498,674,0.674,172,0.172,1
69738,53180,16558,56820,119,110000,486,1000,0.486,695,0.695,181,0.181,1
70249,53540,16709,57460,120,111000,511,1000,0.511,640,0.64,151,0.151,1
70743,53871,16872,58129,121,112000,494,1000,0.494,669,0.669,163,0.163,1
71209,54185,17024,58815,122,113000,466,1000,0.466,686,0.686,152,0.152,1
71714,54528,17186,59472,123,114000,505,1000,0.505,657,0.657,162,0.162,1
71869,54638,17231,59660,124,114298,155,298,0.5201342281879194,188,0.6308724832214765,45,0.15100671140939598,1
100,100,0,0,1,100,NA,NA,NA,NA,NA,NA,NA,2
200,200,0,0,2,200,100,100,1,0,0,0,0,2
297,295,2,5,3,300,97,100,0.97,5,0.05,2,0.02,2
396,393,3,7,4,400,99,100,0.99,2,0.02,1,0.01,2
494,490,4,10,5,500,98,100,0.98,3,0.03,1,0.01,2
593,588,5,12,6,600,99,100,0.99,2,0.02,1,0.01,2
692,686,6,14,7,700,99,100,0.99,2,0.02,1,0.01,2
791,785,6,15,8,800,99,100,0.99,1,0.01,0,0,2
885,873,12,27,9,900,94,100,0.94,12,0.12,6,0.06,2
983,970,13,30,10,1000,98,100,0.98,3,0.03,1,0.01,2
1940,1892,48,108,11,2000,957,1000,0.957,78,0.078,35,0.035,2
2889,2802,87,198,12,3000,949,1000,0.949,90,0.09,39,0.039,2
3794,3635,159,365,13,4000,905,1000,0.905,167,0.167,72,0.072,2
4697,4479,218,521,14,5000,903,1000,0.903,156,0.156,59,0.059,2
5587,5299,288,701,15,6000,890,1000,0.89,180,0.18,70,0.07,2
6463,6091,372,909,16,7000,876,1000,0.876,208,0.208,84,0.084,2
7305,6828,477,1172,17,8000,842,1000,0.842,263,0.263,105,0.105,2
8154,7580,574,1420,18,9000,849,1000,0.849,248,0.248,97,0.097,2
8990,8322,668,1678,19,10000,836,1000,0.836,258,0.258,94,0.094,2
9813,9055,758,1945,20,11000,823,1000,0.823,267,0.267,90,0.09,2
10627,9762,865,2238,21,12000,814,1000,0.814,293,0.293,107,0.107,2
11433,10442,991,2558,22,13000,806,1000,0.806,320,0.32,126,0.126,2
12264,11176,1088,2824,23,14000,831,1000,0.831,266,0.266,97,0.097,2
13036,11812,1224,3188,24,15000,772,1000,0.772,364,0.364,136,0.136,2
13828,12494,1334,3506,25,16000,792,1000,0.792,318,0.318,110,0.11,2
14611,13164,1447,3836,26,17000,783,1000,0.783,330,0.33,113,0.113,2
15377,13796,1581,4204,27,18000,766,1000,0.766,368,0.368,134,0.134,2
16158,14462,1696,4538,28,19000,781,1000,0.781,334,0.334,115,0.115,2
16921,15074,1847,4926,29,20000,763,1000,0.763,388,0.388,151,0.151,2
17674,15701,1973,5299,30,21000,753,1000,0.753,373,0.373,126,0.126,2
18441,16350,2091,5650,31,22000,767,1000,0.767,351,0.351,118,0.118,2
19173,16952,2221,6048,32,23000,732,1000,0.732,398,0.398,130,0.13,2
19888,17535,2353,6465,33,24000,715,1000,0.715,417,0.417,132,0.132,2
20623,18130,2493,6870,34,25000,735,1000,0.735,405,0.405,140,0.14,2
21319,18684,2635,7316,35,26000,696,1000,0.696,446,0.446,142,0.142,2
22002,19209,2793,7791,36,27000,683,1000,0.683,475,0.475,158,0.158,2
22685,19739,2946,8261,37,28000,683,1000,0.683,470,0.47,153,0.153,2
23372,20283,3089,8717,38,29000,687,1000,0.687,456,0.456,143,0.143,2
24063,20823,3240,9177,39,30000,691,1000,0.691,460,0.46,151,0.151,2
24780,21411,3369,9589,40,31000,717,1000,0.717,412,0.412,129,0.129,2
25502,21991,3511,10009,41,32000,722,1000,0.722,420,0.42,142,0.142,2
26187,22524,3663,10476,42,33000,685,1000,0.685,467,0.467,152,0.152,2
26873,23061,3812,10939,43,34000,686,1000,0.686,463,0.463,149,0.149,2
27544,23594,3950,11406,44,35000,671,1000,0.671,467,0.467,138,0.138,2
28222,24132,4090,11868,45,36000,678,1000,0.678,462,0.462,140,0.14,2
28878,24621,4257,12379,46,37000,656,1000,0.656,511,0.511,167,0.167,2
29520,25091,4429,12909,47,38000,642,1000,0.642,530,0.53,172,0.172,2
30200,25622,4578,13378,48,39000,680,1000,0.68,469,0.469,149,0.149,2
30861,26128,4733,13872,49,40000,661,1000,0.661,494,0.494,155,0.155,2
31500,26600,4900,14400,50,41000,639,1000,0.639,528,0.528,167,0.167,2
32112,27046,5066,14954,51,42000,612,1000,0.612,554,0.554,166,0.166,2
32753,27539,5214,15461,52,43000,641,1000,0.641,507,0.507,148,0.148,2
33404,28043,5361,15957,53,44000,651,1000,0.651,496,0.496,147,0.147,2
34055,28533,5522,16467,54,45000,651,1000,0.651,510,0.51,161,0.161,2
34708,29013,5695,16987,55,46000,653,1000,0.653,520,0.52,173,0.173,2
35351,29506,5845,17494,56,47000,643,1000,0.643,507,0.507,150,0.15,2
35986,29973,6013,18027,57,48000,635,1000,0.635,533,0.533,168,0.168,2
36629,30459,6170,18541,58,49000,643,1000,0.643,514,0.514,157,0.157,2
37229,30890,6339,19110,59,50000,600,1000,0.6,569,0.569,169,0.169,2
37850,31357,6493,19643,60,51000,621,1000,0.621,533,0.533,154,0.154,2
38480,31839,6641,20161,61,52000,630,1000,0.63,518,0.518,148,0.148,2
39083,32298,6785,20702,62,53000,603,1000,0.603,541,0.541,144,0.144,2
39676,32746,6930,21254,63,54000,593,1000,0.593,552,0.552,145,0.145,2
40320,33226,7094,21774,64,55000,644,1000,0.644,520,0.52,164,0.164,2
40921,33665,7256,22335,65,56000,601,1000,0.601,561,0.561,162,0.162,2
41528,34106,7422,22894,66,57000,607,1000,0.607,559,0.559,166,0.166,2
42107,34511,7596,23489,67,58000,579,1000,0.579,595,0.595,174,0.174,2
42688,34898,7790,24102,68,59000,581,1000,0.581,613,0.613,194,0.194,2
43270,35310,7960,24690,69,60000,582,1000,0.582,588,0.588,170,0.17,2
43841,35711,8130,25289,70,61000,571,1000,0.571,599,0.599,170,0.17,2
44410,36112,8298,25888,71,62000,569,1000,0.569,599,0.599,168,0.168,2
45006,36541,8465,26459,72,63000,596,1000,0.596,571,0.571,167,0.167,2
45587,36965,8622,27035,73,64000,581,1000,0.581,576,0.576,157,0.157,2
46168,37378,8790,27622,74,65000,581,1000,0.581,587,0.587,168,0.168,2
46732,37764,8968,28236,75,66000,564,1000,0.564,614,0.614,178,0.178,2
47303,38167,9136,28833,76,67000,571,1000,0.571,597,0.597,168,0.168,2
47868,38569,9299,29431,77,68000,565,1000,0.565,598,0.598,163,0.163,2
48414,38963,9451,30037,78,69000,546,1000,0.546,606,0.606,152,0.152,2
48980,39332,9648,30668,79,70000,566,1000,0.566,631,0.631,197,0.197,2
49551,39733,9818,31267,80,71000,571,1000,0.571,599,0.599,170,0.17,2
50124,40151,9973,31849,81,72000,573,1000,0.573,582,0.582,155,0.155,2
50686,40547,10139,32453,82,73000,562,1000,0.562,604,0.604,166,0.166,2
51244,40941,10303,33059,83,74000,558,1000,0.558,606,0.606,164,0.164,2
51808,41329,10479,33671,84,75000,564,1000,0.564,612,0.612,176,0.176,2
52338,41684,10654,34316,85,76000,530,1000,0.53,645,0.645,175,0.175,2
52864,42024,10840,34976,86,77000,526,1000,0.526,660,0.66,186,0.186,2
53431,42437,10994,35563,87,78000,567,1000,0.567,587,0.587,154,0.154,2
54004,42840,11164,36160,88,79000,573,1000,0.573,597,0.597,170,0.17,2
54556,43239,11317,36761,89,80000,552,1000,0.552,601,0.601,153,0.153,2
55091,43598,11493,37402,90,81000,535,1000,0.535,641,0.641,176,0.176,2
55638,43973,11665,38027,91,82000,547,1000,0.547,625,0.625,172,0.172,2
56187,44354,11833,38646,92,83000,549,1000,0.549,619,0.619,168,0.168,2
56724,44717,12007,39283,93,84000,537,1000,0.537,637,0.637,174,0.174,2
57234,45052,12182,39948,94,85000,510,1000,0.51,665,0.665,175,0.175,2
57777,45446,12331,40554,95,86000,543,1000,0.543,606,0.606,149,0.149,2
58274,45768,12506,41232,96,87000,497,1000,0.497,678,0.678,175,0.175,2
58798,46136,12662,41864,97,88000,524,1000,0.524,632,0.632,156,0.156,2
59307,46470,12837,42530,98,89000,509,1000,0.509,666,0.666,175,0.175,2
59829,46816,13013,43184,99,90000,522,1000,0.522,654,0.654,176,0.176,2
60337,47160,13177,43840,100,91000,508,1000,0.508,656,0.656,164,0.164,2
60853,47501,13352,44499,101,92000,516,1000,0.516,659,0.659,175,0.175,2
61358,47840,13518,45160,102,93000,505,1000,0.505,661,0.661,166,0.166,2
61837,48126,13711,45874,103,94000,479,1000,0.479,714,0.714,193,0.193,2
62337,48459,13878,46541,104,95000,500,1000,0.5,667,0.667,167,0.167,2
62844,48799,14045,47201,105,96000,507,1000,0.507,660,0.66,167,0.167,2
63340,49127,14213,47873,106,97000,496,1000,0.496,672,0.672,168,0.168,2
63836,49441,14395,48559,107,98000,496,1000,0.496,686,0.686,182,0.182,2
64327,49771,14556,49229,108,99000,491,1000,0.491,670,0.67,161,0.161,2
64828,50087,14741,49913,109,100000,501,1000,0.501,684,0.684,185,0.185,2
65302,50375,14927,50625,110,101000,474,1000,0.474,712,0.712,186,0.186,2
65824,50727,15097,51273,111,102000,522,1000,0.522,648,0.648,170,0.17,2
66298,51014,15284,51986,112,103000,474,1000,0.474,713,0.713,187,0.187,2
66802,51357,15445,52643,113,104000,504,1000,0.504,657,0.657,161,0.161,2
67293,51653,15640,53347,114,105000,491,1000,0.491,704,0.704,195,0.195,2
67806,52014,15792,53986,115,106000,513,1000,0.513,639,0.639,152,0.152,2
68312,52351,15961,54649,116,107000,506,1000,0.506,663,0.663,169,0.169,2
68779,52644,16135,55356,117,108000,467,1000,0.467,707,0.707,174,0.174,2
69272,52959,16313,56041,118,109000,493,1000,0.493,685,0.685,178,0.178,2
69770,53284,16486,56716,119,110000,498,1000,0.498,675,0.675,173,0.173,2
70243,53579,16664,57421,120,111000,473,1000,0.473,705,0.705,178,0.178,2
70744,53906,16838,58094,121,112000,501,1000,0.501,673,0.673,174,0.174,2
71223,54203,17020,58797,122,113000,479,1000,0.479,703,0.703,182,0.182,2
71716,54535,17181,59465,123,114000,493,1000,0.493,668,0.668,161,0.161,2
71869,54638,17231,59660,124,114298,153,298,0.5134228187919463,195,0.6543624161073825,50,0.16778523489932887,2
100,100,0,0,1,100,NA,NA,NA,NA,NA,NA,NA,3
199,198,1,2,2,200,99,100,0.99,2,0.02,1,0.01,3
299,298,1,2,3,300,100,100,1,0,0,0,0,3
397,394,3,6,4,400,98,100,0.98,4,0.04,2,0.02,3
495,491,4,9,5,500,98,100,0.98,3,0.03,1,0.01,3
594,589,5,11,6,600,99,100,0.99,2,0.02,1,0.01,3
691,683,8,17,7,700,97,100,0.97,6,0.06,3,0.03,3
787,775,12,25,8,800,96,100,0.96,8,0.08,4,0.04,3
885,871,14,29,9,900,98,100,0.98,4,0.04,2,0.02,3
983,967,16,33,10,1000,98,100,0.98,4,0.04,2,0.02,3
1943,1899,44,101,11,2000,960,1000,0.96,68,0.068,28,0.028,3
2883,2796,87,204,12,3000,940,1000,0.94,103,0.103,43,0.043,3
3791,3639,152,361,13,4000,908,1000,0.908,157,0.157,65,0.065,3
4689,4476,213,524,14,5000,898,1000,0.898,163,0.163,61,0.061,3
5575,5286,289,714,15,6000,886,1000,0.886,190,0.19,76,0.076,3
6441,6066,375,934,16,7000,866,1000,0.866,220,0.22,86,0.086,3
7303,6840,463,1160,17,8000,862,1000,0.862,226,0.226,88,0.088,3
8146,7597,549,1403,18,9000,843,1000,0.843,243,0.243,86,0.086,3
8981,8319,662,1681,19,10000,835,1000,0.835,278,0.278,113,0.113,3
9818,9059,759,1941,20,11000,837,1000,0.837,260,0.26,97,0.097,3
10627,9760,867,2240,21,12000,809,1000,0.809,299,0.299,108,0.108,3
11427,10453,974,2547,22,13000,800,1000,0.8,307,0.307,107,0.107,3
12230,11154,1076,2846,23,14000,803,1000,0.803,299,0.299,102,0.102,3
13010,11809,1201,3191,24,15000,780,1000,0.78,345,0.345,125,0.125,3
13800,12474,1326,3526,25,16000,790,1000,0.79,335,0.335,125,0.125,3
14569,13122,1447,3878,26,17000,769,1000,0.769,352,0.352,121,0.121,3
15314,13737,1577,4263,27,18000,745,1000,0.745,385,0.385,130,0.13,3
16073,14357,1716,4643,28,19000,759,1000,0.759,380,0.38,139,0.139,3
16820,14974,1846,5026,29,20000,747,1000,0.747,383,0.383,130,0.13,3
17575,15590,1985,5410,30,21000,755,1000,0.755,384,0.384,139,0.139,3
18328,16218,2110,5782,31,22000,753,1000,0.753,372,0.372,125,0.125,3
19085,16836,2249,6164,32,23000,757,1000,0.757,382,0.382,139,0.139,3
19820,17433,2387,6567,33,24000,735,1000,0.735,403,0.403,138,0.138,3
20529,17991,2538,7009,34,25000,709,1000,0.709,442,0.442,151,0.151,3
21236,18557,2679,7443,35,26000,707,1000,0.707,434,0.434,141,0.141,3
21961,19155,2806,7845,36,27000,725,1000,0.725,402,0.402,127,0.127,3
22668,19725,2943,8275,37,28000,707,1000,0.707,430,0.43,137,0.137,3
23372,20299,3073,8701,38,29000,704,1000,0.704,426,0.426,130,0.13,3
24069,20849,3220,9151,39,30000,697,1000,0.697,450,0.45,147,0.147,3
24781,21425,3356,9575,40,31000,712,1000,0.712,424,0.424,136,0.136,3
25490,22003,3487,9997,41,32000,709,1000,0.709,422,0.422,131,0.131,3
26197,22566,3631,10434,42,33000,707,1000,0.707,437,0.437,144,0.144,3
26872,23076,3796,10924,43,34000,675,1000,0.675,490,0.49,165,0.165,3
27541,23597,3944,11403,44,35000,669,1000,0.669,479,0.479,148,0.148,3
28228,24141,4087,11859,45,36000,687,1000,0.687,456,0.456,143,0.143,3
28913,24661,4252,12339,46,37000,685,1000,0.685,480,0.48,165,0.165,3
29562,25162,4400,12838,47,38000,649,1000,0.649,499,0.499,148,0.148,3
30234,25671,4563,13329,48,39000,672,1000,0.672,491,0.491,163,0.163,3
30855,26123,4732,13877,49,40000,621,1000,0.621,548,0.548,169,0.169,3
31484,26597,4887,14403,50,41000,629,1000,0.629,526,0.526,155,0.155,3
32122,27074,5048,14926,51,42000,638,1000,0.638,523,0.523,161,0.161,3
32758,27561,5197,15439,52,43000,636,1000,0.636,513,0.513,149,0.149,3
33376,27998,5378,16002,53,44000,618,1000,0.618,563,0.563,181,0.181,3
34004,28472,5532,16528,54,45000,628,1000,0.628,526,0.526,154,0.154,3
34644,28952,5692,17048,55,46000,640,1000,0.64,520,0.52,160,0.16,3
35257,29393,5864,17607,56,47000,613,1000,0.613,559,0.559,172,0.172,3
35876,29851,6025,18149,57,48000,619,1000,0.619,542,0.542,161,0.161,3
36499,30327,6172,18673,58,49000,623,1000,0.623,524,0.524,147,0.147,3
37128,30790,6338,19210,59,50000,629,1000,0.629,537,0.537,166,0.166,3
37729,31238,6491,19762,60,51000,601,1000,0.601,552,0.552,153,0.153,3
38298,31634,6664,20366,61,52000,569,1000,0.569,604,0.604,173,0.173,3
38901,32077,6824,20923,62,53000,603,1000,0.603,557,0.557,160,0.16,3
39517,32542,6975,21458,63,54000,616,1000,0.616,535,0.535,151,0.151,3
40130,32995,7135,22005,64,55000,613,1000,0.613,547,0.547,160,0.16,3
40737,33437,7300,22563,65,56000,607,1000,0.607,558,0.558,165,0.165,3
41306,33841,7465,23159,66,57000,569,1000,0.569,596,0.596,165,0.165,3
41896,34264,7632,23736,67,58000,590,1000,0.59,577,0.577,167,0.167,3
42501,34701,7800,24299,68,59000,605,1000,0.605,563,0.563,168,0.168,3
43082,35118,7964,24882,69,60000,581,1000,0.581,583,0.583,164,0.164,3
43673,35541,8132,25459,70,61000,591,1000,0.591,577,0.577,168,0.168,3
44289,35988,8301,26012,71,62000,616,1000,0.616,553,0.553,169,0.169,3
44906,36452,8454,26548,72,63000,617,1000,0.617,536,0.536,153,0.153,3
45466,36832,8634,27168,73,64000,560,1000,0.56,620,0.62,180,0.18,3
46074,37285,8789,27715,74,65000,608,1000,0.608,547,0.547,155,0.155,3
46637,37669,8968,28331,75,66000,563,1000,0.563,616,0.616,179,0.179,3
47219,38090,9129,28910,76,67000,582,1000,0.582,579,0.579,161,0.161,3
47749,38440,9309,29560,77,68000,530,1000,0.53,650,0.65,180,0.18,3
48331,38859,9472,30141,78,69000,582,1000,0.582,581,0.581,163,0.163,3
48901,39261,9640,30739,79,70000,570,1000,0.57,598,0.598,168,0.168,3
49466,39676,9790,31324,80,71000,565,1000,0.565,585,0.585,150,0.15,3
50040,40074,9966,31926,81,72000,574,1000,0.574,602,0.602,176,0.176,3
50587,40432,10155,32568,82,73000,547,1000,0.547,642,0.642,189,0.189,3
51131,40791,10340,33209,83,74000,544,1000,0.544,641,0.641,185,0.185,3
51691,41188,10503,33812,84,75000,560,1000,0.56,603,0.603,163,0.163,3
52245,41574,10671,34426,85,76000,554,1000,0.554,614,0.614,168,0.168,3
52766,41927,10839,35073,86,77000,521,1000,0.521,647,0.647,168,0.168,3
53334,42320,11014,35680,87,78000,568,1000,0.568,607,0.607,175,0.175,3
53868,42676,11192,36324,88,79000,534,1000,0.534,644,0.644,178,0.178,3
54410,43050,11360,36950,89,80000,542,1000,0.542,626,0.626,168,0.168,3
54964,43422,11542,37578,90,81000,554,1000,0.554,628,0.628,182,0.182,3
55548,43844,11704,38156,91,82000,584,1000,0.584,578,0.578,162,0.162,3
56084,44213,11871,38787,92,83000,536,1000,0.536,631,0.631,167,0.167,3
56622,44578,12044,39422,93,84000,538,1000,0.538,635,0.635,173,0.173,3
57144,44948,12196,40052,94,85000,522,1000,0.522,630,0.63,152,0.152,3
57658,45273,12385,40727,95,86000,514,1000,0.514,675,0.675,189,0.189,3
58179,45626,12553,41374,96,87000,521,1000,0.521,647,0.647,168,0.168,3
58678,45931,12747,42069,97,88000,499,1000,0.499,695,0.695,194,0.194,3
59192,46261,12931,42739,98,89000,514,1000,0.514,670,0.67,184,0.184,3
59707,46612,13095,43388,99,90000,515,1000,0.515,649,0.649,164,0.164,3
60244,46971,13273,44029,100,91000,537,1000,0.537,641,0.641,178,0.178,3
60749,47305,13444,44695,101,92000,505,1000,0.505,666,0.666,171,0.171,3
61261,47651,13610,45349,102,93000,512,1000,0.512,654,0.654,166,0.166,3
61774,47986,13788,46014,103,94000,513,1000,0.513,665,0.665,178,0.178,3
62299,48332,13967,46668,104,95000,525,1000,0.525,654,0.654,179,0.179,3
62842,48737,14105,47263,105,96000,543,1000,0.543,595,0.595,138,0.138,3
63340,49050,14290,47950,106,97000,498,1000,0.498,687,0.687,185,0.185,3
63826,49352,14474,48648,107,98000,486,1000,0.486,698,0.698,184,0.184,3
64341,49678,14663,49322,108,99000,515,1000,0.515,674,0.674,189,0.189,3
64828,49979,14849,50021,109,100000,487,1000,0.487,699,0.699,186,0.186,3
65334,50328,15006,50672,110,101000,506,1000,0.506,651,0.651,157,0.157,3
65843,50667,15176,51333,111,102000,509,1000,0.509,661,0.661,170,0.17,3
66352,50983,15369,52017,112,103000,509,1000,0.509,684,0.684,193,0.193,3
66869,51320,15549,52680,113,104000,517,1000,0.517,663,0.663,180,0.18,3
67350,51629,15721,53371,114,105000,481,1000,0.481,691,0.691,172,0.172,3
67857,51991,15866,54009,115,106000,507,1000,0.507,638,0.638,145,0.145,3
68363,52330,16033,54670,116,107000,506,1000,0.506,661,0.661,167,0.167,3
68812,52583,16229,55417,117,108000,449,1000,0.449,747,0.747,196,0.196,3
69308,52914,16394,56086,118,109000,496,1000,0.496,669,0.669,165,0.165,3
69787,53237,16550,56763,119,110000,479,1000,0.479,677,0.677,156,0.156,3
70247,53526,16721,57474,120,111000,460,1000,0.46,711,0.711,171,0.171,3
70734,53860,16874,58140,121,112000,487,1000,0.487,666,0.666,153,0.153,3
71223,54195,17028,58805,122,113000,489,1000,0.489,665,0.665,154,0.154,3
71705,54522,17183,59478,123,114000,482,1000,0.482,673,0.673,155,0.155,3
71869,54638,17231,59660,124,114298,164,298,0.5503355704697986,182,0.610738255033557,48,0.1610738255033557,3
99,98,1,2,1,100,NA,NA,NA,NA,NA,NA,NA,4
199,198,1,2,2,200,100,100,1,0,0,0,0,4
299,298,1,2,3,300,100,100,1,0,0,0,0,4
399,398,1,2,4,400,100,100,1,0,0,0,0,4
496,493,3,7,5,500,97,100,0.97,5,0.05,2,0.02,4
591,583,8,17,6,600,95,100,0.95,10,0.1,5,0.05,4
686,674,12,26,7,700,95,100,0.95,9,0.09,4,0.04,4
785,772,13,28,8,800,99,100,0.99,2,0.02,1,0.01,4
882,866,16,34,9,900,97,100,0.97,6,0.06,3,0.03,4
978,958,20,42,10,1000,96,100,0.96,8,0.08,4,0.04,4
1943,1895,48,105,11,2000,965,1000,0.965,63,0.063,28,0.028,4
2874,2779,95,221,12,3000,931,1000,0.931,116,0.116,47,0.047,4
3798,3649,149,351,13,4000,924,1000,0.924,130,0.13,54,0.054,4
4687,4459,228,541,14,5000,889,1000,0.889,190,0.19,79,0.079,4
5573,5275,298,725,15,6000,886,1000,0.886,184,0.184,70,0.07,4
6444,6064,380,936,16,7000,871,1000,0.871,211,0.211,82,0.082,4
7317,6848,469,1152,17,8000,873,1000,0.873,216,0.216,89,0.089,4
8168,7612,556,1388,18,9000,851,1000,0.851,236,0.236,87,0.087,4
8991,8332,659,1668,19,10000,823,1000,0.823,280,0.28,103,0.103,4
9823,9065,758,1935,20,11000,832,1000,0.832,267,0.267,99,0.099,4
10641,9770,871,2230,21,12000,818,1000,0.818,295,0.295,113,0.113,4
11468,10491,977,2509,22,13000,827,1000,0.827,279,0.279,106,0.106,4
12282,11196,1086,2804,23,14000,814,1000,0.814,295,0.295,109,0.109,4
13063,11851,1212,3149,24,15000,781,1000,0.781,345,0.345,126,0.126,4
13831,12503,1328,3497,25,16000,768,1000,0.768,348,0.348,116,0.116,4
14597,13148,1449,3852,26,17000,766,1000,0.766,355,0.355,121,0.121,4
15376,13825,1551,4175,27,18000,779,1000,0.779,323,0.323,102,0.102,4
16127,14444,1683,4556,28,19000,751,1000,0.751,381,0.381,132,0.132,4
16894,15096,1798,4904,29,20000,767,1000,0.767,348,0.348,115,0.115,4
17643,15732,1911,5268,30,21000,749,1000,0.749,364,0.364,113,0.113,4
18397,16360,2037,5640,31,22000,754,1000,0.754,372,0.372,126,0.126,4
19125,16948,2177,6052,32,23000,728,1000,0.728,412,0.412,140,0.14,4
19862,17545,2317,6455,33,24000,737,1000,0.737,403,0.403,140,0.14,4
20603,18156,2447,6844,34,25000,741,1000,0.741,389,0.389,130,0.13,4
21317,18711,2606,7289,35,26000,714,1000,0.714,445,0.445,159,0.159,4
22048,19302,2746,7698,36,27000,731,1000,0.731,409,0.409,140,0.14,4
22750,19864,2886,8136,37,28000,702,1000,0.702,438,0.438,140,0.14,4
23464,20428,3036,8572,38,29000,714,1000,0.714,436,0.436,150,0.15,4
24185,21016,3169,8984,39,30000,721,1000,0.721,412,0.412,133,0.133,4
24892,21586,3306,9414,40,31000,707,1000,0.707,430,0.43,137,0.137,4
25577,22118,3459,9882,41,32000,685,1000,0.685,468,0.468,153,0.153,4
26270,22669,3601,10331,42,33000,693,1000,0.693,449,0.449,142,0.142,4
26912,23138,3774,10862,43,34000,642,1000,0.642,531,0.531,173,0.173,4
27602,23680,3922,11320,44,35000,690,1000,0.69,458,0.458,148,0.148,4
28251,24163,4088,11837,45,36000,649,1000,0.649,517,0.517,166,0.166,4
28893,24645,4248,12355,46,37000,642,1000,0.642,518,0.518,160,0.16,4
29570,25181,4389,12819,47,38000,677,1000,0.677,464,0.464,141,0.141,4
30224,25693,4531,13307,48,39000,654,1000,0.654,488,0.488,142,0.142,4
30869,26165,4704,13835,49,40000,645,1000,0.645,528,0.528,173,0.173,4
31517,26649,4868,14351,50,41000,648,1000,0.648,516,0.516,164,0.164,4
32181,27144,5037,14856,51,42000,664,1000,0.664,505,0.505,169,0.169,4
32813,27614,5199,15386,52,43000,632,1000,0.632,530,0.53,162,0.162,4
33429,28063,5366,15937,53,44000,616,1000,0.616,551,0.551,167,0.167,4
34043,28525,5518,16475,54,45000,614,1000,0.614,538,0.538,152,0.152,4
34693,29024,5669,16976,55,46000,650,1000,0.65,501,0.501,151,0.151,4
35329,29507,5822,17493,56,47000,636,1000,0.636,517,0.517,153,0.153,4
35952,29966,5986,18034,57,48000,623,1000,0.623,541,0.541,164,0.164,4
36590,30435,6155,18565,58,49000,638,1000,0.638,531,0.531,169,0.169,4
37198,30876,6322,19124,59,50000,608,1000,0.608,559,0.559,167,0.167,4
37786,31283,6503,19717,60,51000,588,1000,0.588,593,0.593,181,0.181,4
38401,31730,6671,20270,61,52000,615,1000,0.615,553,0.553,168,0.168,4
38995,32155,6840,20845,62,53000,594,1000,0.594,575,0.575,169,0.169,4
39589,32582,7007,21418,63,54000,594,1000,0.594,573,0.573,167,0.167,4
40186,33013,7173,21987,64,55000,597,1000,0.597,569,0.569,166,0.166,4
40812,33477,7335,22523,65,56000,626,1000,0.626,536,0.536,162,0.162,4
41391,33878,7513,23122,66,57000,579,1000,0.579,599,0.599,178,0.178,4
41972,34283,7689,23717,67,58000,581,1000,0.581,595,0.595,176,0.176,4
42546,34682,7864,24318,68,59000,574,1000,0.574,601,0.601,175,0.175,4
43153,35118,8035,24882,69,60000,607,1000,0.607,564,0.564,171,0.171,4
43734,35531,8203,25469,70,61000,581,1000,0.581,587,0.587,168,0.168,4
44302,35927,8375,26073,71,62000,568,1000,0.568,604,0.604,172,0.172,4
44881,36335,8546,26665,72,63000,579,1000,0.579,592,0.592,171,0.171,4
45470,36773,8697,27227,73,64000,589,1000,0.589,562,0.562,151,0.151,4
46062,37197,8865,27803,74,65000,592,1000,0.592,576,0.576,168,0.168,4
46628,37595,9033,28405,75,66000,566,1000,0.566,602,0.602,168,0.168,4
47202,38005,9197,28995,76,67000,574,1000,0.574,590,0.59,164,0.164,4
47760,38411,9349,29589,77,68000,558,1000,0.558,594,0.594,152,0.152,4
48341,38813,9528,30187,78,69000,581,1000,0.581,598,0.598,179,0.179,4
48925,39227,9698,30773,79,70000,584,1000,0.584,586,0.586,170,0.17,4
49483,39608,9875,31392,80,71000,558,1000,0.558,619,0.619,177,0.177,4
50032,39975,10057,32025,81,72000,549,1000,0.549,633,0.633,182,0.182,4
50589,40376,10213,32624,82,73000,557,1000,0.557,599,0.599,156,0.156,4
51136,40747,10389,33253,83,74000,547,1000,0.547,629,0.629,176,0.176,4
51676,41117,10559,33883,84,75000,540,1000,0.54,630,0.63,170,0.17,4
52211,41480,10731,34520,85,76000,535,1000,0.535,637,0.637,172,0.172,4
52767,41878,10889,35122,86,77000,556,1000,0.556,602,0.602,158,0.158,4
53329,42297,11032,35703,87,78000,562,1000,0.562,581,0.581,143,0.143,4
53892,42709,11183,36291,88,79000,563,1000,0.563,588,0.588,151,0.151,4
54441,43077,11364,36923,89,80000,549,1000,0.549,632,0.632,181,0.181,4
54985,43452,11533,37548,90,81000,544,1000,0.544,625,0.625,169,0.169,4
55530,43820,11710,38180,91,82000,545,1000,0.545,632,0.632,177,0.177,4
56062,44190,11872,38810,92,83000,532,1000,0.532,630,0.63,162,0.162,4
56577,44518,12059,39482,93,84000,515,1000,0.515,672,0.672,187,0.187,4
57113,44872,12241,40128,94,85000,536,1000,0.536,646,0.646,182,0.182,4
57662,45247,12415,40753,95,86000,549,1000,0.549,625,0.625,174,0.174,4
58180,45583,12597,41417,96,87000,518,1000,0.518,664,0.664,182,0.182,4
58695,45922,12773,42078,97,88000,515,1000,0.515,661,0.661,176,0.176,4
59188,46224,12964,42776,98,89000,493,1000,0.493,698,0.698,191,0.191,4
59723,46593,13130,43407,99,90000,535,1000,0.535,631,0.631,166,0.166,4
60253,46954,13299,44046,100,91000,530,1000,0.53,639,0.639,169,0.169,4
60768,47300,13468,44700,101,92000,515,1000,0.515,654,0.654,169,0.169,4
61283,47649,13634,45351,102,93000,515,1000,0.515,651,0.651,166,0.166,4
61794,47986,13808,46014,103,94000,511,1000,0.511,663,0.663,174,0.174,4
62307,48331,13976,46669,104,95000,513,1000,0.513,655,0.655,168,0.168,4
62792,48627,14165,47373,105,96000,485,1000,0.485,704,0.704,189,0.189,4
63290,48956,14334,48044,106,97000,498,1000,0.498,671,0.671,169,0.169,4
63787,49277,14510,48723,107,98000,497,1000,0.497,679,0.679,176,0.176,4
64285,49608,14677,49392,108,99000,498,1000,0.498,669,0.669,167,0.167,4
64771,49928,14843,50072,109,100000,486,1000,0.486,680,0.68,166,0.166,4
65272,50246,15026,50754,110,101000,501,1000,0.501,682,0.682,183,0.183,4
65748,50541,15207,51459,111,102000,476,1000,0.476,705,0.705,181,0.181,4
66269,50899,15370,52101,112,103000,521,1000,0.521,642,0.642,163,0.163,4
66801,51272,15529,52728,113,104000,532,1000,0.532,627,0.627,159,0.159,4
67318,51619,15699,53381,114,105000,517,1000,0.517,653,0.653,170,0.17,4
67819,51956,15863,54044,115,106000,501,1000,0.501,663,0.663,164,0.164,4
68336,52302,16034,54698,116,107000,517,1000,0.517,654,0.654,171,0.171,4
68807,52622,16185,55378,117,108000,471,1000,0.471,680,0.68,151,0.151,4
69282,52948,16334,56052,118,109000,475,1000,0.475,674,0.674,149,0.149,4
69773,53268,16505,56732,119,110000,491,1000,0.491,680,0.68,171,0.171,4
70259,53579,16680,57421,120,111000,486,1000,0.486,689,0.689,175,0.175,4
70762,53927,16835,58073,121,112000,503,1000,0.503,652,0.652,155,0.155,4
71254,54253,17001,58747,122,113000,492,1000,0.492,674,0.674,166,0.166,4
71732,54547,17185,59453,123,114000,478,1000,0.478,706,0.706,184,0.184,4
71869,54638,17231,59660,124,114298,137,298,0.4597315436241611,207,0.6946308724832215,46,0.15436241610738255,4
99,98,1,2,1,100,NA,NA,NA,NA,NA,NA,NA,5
199,198,1,2,2,200,100,100,1,0,0,0,0,5
297,294,3,6,3,300,98,100,0.98,4,0.04,2,0.02,5
395,390,5,10,4,400,98,100,0.98,4,0.04,2,0.02,5
492,486,6,14,5,500,97,100,0.97,4,0.04,1,0.01,5
591,585,6,15,6,600,99,100,0.99,1,0.01,0,0,5
690,684,6,16,7,700,99,100,0.99,1,0.01,0,0,5
788,780,8,20,8,800,98,100,0.98,4,0.04,2,0.02,5
887,879,8,21,9,900,99,100,0.99,1,0.01,0,0,5
983,972,11,28,10,1000,96,100,0.96,7,0.07,3,0.03,5
1938,1889,49,111,11,2000,955,1000,0.955,83,0.083,38,0.038,5
2862,2758,104,242,12,3000,924,1000,0.924,131,0.131,55,0.055,5
3777,3616,161,384,13,4000,915,1000,0.915,142,0.142,57,0.057,5
4681,4463,218,537,14,5000,904,1000,0.904,153,0.153,57,0.057,5
5572,5283,289,717,15,6000,891,1000,0.891,180,0.18,71,0.071,5
6470,6107,363,893,16,7000,898,1000,0.898,176,0.176,74,0.074,5
7312,6845,467,1155,17,8000,842,1000,0.842,262,0.262,104,0.104,5
8143,7571,572,1429,18,9000,831,1000,0.831,274,0.274,105,0.105,5
8981,8309,672,1691,19,10000,838,1000,0.838,262,0.262,100,0.1,5
9826,9055,771,1945,20,11000,845,1000,0.845,254,0.254,99,0.099,5
10641,9768,873,2232,21,12000,815,1000,0.815,287,0.287,102,0.102,5
11463,10486,977,2514,22,13000,822,1000,0.822,282,0.282,104,0.104,5
12263,11163,1100,2837,23,14000,800,1000,0.8,323,0.323,123,0.123,5
13022,11782,1240,3218,24,15000,759,1000,0.759,381,0.381,140,0.14,5
13780,12402,1378,3598,25,16000,758,1000,0.758,380,0.38,138,0.138,5
14595,13103,1492,3897,26,17000,815,1000,0.815,299,0.299,114,0.114,5
15359,13750,1609,4250,27,18000,764,1000,0.764,353,0.353,117,0.117,5
16098,14355,1743,4645,28,19000,739,1000,0.739,395,0.395,134,0.134,5
16844,14970,1874,5030,29,20000,746,1000,0.746,385,0.385,131,0.131,5
17592,15595,1997,5405,30,21000,748,1000,0.748,375,0.375,123,0.123,5
18326,16194,2132,5806,31,22000,734,1000,0.734,401,0.401,135,0.135,5
19063,16796,2267,6204,32,23000,737,1000,0.737,398,0.398,135,0.135,5
19798,17407,2391,6593,33,24000,735,1000,0.735,389,0.389,124,0.124,5
20517,17987,2530,7013,34,25000,719,1000,0.719,420,0.42,139,0.139,5
21221,18549,2672,7451,35,26000,704,1000,0.704,438,0.438,142,0.142,5
21945,19122,2823,7878,36,27000,724,1000,0.724,427,0.427,151,0.151,5
22656,19693,2963,8307,37,28000,711,1000,0.711,429,0.429,140,0.14,5
23374,20286,3088,8714,38,29000,718,1000,0.718,407,0.407,125,0.125,5
24071,20842,3229,9158,39,30000,697,1000,0.697,444,0.444,141,0.141,5
24757,21381,3376,9619,40,31000,686,1000,0.686,461,0.461,147,0.147,5
25448,21912,3536,10088,41,32000,691,1000,0.691,469,0.469,160,0.16,5
26134,22458,3676,10542,42,33000,686,1000,0.686,454,0.454,140,0.14,5
26810,22979,3831,11021,43,34000,676,1000,0.676,479,0.479,155,0.155,5
27499,23512,3987,11488,44,35000,689,1000,0.689,467,0.467,156,0.156,5
28142,23979,4163,12021,45,36000,643,1000,0.643,533,0.533,176,0.176,5
28824,24507,4317,12493,46,37000,682,1000,0.682,472,0.472,154,0.154,5
29485,25014,4471,12986,47,38000,661,1000,0.661,493,0.493,154,0.154,5
30158,25533,4625,13467,48,39000,673,1000,0.673,481,0.481,154,0.154,5
30823,26047,4776,13953,49,40000,665,1000,0.665,486,0.486,151,0.151,5
31474,26560,4914,14440,50,41000,651,1000,0.651,487,0.487,138,0.138,5
32122,27052,5070,14948,51,42000,648,1000,0.648,508,0.508,156,0.156,5
32719,27465,5254,15535,52,43000,597,1000,0.597,587,0.587,184,0.184,5
33340,27923,5417,16077,53,44000,621,1000,0.621,542,0.542,163,0.163,5
33993,28432,5561,16568,54,45000,653,1000,0.653,491,0.491,144,0.144,5
34622,28902,5720,17098,55,46000,629,1000,0.629,530,0.53,159,0.159,5
35251,29373,5878,17627,56,47000,629,1000,0.629,529,0.529,158,0.158,5
35897,29872,6025,18128,57,48000,646,1000,0.646,501,0.501,147,0.147,5
36504,30320,6184,18680,58,49000,607,1000,0.607,552,0.552,159,0.159,5
37127,30753,6374,19247,59,50000,623,1000,0.623,567,0.567,190,0.19,5
37727,31196,6531,19804,60,51000,600,1000,0.6,557,0.557,157,0.157,5
38321,31623,6698,20377,61,52000,594,1000,0.594,573,0.573,167,0.167,5
38923,32040,6883,20960,62,53000,602,1000,0.602,583,0.583,185,0.185,5
39567,32540,7027,21460,63,54000,644,1000,0.644,500,0.5,144,0.144,5
40163,32958,7205,22042,64,55000,596,1000,0.596,582,0.582,178,0.178,5
40762,33385,7377,22615,65,56000,599,1000,0.599,573,0.573,172,0.172,5
41377,33857,7520,23143,66,57000,615,1000,0.615,528,0.528,143,0.143,5
41980,34302,7678,23698,67,58000,603,1000,0.603,555,0.555,158,0.158,5
42566,34722,7844,24278,68,59000,586,1000,0.586,580,0.58,166,0.166,5
43136,35102,8034,24898,69,60000,570,1000,0.57,620,0.62,190,0.19,5
43733,35542,8191,25458,70,61000,597,1000,0.597,560,0.56,157,0.157,5
44312,35944,8368,26056,71,62000,579,1000,0.579,598,0.598,177,0.177,5
44892,36370,8522,26630,72,63000,580,1000,0.58,574,0.574,154,0.154,5
45475,36791,8684,27209,73,64000,583,1000,0.583,579,0.579,162,0.162,5
46072,37224,8848,27776,74,65000,597,1000,0.597,567,0.567,164,0.164,5
46642,37624,9018,28376,75,66000,570,1000,0.57,600,0.6,170,0.17,5
47209,37999,9210,29001,76,67000,567,1000,0.567,625,0.625,192,0.192,5
47775,38398,9377,29602,77,68000,566,1000,0.566,601,0.601,167,0.167,5
48358,38811,9547,30189,78,69000,583,1000,0.583,587,0.587,170,0.17,5
48926,39210,9716,30790,79,70000,568,1000,0.568,601,0.601,169,0.169,5
49482,39598,9884,31402,80,71000,556,1000,0.556,612,0.612,168,0.168,5
50028,39965,10063,32035,81,72000,546,1000,0.546,633,0.633,179,0.179,5
50592,40375,10217,32625,82,73000,564,1000,0.564,590,0.59,154,0.154,5
51163,40780,10383,33220,83,74000,571,1000,0.571,595,0.595,166,0.166,5
51737,41198,10539,33802,84,75000,574,1000,0.574,582,0.582,156,0.156,5
52273,41570,10703,34430,85,76000,536,1000,0.536,628,0.628,164,0.164,5
52828,41943,10885,35057,86,77000,555,1000,0.555,627,0.627,182,0.182,5
53405,42369,11036,35631,87,78000,577,1000,0.577,574,0.574,151,0.151,5
53944,42728,11216,36272,88,79000,539,1000,0.539,641,0.641,180,0.18,5
54474,43083,11391,36917,89,80000,530,1000,0.53,645,0.645,175,0.175,5
55001,43436,11565,37564,90,81000,527,1000,0.527,647,0.647,174,0.174,5
55537,43785,11752,38215,91,82000,536,1000,0.536,651,0.651,187,0.187,5
56070,44163,11907,38837,92,83000,533,1000,0.533,622,0.622,155,0.155,5
56593,44508,12085,39492,93,84000,523,1000,0.523,655,0.655,178,0.178,5
57123,44872,12251,40128,94,85000,530,1000,0.53,636,0.636,166,0.166,5
57643,45236,12407,40764,95,86000,520,1000,0.52,636,0.636,156,0.156,5
58143,45569,12574,41431,96,87000,500,1000,0.5,667,0.667,167,0.167,5
58684,45947,12737,42053,97,88000,541,1000,0.541,622,0.622,163,0.163,5
59214,46302,12912,42698,98,89000,530,1000,0.53,645,0.645,175,0.175,5
59763,46676,13087,43324,99,90000,549,1000,0.549,626,0.626,175,0.175,5
60259,47001,13258,43999,100,91000,496,1000,0.496,675,0.675,171,0.171,5
60788,47359,13429,44641,101,92000,529,1000,0.529,642,0.642,171,0.171,5
61302,47728,13574,45272,102,93000,514,1000,0.514,631,0.631,145,0.145,5
61794,48046,13748,45954,103,94000,492,1000,0.492,682,0.682,174,0.174,5
62299,48373,13926,46627,104,95000,505,1000,0.505,673,0.673,178,0.178,5
62814,48719,14095,47281,105,96000,515,1000,0.515,654,0.654,169,0.169,5
63327,49070,14257,47930,106,97000,513,1000,0.513,649,0.649,162,0.162,5
63816,49392,14424,48608,107,98000,489,1000,0.489,678,0.678,167,0.167,5
64317,49720,14597,49280,108,99000,501,1000,0.501,672,0.672,173,0.173,5
64792,50013,14779,49987,109,100000,475,1000,0.475,707,0.707,182,0.182,5
65322,50384,14938,50616,110,101000,530,1000,0.53,629,0.629,159,0.159,5
65812,50715,15097,51285,111,102000,490,1000,0.49,669,0.669,159,0.159,5
66294,51021,15273,51979,112,103000,482,1000,0.482,694,0.694,176,0.176,5
66786,51315,15471,52685,113,104000,492,1000,0.492,706,0.706,198,0.198,5
67298,51660,15638,53340,114,105000,512,1000,0.512,655,0.655,167,0.167,5
67798,51984,15814,54016,115,106000,500,1000,0.5,676,0.676,176,0.176,5
68301,52332,15969,54668,116,107000,503,1000,0.503,652,0.652,155,0.155,5
68808,52664,16144,55336,117,108000,507,1000,0.507,668,0.668,175,0.175,5
69285,52966,16319,56034,118,109000,477,1000,0.477,698,0.698,175,0.175,5
69735,53226,16509,56774,119,110000,450,1000,0.45,740,0.74,190,0.19,5
70239,53558,16681,57442,120,111000,504,1000,0.504,668,0.668,172,0.172,5
70739,53888,16851,58112,121,112000,500,1000,0.5,670,0.67,170,0.17,5
71219,54188,17031,58812,122,113000,480,1000,0.48,700,0.7,180,0.18,5
71716,54520,17196,59480,123,114000,497,1000,0.497,668,0.668,165,0.165,5
71869,54638,17231,59660,124,114298,153,298,0.5134228187919463,180,0.6040268456375839,35,0.1174496644295302,5
100,100,0,0,1,100,NA,NA,NA,NA,NA,NA,NA,6
200,200,0,0,2,200,100,100,1,0,0,0,0,6
300,300,0,0,3,300,100,100,1,0,0,0,0,6
399,398,1,2,4,400,99,100,0.99,2,0.02,1,0.01,6
496,492,4,8,5,500,97,100,0.97,6,0.06,3,0.03,6
594,589,5,11,6,600,98,100,0.98,3,0.03,1,0.01,6
689,679,10,21,7,700,95,100,0.95,10,0.1,5,0.05,6
789,779,10,21,8,800,100,100,1,0,0,0,0,6
887,875,12,25,9,900,98,100,0.98,4,0.04,2,0.02,6
984,969,15,31,10,1000,97,100,0.97,6,0.06,3,0.03,6
1939,1884,55,116,11,2000,955,1000,0.955,85,0.085,40,0.04,6
2881,2782,99,218,12,3000,942,1000,0.942,102,0.102,44,0.044,6
3797,3646,151,354,13,4000,916,1000,0.916,136,0.136,52,0.052,6
4701,4480,221,520,14,5000,904,1000,0.904,166,0.166,70,0.07,6
5583,5280,303,720,15,6000,882,1000,0.882,200,0.2,82,0.082,6
6446,6061,385,939,16,7000,863,1000,0.863,219,0.219,82,0.082,6
7299,6828,471,1172,17,8000,853,1000,0.853,233,0.233,86,0.086,6
8168,7612,556,1388,18,9000,869,1000,0.869,216,0.216,85,0.085,6
9005,8353,652,1647,19,10000,837,1000,0.837,259,0.259,96,0.096,6
9833,9079,754,1921,20,11000,828,1000,0.828,274,0.274,102,0.102,6
10648,9783,865,2217,21,12000,815,1000,0.815,296,0.296,111,0.111,6
11476,10504,972,2496,22,13000,828,1000,0.828,279,0.279,107,0.107,6
12290,11212,1078,2788,23,14000,814,1000,0.814,292,0.292,106,0.106,6
13102,11917,1185,3083,24,15000,812,1000,0.812,295,0.295,107,0.107,6
13874,12558,1316,3442,25,16000,772,1000,0.772,359,0.359,131,0.131,6
14653,13228,1425,3772,26,17000,779,1000,0.779,330,0.33,109,0.109,6
15445,13906,1539,4094,27,18000,792,1000,0.792,322,0.322,114,0.114,6
16184,14512,1672,4488,28,19000,739,1000,0.739,394,0.394,133,0.133,6
16945,15158,1787,4842,29,20000,761,1000,0.761,354,0.354,115,0.115,6
17687,15772,1915,5228,30,21000,742,1000,0.742,386,0.386,128,0.128,6
18431,16385,2046,5615,31,22000,744,1000,0.744,387,0.387,131,0.131,6
19174,16990,2184,6010,32,23000,743,1000,0.743,395,0.395,138,0.138,6
19916,17597,2319,6403,33,24000,742,1000,0.742,393,0.393,135,0.135,6
20637,18163,2474,6837,34,25000,721,1000,0.721,434,0.434,155,0.155,6
21349,18735,2614,7265,35,26000,712,1000,0.712,428,0.428,140,0.14,6
22062,19313,2749,7687,36,27000,713,1000,0.713,422,0.422,135,0.135,6
22757,19859,2898,8141,37,28000,695,1000,0.695,454,0.454,149,0.149,6
23452,20404,3048,8596,38,29000,695,1000,0.695,455,0.455,150,0.15,6
24145,20928,3217,9072,39,30000,693,1000,0.693,476,0.476,169,0.169,6
24862,21519,3343,9481,40,31000,717,1000,0.717,409,0.409,126,0.126,6
25558,22085,3473,9915,41,32000,696,1000,0.696,434,0.434,130,0.13,6
26229,22591,3638,10409,42,33000,671,1000,0.671,494,0.494,165,0.165,6
26930,23150,3780,10850,43,34000,701,1000,0.701,441,0.441,142,0.142,6
27605,23672,3933,11328,44,35000,675,1000,0.675,478,0.478,153,0.153,6
28281,24204,4077,11796,45,36000,676,1000,0.676,468,0.468,144,0.144,6
28954,24729,4225,12271,46,37000,673,1000,0.673,475,0.475,148,0.148,6
29629,25253,4376,12747,47,38000,675,1000,0.675,476,0.476,151,0.151,6
30291,25776,4515,13224,48,39000,662,1000,0.662,477,0.477,139,0.139,6
30934,26241,4693,13759,49,40000,643,1000,0.643,535,0.535,178,0.178,6
31568,26701,4867,14299,50,41000,634,1000,0.634,540,0.54,174,0.174,6
32198,27181,5017,14819,51,42000,630,1000,0.63,520,0.52,150,0.15,6
32880,27719,5161,15281,52,43000,682,1000,0.682,462,0.462,144,0.144,6
33522,28208,5314,15792,53,44000,642,1000,0.642,511,0.511,153,0.153,6
34156,28689,5467,16311,54,45000,634,1000,0.634,519,0.519,153,0.153,6
34784,29179,5605,16821,55,46000,628,1000,0.628,510,0.51,138,0.138,6
35393,29603,5790,17397,56,47000,609,1000,0.609,576,0.576,185,0.185,6
36043,30116,5927,17884,57,48000,650,1000,0.65,487,0.487,137,0.137,6
36682,30596,6086,18404,58,49000,639,1000,0.639,520,0.52,159,0.159,6
37324,31071,6253,18929,59,50000,642,1000,0.642,525,0.525,167,0.167,6
37946,31523,6423,19477,60,51000,622,1000,0.622,548,0.548,170,0.17,6
38526,31924,6602,20076,61,52000,580,1000,0.58,599,0.599,179,0.179,6
39131,32364,6767,20636,62,53000,605,1000,0.605,560,0.56,165,0.165,6
39758,32829,6929,21171,63,54000,627,1000,0.627,535,0.535,162,0.162,6
40354,33242,7112,21758,64,55000,596,1000,0.596,587,0.587,183,0.183,6
40963,33691,7272,22309,65,56000,609,1000,0.609,551,0.551,160,0.16,6
41549,34128,7421,22872,66,57000,586,1000,0.586,563,0.563,149,0.149,6
42154,34577,7577,23423,67,58000,605,1000,0.605,551,0.551,156,0.156,6
42744,34993,7751,24007,68,59000,590,1000,0.59,584,0.584,174,0.174,6
43306,35376,7930,24624,69,60000,562,1000,0.562,617,0.617,179,0.179,6
43910,35808,8102,25192,70,61000,604,1000,0.604,568,0.568,172,0.172,6
44502,36217,8285,25783,71,62000,592,1000,0.592,591,0.591,183,0.183,6
45059,36598,8461,26402,72,63000,557,1000,0.557,619,0.619,176,0.176,6
45654,37028,8626,26972,73,64000,595,1000,0.595,570,0.57,165,0.165,6
46203,37385,8818,27615,74,65000,549,1000,0.549,643,0.643,192,0.192,6
46777,37788,8989,28212,75,66000,574,1000,0.574,597,0.597,171,0.171,6
47326,38148,9178,28852,76,67000,549,1000,0.549,640,0.64,189,0.189,6
47887,38539,9348,29461,77,68000,561,1000,0.561,609,0.609,170,0.17,6
48448,38915,9533,30085,78,69000,561,1000,0.561,624,0.624,185,0.185,6
49012,39296,9716,30704,79,70000,564,1000,0.564,619,0.619,183,0.183,6
49557,39648,9909,31352,80,71000,545,1000,0.545,648,0.648,193,0.193,6
50118,40047,10071,31953,81,72000,561,1000,0.561,601,0.601,162,0.162,6
50685,40442,10243,32558,82,73000,567,1000,0.567,605,0.605,172,0.172,6
51250,40841,10409,33159,83,74000,565,1000,0.565,601,0.601,166,0.166,6
51806,41237,10569,33763,84,75000,556,1000,0.556,604,0.604,160,0.16,6
52349,41618,10731,34382,85,76000,543,1000,0.543,619,0.619,162,0.162,6
52860,41956,10904,35044,86,77000,511,1000,0.511,662,0.662,173,0.173,6
53410,42337,11073,35663,87,78000,550,1000,0.55,619,0.619,169,0.169,6
53953,42702,11251,36298,88,79000,543,1000,0.543,635,0.635,178,0.178,6
54471,43060,11411,36940,89,80000,518,1000,0.518,642,0.642,160,0.16,6
55015,43449,11566,37551,90,81000,544,1000,0.544,611,0.611,155,0.155,6
55550,43811,11739,38189,91,82000,535,1000,0.535,638,0.638,173,0.173,6
56073,44156,11917,38844,92,83000,523,1000,0.523,655,0.655,178,0.178,6
56633,44569,12064,39431,93,84000,560,1000,0.56,587,0.587,147,0.147,6
57168,44928,12240,40072,94,85000,535,1000,0.535,641,0.641,176,0.176,6
57670,45231,12439,40769,95,86000,502,1000,0.502,697,0.697,199,0.199,6
58172,45556,12616,41444,96,87000,502,1000,0.502,675,0.675,177,0.177,6
58686,45899,12787,42101,97,88000,514,1000,0.514,657,0.657,171,0.171,6
59205,46257,12948,42743,98,89000,519,1000,0.519,642,0.642,161,0.161,6
59712,46603,13109,43397,99,90000,507,1000,0.507,654,0.654,161,0.161,6
60233,46946,13287,44054,100,91000,521,1000,0.521,657,0.657,178,0.178,6
60756,47289,13467,44711,101,92000,523,1000,0.523,657,0.657,180,0.18,6
61243,47601,13642,45399,102,93000,487,1000,0.487,688,0.688,175,0.175,6
61752,47925,13827,46075,103,94000,509,1000,0.509,676,0.676,185,0.185,6
62259,48268,13991,46732,104,95000,507,1000,0.507,657,0.657,164,0.164,6
62778,48617,14161,47383,105,96000,519,1000,0.519,651,0.651,170,0.17,6
63267,48951,14316,48049,106,97000,489,1000,0.489,666,0.666,155,0.155,6
63762,49265,14497,48735,107,98000,495,1000,0.495,686,0.686,181,0.181,6
64278,49608,14670,49392,108,99000,516,1000,0.516,657,0.657,173,0.173,6
64803,49965,14838,50035,109,100000,525,1000,0.525,643,0.643,168,0.168,6
65315,50313,15002,50687,110,101000,512,1000,0.512,652,0.652,164,0.164,6
65796,50612,15184,51388,111,102000,481,1000,0.481,701,0.701,182,0.182,6
66321,50973,15348,52027,112,103000,525,1000,0.525,639,0.639,164,0.164,6
66828,51318,15510,52682,113,104000,507,1000,0.507,655,0.655,162,0.162,6
67326,51648,15678,53352,114,105000,498,1000,0.498,670,0.67,168,0.168,6
67813,51955,15858,54045,115,106000,487,1000,0.487,693,0.693,180,0.18,6
68302,52277,16025,54723,116,107000,489,1000,0.489,678,0.678,167,0.167,6
68769,52566,16203,55434,117,108000,467,1000,0.467,711,0.711,178,0.178,6
69262,52877,16385,56123,118,109000,493,1000,0.493,689,0.689,182,0.182,6
69770,53223,16547,56777,119,110000,508,1000,0.508,654,0.654,162,0.162,6
70263,53538,16725,57462,120,111000,493,1000,0.493,685,0.685,178,0.178,6
70746,53866,16880,58134,121,112000,483,1000,0.483,672,0.672,155,0.155,6
71229,54196,17033,58804,122,113000,483,1000,0.483,670,0.67,153,0.153,6
71726,54542,17184,59458,123,114000,497,1000,0.497,654,0.654,151,0.151,6
71869,54638,17231,59660,124,114298,143,298,0.4798657718120805,202,0.6778523489932886,47,0.15771812080536912,6
99,98,1,2,1,100,NA,NA,NA,NA,NA,NA,NA,7
199,198,1,2,2,200,100,100,1,0,0,0,0,7
299,298,1,2,3,300,100,100,1,0,0,0,0,7
397,394,3,6,4,400,98,100,0.98,4,0.04,2,0.02,7
496,492,4,8,5,500,99,100,0.99,2,0.02,1,0.01,7
592,584,8,16,6,600,96,100,0.96,8,0.08,4,0.04,7
688,677,11,23,7,700,96,100,0.96,7,0.07,3,0.03,7
785,772,13,28,8,800,97,100,0.97,5,0.05,2,0.02,7
885,872,13,28,9,900,100,100,1,0,0,0,0,7
983,968,15,32,10,1000,98,100,0.98,4,0.04,2,0.02,7
1936,1885,51,115,11,2000,953,1000,0.953,83,0.083,36,0.036,7
2867,2771,96,229,12,3000,931,1000,0.931,114,0.114,45,0.045,7
3780,3625,155,375,13,4000,913,1000,0.913,146,0.146,59,0.059,7
4676,4449,227,551,14,5000,896,1000,0.896,176,0.176,72,0.072,7
5572,5273,299,727,15,6000,896,1000,0.896,176,0.176,72,0.072,7
6460,6100,360,900,16,7000,888,1000,0.888,173,0.173,61,0.061,7
7321,6870,451,1130,17,8000,861,1000,0.861,230,0.23,91,0.091,7
8172,7623,549,1377,18,9000,851,1000,0.851,247,0.247,98,0.098,7
9020,8373,647,1627,19,10000,848,1000,0.848,250,0.25,98,0.098,7
9846,9091,755,1909,20,11000,826,1000,0.826,282,0.282,108,0.108,7
10642,9759,883,2241,21,12000,796,1000,0.796,332,0.332,128,0.128,7
11461,10479,982,2521,22,13000,819,1000,0.819,280,0.28,99,0.099,7
12267,11175,1092,2825,23,14000,806,1000,0.806,304,0.304,110,0.11,7
13073,11877,1196,3123,24,15000,806,1000,0.806,298,0.298,104,0.104,7
13862,12544,1318,3456,25,16000,789,1000,0.789,333,0.333,122,0.122,7
14658,13235,1423,3765,26,17000,796,1000,0.796,309,0.309,105,0.105,7
15416,13859,1557,4141,27,18000,758,1000,0.758,376,0.376,134,0.134,7
16188,14510,1678,4490,28,19000,772,1000,0.772,349,0.349,121,0.121,7
16933,15119,1814,4881,29,20000,745,1000,0.745,391,0.391,136,0.136,7
17702,15768,1934,5232,30,21000,769,1000,0.769,351,0.351,120,0.12,7
18420,16344,2076,5656,31,22000,718,1000,0.718,424,0.424,142,0.142,7
19139,16909,2230,6091,32,23000,719,1000,0.719,435,0.435,154,0.154,7
19856,17496,2360,6504,33,24000,717,1000,0.717,413,0.413,130,0.13,7
20592,18097,2495,6903,34,25000,736,1000,0.736,399,0.399,135,0.135,7
21285,18646,2639,7354,35,26000,693,1000,0.693,451,0.451,144,0.144,7
22013,19238,2775,7762,36,27000,728,1000,0.728,408,0.408,136,0.136,7
22706,19784,2922,8216,37,28000,693,1000,0.693,454,0.454,147,0.147,7
23412,20347,3065,8653,38,29000,706,1000,0.706,437,0.437,143,0.143,7
24084,20867,3217,9133,39,30000,672,1000,0.672,480,0.48,152,0.152,7
24757,21371,3386,9629,40,31000,673,1000,0.673,496,0.496,169,0.169,7
25458,21938,3520,10062,41,32000,701,1000,0.701,433,0.433,134,0.134,7
26165,22514,3651,10486,42,33000,707,1000,0.707,424,0.424,131,0.131,7
26847,23054,3793,10946,43,34000,682,1000,0.682,460,0.46,142,0.142,7
27530,23591,3939,11409,44,35000,683,1000,0.683,463,0.463,146,0.146,7
28210,24124,4086,11876,45,36000,680,1000,0.68,467,0.467,147,0.147,7
28872,24620,4252,12380,46,37000,662,1000,0.662,504,0.504,166,0.166,7
29548,25145,4403,12855,47,38000,676,1000,0.676,475,0.475,151,0.151,7
30213,25649,4564,13351,48,39000,665,1000,0.665,496,0.496,161,0.161,7
30864,26145,4719,13855,49,40000,651,1000,0.651,504,0.504,155,0.155,7
31528,26642,4886,14358,50,41000,664,1000,0.664,503,0.503,167,0.167,7
32183,27131,5052,14869,51,42000,655,1000,0.655,511,0.511,166,0.166,7
32827,27621,5206,15379,52,43000,644,1000,0.644,510,0.51,154,0.154,7
33477,28108,5369,15892,53,44000,650,1000,0.65,513,0.513,163,0.163,7
34132,28613,5519,16387,54,45000,655,1000,0.655,495,0.495,150,0.15,7
34760,29086,5674,16914,55,46000,628,1000,0.628,527,0.527,155,0.155,7
35408,29590,5818,17410,56,47000,648,1000,0.648,496,0.496,144,0.144,7
36020,30037,5983,17963,57,48000,612,1000,0.612,553,0.553,165,0.165,7
36668,30538,6130,18462,58,49000,648,1000,0.648,499,0.499,147,0.147,7
37284,30977,6307,19023,59,50000,616,1000,0.616,561,0.561,177,0.177,7
37916,31437,6479,19563,60,51000,632,1000,0.632,540,0.54,172,0.172,7
38526,31884,6642,20116,61,52000,610,1000,0.61,553,0.553,163,0.163,7
39148,32331,6817,20669,62,53000,622,1000,0.622,553,0.553,175,0.175,7
39761,32786,6975,21214,63,54000,613,1000,0.613,545,0.545,158,0.158,7
40392,33260,7132,21740,64,55000,631,1000,0.631,526,0.526,157,0.157,7
40978,33699,7279,22301,65,56000,586,1000,0.586,561,0.561,147,0.147,7
41570,34116,7454,22884,66,57000,592,1000,0.592,583,0.583,175,0.175,7
42143,34515,7628,23485,67,58000,573,1000,0.573,601,0.601,174,0.174,7
42709,34901,7808,24099,68,59000,566,1000,0.566,614,0.614,180,0.18,7
43313,35344,7969,24656,69,60000,604,1000,0.604,557,0.557,161,0.161,7
43881,35744,8137,25256,70,61000,568,1000,0.568,600,0.6,168,0.168,7
44463,36166,8297,25834,71,62000,582,1000,0.582,578,0.578,160,0.16,7
45036,36572,8464,26428,72,63000,573,1000,0.573,594,0.594,167,0.167,7
45638,37012,8626,26988,73,64000,602,1000,0.602,560,0.56,162,0.162,7
46232,37440,8792,27560,74,65000,594,1000,0.594,572,0.572,166,0.166,7
46819,37882,8937,28118,75,66000,587,1000,0.587,558,0.558,145,0.145,7
47370,38261,9109,28739,76,67000,551,1000,0.551,621,0.621,172,0.172,7
47923,38635,9288,29365,77,68000,553,1000,0.553,626,0.626,179,0.179,7
48512,39065,9447,29935,78,69000,589,1000,0.589,570,0.57,159,0.159,7
49054,39432,9622,30568,79,70000,542,1000,0.542,633,0.633,175,0.175,7
49608,39797,9811,31203,80,71000,554,1000,0.554,635,0.635,189,0.189,7
50130,40123,10007,31877,81,72000,522,1000,0.522,674,0.674,196,0.196,7
50692,40497,10195,32503,82,73000,562,1000,0.562,626,0.626,188,0.188,7
51245,40893,10352,33107,83,74000,553,1000,0.553,604,0.604,157,0.157,7
51797,41282,10515,33718,84,75000,552,1000,0.552,611,0.611,163,0.163,7
52349,41673,10676,34327,85,76000,552,1000,0.552,609,0.609,161,0.161,7
52918,42081,10837,34919,86,77000,569,1000,0.569,592,0.592,161,0.161,7
53463,42460,11003,35540,87,78000,545,1000,0.545,621,0.621,166,0.166,7
54008,42834,11174,36166,88,79000,545,1000,0.545,626,0.626,171,0.171,7
54561,43225,11336,36775,89,80000,553,1000,0.553,609,0.609,162,0.162,7
55115,43617,11498,37383,90,81000,554,1000,0.554,608,0.608,162,0.162,7
55667,43991,11676,38009,91,82000,552,1000,0.552,626,0.626,178,0.178,7
56204,44351,11853,38649,92,83000,537,1000,0.537,640,0.64,177,0.177,7
56730,44691,12039,39309,93,84000,526,1000,0.526,660,0.66,186,0.186,7
57232,45000,12232,40000,94,85000,502,1000,0.502,691,0.691,193,0.193,7
57751,45346,12405,40654,95,86000,519,1000,0.519,654,0.654,173,0.173,7
58257,45676,12581,41324,96,87000,506,1000,0.506,670,0.67,176,0.176,7
58781,46027,12754,41973,97,88000,524,1000,0.524,649,0.649,173,0.173,7
59307,46380,12927,42620,98,89000,526,1000,0.526,647,0.647,173,0.173,7
59826,46732,13094,43268,99,90000,519,1000,0.519,648,0.648,167,0.167,7
60339,47061,13278,43939,100,91000,513,1000,0.513,671,0.671,184,0.184,7
60857,47404,13453,44596,101,92000,518,1000,0.518,657,0.657,175,0.175,7
61379,47755,13624,45245,102,93000,522,1000,0.522,649,0.649,171,0.171,7
61907,48108,13799,45892,103,94000,528,1000,0.528,647,0.647,175,0.175,7
62414,48448,13966,46552,104,95000,507,1000,0.507,660,0.66,167,0.167,7
62902,48768,14134,47232,105,96000,488,1000,0.488,680,0.68,168,0.168,7
63408,49103,14305,47897,106,97000,506,1000,0.506,665,0.665,171,0.171,7
63898,49433,14465,48567,107,98000,490,1000,0.49,670,0.67,160,0.16,7
64410,49775,14635,49225,108,99000,512,1000,0.512,658,0.658,170,0.17,7
64926,50126,14800,49874,109,100000,516,1000,0.516,649,0.649,165,0.165,7
65414,50418,14996,50582,110,101000,488,1000,0.488,708,0.708,196,0.196,7
65907,50743,15164,51257,111,102000,493,1000,0.493,675,0.675,168,0.168,7
66404,51060,15344,51940,112,103000,497,1000,0.497,683,0.683,180,0.18,7
66890,51382,15508,52618,113,104000,486,1000,0.486,678,0.678,164,0.164,7
67409,51731,15678,53269,114,105000,519,1000,0.519,651,0.651,170,0.17,7
67918,52100,15818,53900,115,106000,509,1000,0.509,631,0.631,140,0.14,7
68412,52431,15981,54569,116,107000,494,1000,0.494,669,0.669,163,0.163,7
68894,52739,16155,55261,117,108000,482,1000,0.482,692,0.692,174,0.174,7
69356,53017,16339,55983,118,109000,462,1000,0.462,722,0.722,184,0.184,7
69802,53264,16538,56736,119,110000,446,1000,0.446,753,0.753,199,0.199,7
70284,53573,16711,57427,120,111000,482,1000,0.482,691,0.691,173,0.173,7
70782,53922,16860,58078,121,112000,498,1000,0.498,651,0.651,149,0.149,7
71255,54229,17026,58771,122,113000,473,1000,0.473,693,0.693,166,0.166,7
71725,54539,17186,59461,123,114000,470,1000,0.47,690,0.69,160,0.16,7
71869,54638,17231,59660,124,114298,144,298,0.48322147651006714,199,0.6677852348993288,45,0.15100671140939598,7
100,100,0,0,1,100,NA,NA,NA,NA,NA,NA,NA,8
200,200,0,0,2,200,100,100,1,0,0,0,0,8
300,300,0,0,3,300,100,100,1,0,0,0,0,8
400,400,0,0,4,400,100,100,1,0,0,0,0,8
498,496,2,4,5,500,98,100,0.98,4,0.04,2,0.02,8
596,592,4,8,6,600,98,100,0.98,4,0.04,2,0.02,8
694,689,5,11,7,700,98,100,0.98,3,0.03,1,0.01,8
794,789,5,11,8,800,100,100,1,0,0,0,0,8
887,876,11,24,9,900,93,100,0.93,13,0.13,6,0.06,8
983,968,15,32,10,1000,96,100,0.96,8,0.08,4,0.04,8
1941,1894,47,106,11,2000,958,1000,0.958,74,0.074,32,0.032,8
2875,2779,96,221,12,3000,934,1000,0.934,115,0.115,49,0.049,8
3776,3616,160,384,13,4000,901,1000,0.901,163,0.163,64,0.064,8
4673,4438,235,562,14,5000,897,1000,0.897,178,0.178,75,0.075,8
5536,5208,328,792,15,6000,863,1000,0.863,230,0.23,93,0.093,8
6414,6004,410,996,16,7000,878,1000,0.878,204,0.204,82,0.082,8
7300,6814,486,1186,17,8000,886,1000,0.886,190,0.19,76,0.076,8
8147,7556,591,1444,18,9000,847,1000,0.847,258,0.258,105,0.105,8
8994,8318,676,1682,19,10000,847,1000,0.847,238,0.238,85,0.085,8
9839,9064,775,1936,20,11000,845,1000,0.845,254,0.254,99,0.099,8
10655,9771,884,2229,21,12000,816,1000,0.816,293,0.293,109,0.109,8
11453,10456,997,2544,22,13000,798,1000,0.798,315,0.315,113,0.113,8
12259,11159,1100,2841,23,14000,806,1000,0.806,297,0.297,103,0.103,8
13053,11837,1216,3163,24,15000,794,1000,0.794,322,0.322,116,0.116,8
13844,12508,1336,3492,25,16000,791,1000,0.791,329,0.329,120,0.12,8
14627,13167,1460,3833,26,17000,783,1000,0.783,341,0.341,124,0.124,8
15378,13785,1593,4215,27,18000,751,1000,0.751,382,0.382,133,0.133,8
16123,14394,1729,4606,28,19000,745,1000,0.745,391,0.391,136,0.136,8
16905,15061,1844,4939,29,20000,782,1000,0.782,333,0.333,115,0.115,8
17672,15699,1973,5301,30,21000,767,1000,0.767,362,0.362,129,0.129,8
18428,16326,2102,5674,31,22000,756,1000,0.756,373,0.373,129,0.129,8
19199,16987,2212,6013,32,23000,771,1000,0.771,339,0.339,110,0.11,8
19947,17615,2332,6385,33,24000,748,1000,0.748,372,0.372,120,0.12,8
20641,18167,2474,6833,34,25000,694,1000,0.694,448,0.448,142,0.142,8
21343,18716,2627,7284,35,26000,702,1000,0.702,451,0.451,153,0.153,8
22047,19273,2774,7727,36,27000,704,1000,0.704,443,0.443,147,0.147,8
22754,19826,2928,8174,37,28000,707,1000,0.707,447,0.447,154,0.154,8
23468,20396,3072,8604,38,29000,714,1000,0.714,430,0.43,144,0.144,8
24193,20990,3203,9010,39,30000,725,1000,0.725,406,0.406,131,0.131,8
24876,21520,3356,9480,40,31000,683,1000,0.683,470,0.47,153,0.153,8
25566,22051,3515,9949,41,32000,690,1000,0.69,469,0.469,159,0.159,8
26264,22600,3664,10400,42,33000,698,1000,0.698,451,0.451,149,0.149,8
26937,23113,3824,10887,43,34000,673,1000,0.673,487,0.487,160,0.16,8
27585,23595,3990,11405,44,35000,648,1000,0.648,518,0.518,166,0.166,8
28258,24118,4140,11882,45,36000,673,1000,0.673,477,0.477,150,0.15,8
28929,24639,4290,12361,46,37000,671,1000,0.671,479,0.479,150,0.15,8
29578,25132,4446,12868,47,38000,649,1000,0.649,507,0.507,156,0.156,8
30251,25661,4590,13339,48,39000,673,1000,0.673,471,0.471,144,0.144,8
30899,26136,4763,13864,49,40000,648,1000,0.648,525,0.525,173,0.173,8
31567,26660,4907,14340,50,41000,668,1000,0.668,476,0.476,144,0.144,8
32220,27157,5063,14843,51,42000,653,1000,0.653,503,0.503,156,0.156,8
32831,27616,5215,15384,52,43000,611,1000,0.611,541,0.541,152,0.152,8
33473,28097,5376,15903,53,44000,642,1000,0.642,519,0.519,161,0.161,8
34125,28570,5555,16430,54,45000,652,1000,0.652,527,0.527,179,0.179,8
34768,29056,5712,16944,55,46000,643,1000,0.643,514,0.514,157,0.157,8
35397,29520,5877,17480,56,47000,629,1000,0.629,536,0.536,165,0.165,8
36032,30000,6032,18000,57,48000,635,1000,0.635,520,0.52,155,0.155,8
36642,30454,6188,18546,58,49000,610,1000,0.61,546,0.546,156,0.156,8
37278,30929,6349,19071,59,50000,636,1000,0.636,525,0.525,161,0.161,8
37893,31372,6521,19628,60,51000,615,1000,0.615,557,0.557,172,0.172,8
38506,31820,6686,20180,61,52000,613,1000,0.613,552,0.552,165,0.165,8
39149,32294,6855,20706,62,53000,643,1000,0.643,526,0.526,169,0.169,8
39744,32721,7023,21279,63,54000,595,1000,0.595,573,0.573,168,0.168,8
40350,33177,7173,21823,64,55000,606,1000,0.606,544,0.544,150,0.15,8
40943,33592,7351,22408,65,56000,593,1000,0.593,585,0.585,178,0.178,8
41547,34036,7511,22964,66,57000,604,1000,0.604,556,0.556,160,0.16,8
42126,34448,7678,23552,67,58000,579,1000,0.579,588,0.588,167,0.167,8
42723,34870,7853,24130,68,59000,597,1000,0.597,578,0.578,175,0.175,8
43316,35301,8015,24699,69,60000,593,1000,0.593,569,0.569,162,0.162,8
43907,35739,8168,25261,70,61000,591,1000,0.591,562,0.562,153,0.153,8
44479,36127,8352,25873,71,62000,572,1000,0.572,612,0.612,184,0.184,8
45038,36539,8499,26461,72,63000,559,1000,0.559,588,0.588,147,0.147,8
45635,36967,8668,27033,73,64000,597,1000,0.597,572,0.572,169,0.169,8
46200,37358,8842,27642,74,65000,565,1000,0.565,609,0.609,174,0.174,8
46765,37766,8999,28234,75,66000,565,1000,0.565,592,0.592,157,0.157,8
47320,38139,9181,28861,76,67000,555,1000,0.555,627,0.627,182,0.182,8
47879,38552,9327,29448,77,68000,559,1000,0.559,587,0.587,146,0.146,8
48458,38972,9486,30028,78,69000,579,1000,0.579,580,0.58,159,0.159,8
49022,39361,9661,30639,79,70000,564,1000,0.564,611,0.611,175,0.175,8
49593,39773,9820,31227,80,71000,571,1000,0.571,588,0.588,159,0.159,8
50127,40151,9976,31849,81,72000,534,1000,0.534,622,0.622,156,0.156,8
50708,40586,10122,32414,82,73000,581,1000,0.581,565,0.565,146,0.146,8
51244,40953,10291,33047,83,74000,536,1000,0.536,633,0.633,169,0.169,8
51778,41314,10464,33686,84,75000,534,1000,0.534,639,0.639,173,0.173,8
52347,41725,10622,34275,85,76000,569,1000,0.569,589,0.589,158,0.158,8
52900,42119,10781,34881,86,77000,553,1000,0.553,606,0.606,159,0.159,8
53438,42504,10934,35496,87,78000,538,1000,0.538,615,0.615,153,0.153,8
53963,42875,11088,36125,88,79000,525,1000,0.525,629,0.629,154,0.154,8
54492,43227,11265,36773,89,80000,529,1000,0.529,648,0.648,177,0.177,8
55040,43610,11430,37390,90,81000,548,1000,0.548,617,0.617,165,0.165,8
55567,43965,11602,38035,91,82000,527,1000,0.527,645,0.645,172,0.172,8
56122,44364,11758,38636,92,83000,555,1000,0.555,601,0.601,156,0.156,8
56682,44755,11927,39245,93,84000,560,1000,0.56,609,0.609,169,0.169,8
57219,45125,12094,39875,94,85000,537,1000,0.537,630,0.63,167,0.167,8
57733,45468,12265,40532,95,86000,514,1000,0.514,657,0.657,171,0.171,8
58283,45833,12450,41167,96,87000,550,1000,0.55,635,0.635,185,0.185,8
58795,46191,12604,41809,97,88000,512,1000,0.512,642,0.642,154,0.154,8
59302,46502,12800,42498,98,89000,507,1000,0.507,689,0.689,196,0.196,8
59849,46894,12955,43106,99,90000,547,1000,0.547,608,0.608,155,0.155,8
60354,47219,13135,43781,100,91000,505,1000,0.505,675,0.675,180,0.18,8
60895,47604,13291,44396,101,92000,541,1000,0.541,615,0.615,156,0.156,8
61404,47929,13475,45071,102,93000,509,1000,0.509,675,0.675,184,0.184,8
61901,48242,13659,45758,103,94000,497,1000,0.497,687,0.687,184,0.184,8
62411,48567,13844,46433,104,95000,510,1000,0.51,675,0.675,185,0.185,8
62920,48901,14019,47099,105,96000,509,1000,0.509,666,0.666,175,0.175,8
63454,49273,14181,47727,106,97000,534,1000,0.534,628,0.628,162,0.162,8
63941,49585,14356,48415,107,98000,487,1000,0.487,688,0.688,175,0.175,8
64429,49903,14526,49097,108,99000,488,1000,0.488,682,0.682,170,0.17,8
64927,50230,14697,49770,109,100000,498,1000,0.498,673,0.673,171,0.171,8
65448,50585,14863,50415,110,101000,521,1000,0.521,645,0.645,166,0.166,8
65953,50924,15029,51076,111,102000,505,1000,0.505,661,0.661,166,0.166,8
66474,51279,15195,51721,112,103000,521,1000,0.521,645,0.645,166,0.166,8
66958,51581,15377,52419,113,104000,484,1000,0.484,698,0.698,182,0.182,8
67493,51974,15519,53026,114,105000,535,1000,0.535,607,0.607,142,0.142,8
67943,52242,15701,53758,115,106000,450,1000,0.45,732,0.732,182,0.182,8
68438,52570,15868,54430,116,107000,495,1000,0.495,672,0.672,167,0.167,8
68915,52872,16043,55128,117,108000,477,1000,0.477,698,0.698,175,0.175,8
69404,53189,16215,55811,118,109000,489,1000,0.489,683,0.683,172,0.172,8
69879,53469,16410,56531,119,110000,475,1000,0.475,720,0.72,195,0.195,8
70316,53710,16606,57290,120,111000,437,1000,0.437,759,0.759,196,0.196,8
70786,53992,16794,58008,121,112000,470,1000,0.47,718,0.718,188,0.188,8
71265,54282,16983,58718,122,113000,479,1000,0.479,710,0.71,189,0.189,8
71723,54546,17177,59454,123,114000,458,1000,0.458,736,0.736,194,0.194,8
71869,54638,17231,59660,124,114298,146,298,0.4899328859060403,206,0.6912751677852349,54,0.18120805369127516,8
100,100,0,0,1,100,NA,NA,NA,NA,NA,NA,NA,9
199,198,1,2,2,200,99,100,0.99,2,0.02,1,0.01,9
299,298,1,2,3,300,100,100,1,0,0,0,0,9
399,398,1,2,4,400,100,100,1,0,0,0,0,9
494,488,6,12,5,500,95,100,0.95,10,0.1,5,0.05,9
593,586,7,14,6,600,99,100,0.99,2,0.02,1,0.01,9
692,684,8,16,7,700,99,100,0.99,2,0.02,1,0.01,9
791,782,9,18,8,800,99,100,0.99,2,0.02,1,0.01,9
889,878,11,22,9,900,98,100,0.98,4,0.04,2,0.02,9
988,976,12,24,10,1000,99,100,0.99,2,0.02,1,0.01,9
1931,1875,56,125,11,2000,943,1000,0.943,101,0.101,44,0.044,9
2862,2761,101,239,12,3000,931,1000,0.931,114,0.114,45,0.045,9
3783,3630,153,370,13,4000,921,1000,0.921,131,0.131,52,0.052,9
4684,4459,225,541,14,5000,901,1000,0.901,171,0.171,72,0.072,9
5580,5291,289,709,15,6000,896,1000,0.896,168,0.168,64,0.064,9
6461,6091,370,909,16,7000,881,1000,0.881,200,0.2,81,0.081,9
7330,6878,452,1122,17,8000,869,1000,0.869,213,0.213,82,0.082,9
8190,7669,521,1331,18,9000,860,1000,0.86,209,0.209,69,0.069,9
9028,8405,623,1595,19,10000,838,1000,0.838,264,0.264,102,0.102,9
9868,9146,722,1854,20,11000,840,1000,0.84,259,0.259,99,0.099,9
10679,9842,837,2158,21,12000,811,1000,0.811,304,0.304,115,0.115,9
11487,10537,950,2463,22,13000,808,1000,0.808,305,0.305,113,0.113,9
12295,11239,1056,2761,23,14000,808,1000,0.808,298,0.298,106,0.106,9
13069,11882,1187,3118,24,15000,774,1000,0.774,357,0.357,131,0.131,9
13870,12574,1296,3426,25,16000,801,1000,0.801,308,0.308,109,0.109,9
14635,13217,1418,3783,26,17000,765,1000,0.765,357,0.357,122,0.122,9
15395,13843,1552,4157,27,18000,760,1000,0.76,374,0.374,134,0.134,9
16164,14477,1687,4523,28,19000,769,1000,0.769,366,0.366,135,0.135,9
16928,15116,1812,4884,29,20000,764,1000,0.764,361,0.361,125,0.125,9
17663,15711,1952,5289,30,21000,735,1000,0.735,405,0.405,140,0.14,9
18425,16346,2079,5654,31,22000,762,1000,0.762,365,0.365,127,0.127,9
19172,16964,2208,6036,32,23000,747,1000,0.747,382,0.382,129,0.129,9
19893,17555,2338,6445,33,24000,721,1000,0.721,409,0.409,130,0.13,9
20624,18149,2475,6851,34,25000,731,1000,0.731,406,0.406,137,0.137,9
21343,18727,2616,7273,35,26000,719,1000,0.719,422,0.422,141,0.141,9
22037,19265,2772,7735,36,27000,694,1000,0.694,462,0.462,156,0.156,9
22765,19877,2888,8123,37,28000,728,1000,0.728,388,0.388,116,0.116,9
23454,20408,3046,8592,38,29000,689,1000,0.689,469,0.469,158,0.158,9
24144,20944,3200,9056,39,30000,690,1000,0.69,464,0.464,154,0.154,9
24829,21479,3350,9521,40,31000,685,1000,0.685,465,0.465,150,0.15,9
25511,22015,3496,9985,41,32000,682,1000,0.682,464,0.464,146,0.146,9
26184,22531,3653,10469,42,33000,673,1000,0.673,484,0.484,157,0.157,9
26882,23069,3813,10931,43,34000,698,1000,0.698,462,0.462,160,0.16,9
27542,23575,3967,11425,44,35000,660,1000,0.66,494,0.494,154,0.154,9
28222,24115,4107,11885,45,36000,680,1000,0.68,460,0.46,140,0.14,9
28892,24627,4265,12373,46,37000,670,1000,0.67,488,0.488,158,0.158,9
29551,25120,4431,12880,47,38000,659,1000,0.659,507,0.507,166,0.166,9
30238,25656,4582,13344,48,39000,687,1000,0.687,464,0.464,151,0.151,9
30858,26092,4766,13908,49,40000,620,1000,0.62,564,0.564,184,0.184,9
31485,26536,4949,14464,50,41000,627,1000,0.627,556,0.556,183,0.183,9
32141,27028,5113,14972,51,42000,656,1000,0.656,508,0.508,164,0.164,9
32761,27488,5273,15512,52,43000,620,1000,0.62,540,0.54,160,0.16,9
33396,27966,5430,16034,53,44000,635,1000,0.635,522,0.522,157,0.157,9
34057,28479,5578,16521,54,45000,661,1000,0.661,487,0.487,148,0.148,9
34688,28951,5737,17049,55,46000,631,1000,0.631,528,0.528,159,0.159,9
35306,29402,5904,17598,56,47000,618,1000,0.618,549,0.549,167,0.167,9
35915,29866,6049,18134,57,48000,609,1000,0.609,536,0.536,145,0.145,9
36546,30332,6214,18668,58,49000,631,1000,0.631,534,0.534,165,0.165,9
37192,30810,6382,19190,59,50000,646,1000,0.646,522,0.522,168,0.168,9
37814,31276,6538,19724,60,51000,622,1000,0.622,534,0.534,156,0.156,9
38438,31741,6697,20259,61,52000,624,1000,0.624,535,0.535,159,0.159,9
39040,32189,6851,20811,62,53000,602,1000,0.602,552,0.552,154,0.154,9
39628,32602,7026,21398,63,54000,588,1000,0.588,587,0.587,175,0.175,9
40239,33059,7180,21941,64,55000,611,1000,0.611,543,0.543,154,0.154,9
40840,33502,7338,22498,65,56000,601,1000,0.601,557,0.557,158,0.158,9
41415,33906,7509,23094,66,57000,575,1000,0.575,596,0.596,171,0.171,9
41989,34293,7696,23707,67,58000,574,1000,0.574,613,0.613,187,0.187,9
42593,34727,7866,24273,68,59000,604,1000,0.604,566,0.566,170,0.17,9
43198,35183,8015,24817,69,60000,605,1000,0.605,544,0.544,149,0.149,9
43774,35587,8187,25413,70,61000,576,1000,0.576,596,0.596,172,0.172,9
44354,35998,8356,26002,71,62000,580,1000,0.58,589,0.589,169,0.169,9
44966,36470,8496,26530,72,63000,612,1000,0.612,528,0.528,140,0.14,9
45548,36892,8656,27108,73,64000,582,1000,0.582,578,0.578,160,0.16,9
46120,37287,8833,27713,74,65000,572,1000,0.572,605,0.605,177,0.177,9
46686,37679,9007,28321,75,66000,566,1000,0.566,608,0.608,174,0.174,9
47269,38102,9167,28898,76,67000,583,1000,0.583,577,0.577,160,0.16,9
47848,38514,9334,29486,77,68000,579,1000,0.579,588,0.588,167,0.167,9
48429,38928,9501,30072,78,69000,581,1000,0.581,586,0.586,167,0.167,9
48992,39335,9657,30665,79,70000,563,1000,0.563,593,0.593,156,0.156,9
49553,39731,9822,31269,80,71000,561,1000,0.561,604,0.604,165,0.165,9
50136,40150,9986,31850,81,72000,583,1000,0.583,581,0.581,164,0.164,9
50667,40521,10146,32479,82,73000,531,1000,0.531,629,0.629,160,0.16,9
51219,40913,10306,33087,83,74000,552,1000,0.552,608,0.608,160,0.16,9
51777,41300,10477,33700,84,75000,558,1000,0.558,613,0.613,171,0.171,9
52333,41698,10635,34302,85,76000,556,1000,0.556,602,0.602,158,0.158,9
52909,42127,10782,34873,86,77000,576,1000,0.576,571,0.571,147,0.147,9
53449,42502,10947,35498,87,78000,540,1000,0.54,625,0.625,165,0.165,9
53993,42867,11126,36133,88,79000,544,1000,0.544,635,0.635,179,0.179,9
54509,43203,11306,36797,89,80000,516,1000,0.516,664,0.664,180,0.18,9
55039,43573,11466,37427,90,81000,530,1000,0.53,630,0.63,160,0.16,9
55556,43922,11634,38078,91,82000,517,1000,0.517,651,0.651,168,0.168,9
56100,44300,11800,38700,92,83000,544,1000,0.544,622,0.622,166,0.166,9
56615,44638,11977,39362,93,84000,515,1000,0.515,662,0.662,177,0.177,9
57137,44992,12145,40008,94,85000,522,1000,0.522,646,0.646,168,0.168,9
57681,45364,12317,40636,95,86000,544,1000,0.544,628,0.628,172,0.172,9
58200,45701,12499,41299,96,87000,519,1000,0.519,663,0.663,182,0.182,9
58705,46021,12684,41979,97,88000,505,1000,0.505,680,0.68,185,0.185,9
59238,46397,12841,42603,98,89000,533,1000,0.533,624,0.624,157,0.157,9
59770,46749,13021,43251,99,90000,532,1000,0.532,648,0.648,180,0.18,9
60310,47133,13177,43867,100,91000,540,1000,0.54,616,0.616,156,0.156,9
60856,47507,13349,44493,101,92000,546,1000,0.546,626,0.626,172,0.172,9
61389,47858,13531,45142,102,93000,533,1000,0.533,649,0.649,182,0.182,9
61913,48220,13693,45780,103,94000,524,1000,0.524,638,0.638,162,0.162,9
62414,48552,13862,46448,104,95000,501,1000,0.501,668,0.668,169,0.169,9
62915,48887,14028,47113,105,96000,501,1000,0.501,665,0.665,166,0.166,9
63422,49219,14203,47781,106,97000,507,1000,0.507,668,0.668,175,0.175,9
63949,49575,14374,48425,107,98000,527,1000,0.527,644,0.644,171,0.171,9
64447,49895,14552,49105,108,99000,498,1000,0.498,680,0.68,178,0.178,9
64938,50201,14737,49799,109,100000,491,1000,0.491,694,0.694,185,0.185,9
65463,50550,14913,50450,110,101000,525,1000,0.525,651,0.651,176,0.176,9
65946,50850,15096,51150,111,102000,483,1000,0.483,700,0.7,183,0.183,9
66427,51152,15275,51848,112,103000,481,1000,0.481,698,0.698,179,0.179,9
66938,51491,15447,52509,113,104000,511,1000,0.511,661,0.661,172,0.172,9
67445,51855,15590,53145,114,105000,507,1000,0.507,636,0.636,143,0.143,9
67923,52147,15776,53853,115,106000,478,1000,0.478,708,0.708,186,0.186,9
68388,52434,15954,54566,116,107000,465,1000,0.465,713,0.713,178,0.178,9
68859,52742,16117,55258,117,108000,471,1000,0.471,692,0.692,163,0.163,9
69365,53075,16290,55925,118,109000,506,1000,0.506,667,0.667,173,0.173,9
69847,53366,16481,56634,119,110000,482,1000,0.482,709,0.709,191,0.191,9
70347,53701,16646,57299,120,111000,500,1000,0.5,665,0.665,165,0.165,9
70786,53961,16825,58039,121,112000,439,1000,0.439,740,0.74,179,0.179,9
71252,54255,16997,58745,122,113000,466,1000,0.466,706,0.706,172,0.172,9
71724,54541,17183,59459,123,114000,472,1000,0.472,714,0.714,186,0.186,9
71869,54638,17231,59660,124,114298,145,298,0.4865771812080537,201,0.674496644295302,48,0.1610738255033557,9
100,100,0,0,1,100,NA,NA,NA,NA,NA,NA,NA,10
200,200,0,0,2,200,100,100,1,0,0,0,0,10
300,300,0,0,3,300,100,100,1,0,0,0,0,10
397,395,2,5,4,400,97,100,0.97,5,0.05,2,0.02,10
494,489,5,11,5,500,97,100,0.97,6,0.06,3,0.03,10
592,585,7,15,6,600,98,100,0.98,4,0.04,2,0.02,10
690,681,9,19,7,700,98,100,0.98,4,0.04,2,0.02,10
787,776,11,24,8,800,97,100,0.97,5,0.05,2,0.02,10
884,870,14,30,9,900,97,100,0.97,6,0.06,3,0.03,10
980,964,16,36,10,1000,96,100,0.96,6,0.06,2,0.02,10
1940,1897,43,103,11,2000,960,1000,0.96,67,0.067,27,0.027,10
2864,2762,102,238,12,3000,924,1000,0.924,135,0.135,59,0.059,10
3773,3609,164,391,13,4000,909,1000,0.909,153,0.153,62,0.062,10
4644,4392,252,608,14,5000,871,1000,0.871,217,0.217,88,0.088,10
5514,5180,334,820,15,6000,870,1000,0.87,212,0.212,82,0.082,10
6385,5977,408,1023,16,7000,871,1000,0.871,203,0.203,74,0.074,10
7244,6746,498,1254,17,8000,859,1000,0.859,231,0.231,90,0.09,10
8086,7496,590,1504,18,9000,842,1000,0.842,250,0.25,92,0.092,10
8923,8227,696,1773,19,10000,837,1000,0.837,269,0.269,106,0.106,10
9749,8959,790,2041,20,11000,826,1000,0.826,268,0.268,94,0.094,10
10574,9685,889,2315,21,12000,825,1000,0.825,274,0.274,99,0.099,10
11380,10374,1006,2626,22,13000,806,1000,0.806,311,0.311,117,0.117,10
12147,11008,1139,2992,23,14000,767,1000,0.767,366,0.366,133,0.133,10
12970,11732,1238,3268,24,15000,823,1000,0.823,276,0.276,99,0.099,10
13784,12439,1345,3561,25,16000,814,1000,0.814,293,0.293,107,0.107,10
14564,13104,1460,3896,26,17000,780,1000,0.78,335,0.335,115,0.115,10
15325,13741,1584,4259,27,18000,761,1000,0.761,363,0.363,124,0.124,10
16071,14349,1722,4651,28,19000,746,1000,0.746,392,0.392,138,0.138,10
16803,14946,1857,5054,29,20000,732,1000,0.732,403,0.403,135,0.135,10
17545,15546,1999,5454,30,21000,742,1000,0.742,400,0.4,142,0.142,10
18305,16178,2127,5822,31,22000,760,1000,0.76,368,0.368,128,0.128,10
19054,16795,2259,6205,32,23000,749,1000,0.749,383,0.383,132,0.132,10
19805,17412,2393,6588,33,24000,751,1000,0.751,383,0.383,134,0.134,10
20512,17971,2541,7029,34,25000,707,1000,0.707,441,0.441,148,0.148,10
21225,18534,2691,7466,35,26000,713,1000,0.713,437,0.437,150,0.15,10
21941,19103,2838,7897,36,27000,716,1000,0.716,431,0.431,147,0.147,10
22634,19637,2997,8363,37,28000,693,1000,0.693,466,0.466,159,0.159,10
23331,20186,3145,8814,38,29000,697,1000,0.697,451,0.451,148,0.148,10
24028,20740,3288,9260,39,30000,697,1000,0.697,446,0.446,143,0.143,10
24707,21287,3420,9713,40,31000,679,1000,0.679,453,0.453,132,0.132,10
25403,21837,3566,10163,41,32000,696,1000,0.696,450,0.45,146,0.146,10
26069,22349,3720,10651,42,33000,666,1000,0.666,488,0.488,154,0.154,10
26744,22876,3868,11124,43,34000,675,1000,0.675,473,0.473,148,0.148,10
27393,23352,4041,11648,44,35000,649,1000,0.649,524,0.524,173,0.173,10
28048,23829,4219,12171,45,36000,655,1000,0.655,523,0.523,178,0.178,10
28705,24322,4383,12678,46,37000,657,1000,0.657,507,0.507,164,0.164,10
29363,24833,4530,13167,47,38000,658,1000,0.658,489,0.489,147,0.147,10
30014,25337,4677,13663,48,39000,651,1000,0.651,496,0.496,147,0.147,10
30661,25816,4845,14184,49,40000,647,1000,0.647,521,0.521,168,0.168,10
31340,26350,4990,14650,50,41000,679,1000,0.679,466,0.466,145,0.145,10
31953,26790,5163,15210,51,42000,613,1000,0.613,560,0.56,173,0.173,10
32598,27275,5323,15725,52,43000,645,1000,0.645,515,0.515,160,0.16,10
33251,27778,5473,16222,53,44000,653,1000,0.653,497,0.497,150,0.15,10
33873,28225,5648,16775,54,45000,622,1000,0.622,553,0.553,175,0.175,10
34509,28711,5798,17289,55,46000,636,1000,0.636,514,0.514,150,0.15,10
35151,29202,5949,17798,56,47000,642,1000,0.642,509,0.509,151,0.151,10
35779,29672,6107,18328,57,48000,628,1000,0.628,530,0.53,158,0.158,10
36405,30141,6264,18859,58,49000,626,1000,0.626,531,0.531,157,0.157,10
37020,30600,6420,19400,59,50000,615,1000,0.615,541,0.541,156,0.156,10
37616,31024,6592,19976,60,51000,596,1000,0.596,576,0.576,172,0.172,10
38215,31442,6773,20558,61,52000,599,1000,0.599,582,0.582,181,0.181,10
38810,31862,6948,21138,62,53000,595,1000,0.595,580,0.58,175,0.175,10
39418,32301,7117,21699,63,54000,608,1000,0.608,561,0.561,169,0.169,10
40029,32751,7278,22249,64,55000,611,1000,0.611,550,0.55,161,0.161,10
40627,33181,7446,22819,65,56000,598,1000,0.598,570,0.57,168,0.168,10
41233,33647,7586,23353,66,57000,606,1000,0.606,534,0.534,140,0.14,10
41821,34061,7760,23939,67,58000,588,1000,0.588,586,0.586,174,0.174,10
42415,34488,7927,24512,68,59000,594,1000,0.594,573,0.573,167,0.167,10
42996,34886,8110,25114,69,60000,581,1000,0.581,602,0.602,183,0.183,10
43595,35328,8267,25672,70,61000,599,1000,0.599,558,0.558,157,0.157,10
44193,35772,8421,26228,71,62000,598,1000,0.598,556,0.556,154,0.154,10
44778,36193,8585,26807,72,63000,585,1000,0.585,579,0.579,164,0.164,10
45367,36624,8743,27376,73,64000,589,1000,0.589,569,0.569,158,0.158,10
45953,37048,8905,27952,74,65000,586,1000,0.586,576,0.576,162,0.162,10
46539,37462,9077,28538,75,66000,586,1000,0.586,586,0.586,172,0.172,10
47086,37818,9268,29182,76,67000,547,1000,0.547,644,0.644,191,0.191,10
47674,38246,9428,29754,77,68000,588,1000,0.588,572,0.572,160,0.16,10
48237,38637,9600,30363,78,69000,563,1000,0.563,609,0.609,172,0.172,10
48801,39045,9756,30955,79,70000,564,1000,0.564,592,0.592,156,0.156,10
49364,39460,9904,31540,80,71000,563,1000,0.563,585,0.585,148,0.148,10
49911,39823,10088,32177,81,72000,547,1000,0.547,637,0.637,184,0.184,10
50460,40214,10246,32786,82,73000,549,1000,0.549,609,0.609,158,0.158,10
51018,40593,10425,33407,83,74000,558,1000,0.558,621,0.621,179,0.179,10
51553,40957,10596,34043,84,75000,535,1000,0.535,636,0.636,171,0.171,10
52122,41353,10769,34647,85,76000,569,1000,0.569,604,0.604,173,0.173,10
52668,41710,10958,35290,86,77000,546,1000,0.546,643,0.643,189,0.189,10
53220,42097,11123,35903,87,78000,552,1000,0.552,613,0.613,165,0.165,10
53785,42496,11289,36504,88,79000,565,1000,0.565,601,0.601,166,0.166,10
54318,42855,11463,37145,89,80000,533,1000,0.533,641,0.641,174,0.174,10
54855,43218,11637,37782,90,81000,537,1000,0.537,637,0.637,174,0.174,10
55386,43561,11825,38439,91,82000,531,1000,0.531,657,0.657,188,0.188,10
55921,43927,11994,39073,92,83000,535,1000,0.535,634,0.634,169,0.169,10
56450,44294,12156,39706,93,84000,529,1000,0.529,633,0.633,162,0.162,10
56943,44609,12334,40391,94,85000,493,1000,0.493,685,0.685,178,0.178,10
57490,44983,12507,41017,95,86000,547,1000,0.547,626,0.626,173,0.173,10
58012,45340,12672,41660,96,87000,522,1000,0.522,643,0.643,165,0.165,10
58551,45731,12820,42269,97,88000,539,1000,0.539,609,0.609,148,0.148,10
59094,46109,12985,42891,98,89000,543,1000,0.543,622,0.622,165,0.165,10
59625,46495,13130,43505,99,90000,531,1000,0.531,614,0.614,145,0.145,10
60130,46829,13301,44171,100,91000,505,1000,0.505,666,0.666,171,0.171,10
60654,47191,13463,44809,101,92000,524,1000,0.524,638,0.638,162,0.162,10
61182,47557,13625,45443,102,93000,528,1000,0.528,634,0.634,162,0.162,10
61706,47917,13789,46083,103,94000,524,1000,0.524,640,0.64,164,0.164,10
62212,48276,13936,46724,104,95000,506,1000,0.506,641,0.641,147,0.147,10
62722,48615,14107,47385,105,96000,510,1000,0.51,661,0.661,171,0.171,10
63206,48929,14277,48071,106,97000,484,1000,0.484,686,0.686,170,0.17,10
63718,49273,14445,48727,107,98000,512,1000,0.512,656,0.656,168,0.168,10
64216,49604,14612,49396,108,99000,498,1000,0.498,669,0.669,167,0.167,10
64748,49958,14790,50042,109,100000,532,1000,0.532,646,0.646,178,0.178,10
65272,50302,14970,50698,110,101000,524,1000,0.524,656,0.656,180,0.18,10
65751,50605,15146,51395,111,102000,479,1000,0.479,697,0.697,176,0.176,10
66252,50941,15311,52059,112,103000,501,1000,0.501,664,0.664,165,0.165,10
66751,51267,15484,52733,113,104000,499,1000,0.499,674,0.674,173,0.173,10
67263,51625,15638,53375,114,105000,512,1000,0.512,642,0.642,154,0.154,10
67776,51973,15803,54027,115,106000,513,1000,0.513,652,0.652,165,0.165,10
68269,52289,15980,54711,116,107000,493,1000,0.493,684,0.684,177,0.177,10
68755,52587,16168,55413,117,108000,486,1000,0.486,702,0.702,188,0.188,10
69290,52966,16324,56034,118,109000,535,1000,0.535,621,0.621,156,0.156,10
69796,53307,16489,56693,119,110000,506,1000,0.506,659,0.659,165,0.165,10
70293,53618,16675,57382,120,111000,497,1000,0.497,689,0.689,186,0.186,10
70756,53918,16838,58082,121,112000,463,1000,0.463,700,0.7,163,0.163,10
71234,54217,17017,58783,122,113000,478,1000,0.478,701,0.701,179,0.179,10
71717,54533,17184,59467,123,114000,483,1000,0.483,684,0.684,167,0.167,10
71869,54638,17231,59660,124,114298,152,298,0.5100671140939598,193,0.6476510067114094,47,0.15771812080536912,10
99,98,1,2,1,100,NA,NA,NA,NA,NA,NA,NA,11
199,198,1,2,2,200,100,100,1,0,0,0,0,11
298,296,2,4,3,300,99,100,0.99,2,0.02,1,0.01,11
398,396,2,4,4,400,100,100,1,0,0,0,0,11
496,493,3,7,5,500,98,100,0.98,3,0.03,1,0.01,11
595,592,3,8,6,600,99,100,0.99,1,0.01,0,0,11
694,690,4,10,7,700,99,100,0.99,2,0.02,1,0.01,11
789,781,8,19,8,800,95,100,0.95,9,0.09,4,0.04,11
887,877,10,23,9,900,98,100,0.98,4,0.04,2,0.02,11
983,970,13,30,10,1000,96,100,0.96,7,0.07,3,0.03,11
1935,1886,49,114,11,2000,952,1000,0.952,84,0.084,36,0.036,11
2869,2776,93,224,12,3000,934,1000,0.934,110,0.11,44,0.044,11
3795,3648,147,352,13,4000,926,1000,0.926,128,0.128,54,0.054,11
4682,4462,220,538,14,5000,887,1000,0.887,186,0.186,73,0.073,11
5584,5301,283,699,15,6000,902,1000,0.902,161,0.161,63,0.063,11
6458,6086,372,914,16,7000,874,1000,0.874,215,0.215,89,0.089,11
7304,6835,469,1165,17,8000,846,1000,0.846,251,0.251,97,0.097,11
8157,7600,557,1400,18,9000,853,1000,0.853,235,0.235,88,0.088,11
8995,8345,650,1655,19,10000,838,1000,0.838,255,0.255,93,0.093,11
9840,9098,742,1902,20,11000,845,1000,0.845,247,0.247,92,0.092,11
10661,9813,848,2187,21,12000,821,1000,0.821,285,0.285,106,0.106,11
11462,10504,958,2496,22,13000,801,1000,0.801,309,0.309,110,0.11,11
12260,11196,1064,2804,23,14000,798,1000,0.798,308,0.308,106,0.106,11
13046,11853,1193,3147,24,15000,786,1000,0.786,343,0.343,129,0.129,11
13846,12528,1318,3472,25,16000,800,1000,0.8,325,0.325,125,0.125,11
14620,13183,1437,3817,26,17000,774,1000,0.774,345,0.345,119,0.119,11
15384,13821,1563,4179,27,18000,764,1000,0.764,362,0.362,126,0.126,11
16141,14437,1704,4563,28,19000,757,1000,0.757,384,0.384,141,0.141,11
16895,15074,1821,4926,29,20000,754,1000,0.754,363,0.363,117,0.117,11
17624,15658,1966,5342,30,21000,729,1000,0.729,416,0.416,145,0.145,11
18377,16285,2092,5715,31,22000,753,1000,0.753,373,0.373,126,0.126,11
19123,16905,2218,6095,32,23000,746,1000,0.746,380,0.38,126,0.126,11
19859,17513,2346,6487,33,24000,736,1000,0.736,392,0.392,128,0.128,11
20582,18084,2498,6916,34,25000,723,1000,0.723,429,0.429,152,0.152,11
21316,18682,2634,7318,35,26000,734,1000,0.734,402,0.402,136,0.136,11
22038,19266,2772,7734,36,27000,722,1000,0.722,416,0.416,138,0.138,11
22746,19828,2918,8172,37,28000,708,1000,0.708,438,0.438,146,0.146,11
23438,20370,3068,8630,38,29000,692,1000,0.692,458,0.458,150,0.15,11
24130,20913,3217,9087,39,30000,692,1000,0.692,457,0.457,149,0.149,11
24804,21434,3370,9566,40,31000,674,1000,0.674,479,0.479,153,0.153,11
25475,21945,3530,10055,41,32000,671,1000,0.671,489,0.489,160,0.16,11
26151,22464,3687,10536,42,33000,676,1000,0.676,481,0.481,157,0.157,11
26841,23003,3838,10997,43,34000,690,1000,0.69,461,0.461,151,0.151,11
27512,23526,3986,11474,44,35000,671,1000,0.671,477,0.477,148,0.148,11
28172,24042,4130,11958,45,36000,660,1000,0.66,484,0.484,144,0.144,11
28826,24532,4294,12468,46,37000,654,1000,0.654,510,0.51,164,0.164,11
29480,25019,4461,12981,47,38000,654,1000,0.654,513,0.513,167,0.167,11
30152,25552,4600,13448,48,39000,672,1000,0.672,467,0.467,139,0.139,11
30797,26044,4753,13956,49,40000,645,1000,0.645,508,0.508,153,0.153,11
31465,26564,4901,14436,50,41000,668,1000,0.668,480,0.48,148,0.148,11
32130,27068,5062,14932,51,42000,665,1000,0.665,496,0.496,161,0.161,11
32788,27564,5224,15436,52,43000,658,1000,0.658,504,0.504,162,0.162,11
33444,28086,5358,15914,53,44000,656,1000,0.656,478,0.478,134,0.134,11
34059,28535,5524,16465,54,45000,615,1000,0.615,551,0.551,166,0.166,11
34707,29033,5674,16967,55,46000,648,1000,0.648,502,0.502,150,0.15,11
35332,29497,5835,17503,56,47000,625,1000,0.625,536,0.536,161,0.161,11
35972,29985,5987,18015,57,48000,640,1000,0.64,512,0.512,152,0.152,11
36578,30414,6164,18586,58,49000,606,1000,0.606,571,0.571,177,0.177,11
37192,30880,6312,19120,59,50000,614,1000,0.614,534,0.534,148,0.148,11
37800,31325,6475,19675,60,51000,608,1000,0.608,555,0.555,163,0.163,11
38419,31784,6635,20216,61,52000,619,1000,0.619,541,0.541,160,0.16,11
39042,32246,6796,20754,62,53000,623,1000,0.623,538,0.538,161,0.161,11
39651,32691,6960,21309,63,54000,609,1000,0.609,555,0.555,164,0.164,11
40244,33120,7124,21880,64,55000,593,1000,0.593,571,0.571,164,0.164,11
40828,33534,7294,22466,65,56000,584,1000,0.584,586,0.586,170,0.17,11
41412,33935,7477,23065,66,57000,584,1000,0.584,599,0.599,183,0.183,11
42021,34374,7647,23626,67,58000,609,1000,0.609,561,0.561,170,0.17,11
42601,34785,7816,24215,68,59000,580,1000,0.58,589,0.589,169,0.169,11
43173,35175,7998,24825,69,60000,572,1000,0.572,610,0.61,182,0.182,11
43718,35522,8196,25478,70,61000,545,1000,0.545,653,0.653,198,0.198,11
44308,35934,8374,26066,71,62000,590,1000,0.59,588,0.588,178,0.178,11
44881,36333,8548,26667,72,63000,573,1000,0.573,601,0.601,174,0.174,11
45453,36736,8717,27264,73,64000,572,1000,0.572,597,0.597,169,0.169,11
46027,37144,8883,27856,74,65000,574,1000,0.574,592,0.592,166,0.166,11
46626,37596,9030,28404,75,66000,599,1000,0.599,548,0.548,147,0.147,11
47195,37999,9196,29001,76,67000,569,1000,0.569,597,0.597,166,0.166,11
47762,38393,9369,29607,77,68000,567,1000,0.567,606,0.606,173,0.173,11
48337,38811,9526,30189,78,69000,575,1000,0.575,582,0.582,157,0.157,11
48879,39184,9695,30816,79,70000,542,1000,0.542,627,0.627,169,0.169,11
49441,39588,9853,31412,80,71000,562,1000,0.562,596,0.596,158,0.158,11
49997,39984,10013,32016,81,72000,556,1000,0.556,604,0.604,160,0.16,11
50537,40357,10180,32643,82,73000,540,1000,0.54,627,0.627,167,0.167,11
51062,40726,10336,33274,83,74000,525,1000,0.525,631,0.631,156,0.156,11
51631,41127,10504,33873,84,75000,569,1000,0.569,599,0.599,168,0.168,11
52204,41547,10657,34453,85,76000,573,1000,0.573,580,0.58,153,0.153,11
52770,41958,10812,35042,86,77000,566,1000,0.566,589,0.589,155,0.155,11
53324,42335,10989,35665,87,78000,554,1000,0.554,623,0.623,177,0.177,11
53875,42718,11157,36282,88,79000,551,1000,0.551,617,0.617,168,0.168,11
54436,43132,11304,36868,89,80000,561,1000,0.561,586,0.586,147,0.147,11
54997,43527,11470,37473,90,81000,561,1000,0.561,605,0.605,166,0.166,11
55524,43858,11666,38142,91,82000,527,1000,0.527,669,0.669,196,0.196,11
56076,44231,11845,38769,92,83000,552,1000,0.552,627,0.627,179,0.179,11
56627,44609,12018,39391,93,84000,551,1000,0.551,622,0.622,173,0.173,11
57114,44909,12205,40091,94,85000,487,1000,0.487,700,0.7,187,0.187,11
57661,45308,12353,40692,95,86000,547,1000,0.547,601,0.601,148,0.148,11
58193,45684,12509,41316,96,87000,532,1000,0.532,624,0.624,156,0.156,11
58705,46028,12677,41972,97,88000,512,1000,0.512,656,0.656,168,0.168,11
59266,46421,12845,42579,98,89000,561,1000,0.561,607,0.607,168,0.168,11
59786,46772,13014,43228,99,90000,520,1000,0.52,649,0.649,169,0.169,11
60315,47144,13171,43856,100,91000,529,1000,0.529,628,0.628,157,0.157,11
60857,47526,13331,44474,101,92000,542,1000,0.542,618,0.618,160,0.16,11
61370,47841,13529,45159,102,93000,513,1000,0.513,685,0.685,198,0.198,11
61899,48214,13685,45786,103,94000,529,1000,0.529,627,0.627,156,0.156,11
62414,48554,13860,46446,104,95000,515,1000,0.515,660,0.66,175,0.175,11
62885,48830,14055,47170,105,96000,471,1000,0.471,724,0.724,195,0.195,11
63409,49201,14208,47799,106,97000,524,1000,0.524,629,0.629,153,0.153,11
63915,49526,14389,48474,107,98000,506,1000,0.506,675,0.675,181,0.181,11
64415,49840,14575,49160,108,99000,500,1000,0.5,686,0.686,186,0.186,11
64906,50153,14753,49847,109,100000,491,1000,0.491,687,0.687,178,0.178,11
65407,50489,14918,50511,110,101000,501,1000,0.501,664,0.664,165,0.165,11
65903,50810,15093,51190,111,102000,496,1000,0.496,679,0.679,175,0.175,11
66392,51135,15257,51865,112,103000,489,1000,0.489,675,0.675,164,0.164,11
66889,51459,15430,52541,113,104000,497,1000,0.497,676,0.676,173,0.173,11
67380,51779,15601,53221,114,105000,491,1000,0.491,680,0.68,171,0.171,11
67847,52059,15788,53941,115,106000,467,1000,0.467,720,0.72,187,0.187,11
68345,52392,15953,54608,116,107000,498,1000,0.498,667,0.667,165,0.165,11
68857,52746,16111,55254,117,108000,512,1000,0.512,646,0.646,158,0.158,11
69339,53049,16290,55951,118,109000,482,1000,0.482,697,0.697,179,0.179,11
69822,53377,16445,56623,119,110000,483,1000,0.483,672,0.672,155,0.155,11
70306,53692,16614,57308,120,111000,484,1000,0.484,685,0.685,169,0.169,11
70790,53995,16795,58005,121,112000,484,1000,0.484,697,0.697,181,0.181,11
71249,54260,16989,58740,122,113000,459,1000,0.459,735,0.735,194,0.194,11
71726,54550,17176,59450,123,114000,477,1000,0.477,710,0.71,187,0.187,11
71869,54638,17231,59660,124,114298,143,298,0.4798657718120805,210,0.7046979865771812,55,0.18456375838926176,11
99,98,1,2,1,100,NA,NA,NA,NA,NA,NA,NA,12
198,196,2,4,2,200,99,100,0.99,2,0.02,1,0.01,12
298,296,2,4,3,300,100,100,1,0,0,0,0,12
397,394,3,6,4,400,99,100,0.99,2,0.02,1,0.01,12
496,492,4,8,5,500,99,100,0.99,2,0.02,1,0.01,12
595,590,5,10,6,600,99,100,0.99,2,0.02,1,0.01,12
694,688,6,12,7,700,99,100,0.99,2,0.02,1,0.01,12
793,786,7,14,8,800,99,100,0.99,2,0.02,1,0.01,12
889,878,11,22,9,900,96,100,0.96,8,0.08,4,0.04,12
983,966,17,34,10,1000,94,100,0.94,12,0.12,6,0.06,12
1937,1883,54,117,11,2000,954,1000,0.954,83,0.083,37,0.037,12
2880,2786,94,214,12,3000,943,1000,0.943,97,0.097,40,0.04,12
3804,3656,148,344,13,4000,924,1000,0.924,130,0.13,54,0.054,12
4701,4483,218,517,14,5000,897,1000,0.897,173,0.173,70,0.07,12
5592,5301,291,699,15,6000,891,1000,0.891,182,0.182,73,0.073,12
6475,6100,375,900,16,7000,883,1000,0.883,201,0.201,84,0.084,12
7344,6873,471,1127,17,8000,869,1000,0.869,227,0.227,96,0.096,12
8213,7664,549,1336,18,9000,869,1000,0.869,209,0.209,78,0.078,12
9061,8413,648,1587,19,10000,848,1000,0.848,251,0.251,99,0.099,12
9869,9090,779,1910,20,11000,808,1000,0.808,323,0.323,131,0.131,12
10686,9797,889,2203,21,12000,817,1000,0.817,293,0.293,110,0.11,12
11497,10488,1009,2512,22,13000,811,1000,0.811,309,0.309,120,0.12,12
12293,11175,1118,2825,23,14000,796,1000,0.796,313,0.313,109,0.109,12
13083,11830,1253,3170,24,15000,790,1000,0.79,345,0.345,135,0.135,12
13858,12481,1377,3519,25,16000,775,1000,0.775,349,0.349,124,0.124,12
14633,13137,1496,3863,26,17000,775,1000,0.775,344,0.344,119,0.119,12
15421,13812,1609,4188,27,18000,788,1000,0.788,325,0.325,113,0.113,12
16186,14439,1747,4561,28,19000,765,1000,0.765,373,0.373,138,0.138,12
16961,15086,1875,4914,29,20000,775,1000,0.775,353,0.353,128,0.128,12
17712,15676,2036,5324,30,21000,751,1000,0.751,410,0.41,161,0.161,12
18465,16301,2164,5699,31,22000,753,1000,0.753,375,0.375,128,0.128,12
19208,16915,2293,6085,32,23000,743,1000,0.743,386,0.386,129,0.129,12
19936,17511,2425,6489,33,24000,728,1000,0.728,404,0.404,132,0.132,12
20644,18075,2569,6925,34,25000,708,1000,0.708,436,0.436,144,0.144,12
21366,18656,2710,7344,35,26000,722,1000,0.722,419,0.419,141,0.141,12
22091,19245,2846,7755,36,27000,725,1000,0.725,411,0.411,136,0.136,12
22818,19835,2983,8165,37,28000,727,1000,0.727,410,0.41,137,0.137,12
23518,20394,3124,8606,38,29000,700,1000,0.7,441,0.441,141,0.141,12
24203,20926,3277,9074,39,30000,685,1000,0.685,468,0.468,153,0.153,12
24912,21495,3417,9505,40,31000,709,1000,0.709,431,0.431,140,0.14,12
25600,22048,3552,9952,41,32000,688,1000,0.688,447,0.447,135,0.135,12
26280,22591,3689,10409,42,33000,680,1000,0.68,457,0.457,137,0.137,12
26974,23148,3826,10852,43,34000,694,1000,0.694,443,0.443,137,0.137,12
27634,23651,3983,11349,44,35000,660,1000,0.66,497,0.497,157,0.157,12
28300,24161,4139,11839,45,36000,666,1000,0.666,490,0.49,156,0.156,12
28975,24685,4290,12315,46,37000,675,1000,0.675,476,0.476,151,0.151,12
29632,25176,4456,12824,47,38000,657,1000,0.657,509,0.509,166,0.166,12
30278,25646,4632,13354,48,39000,646,1000,0.646,530,0.53,176,0.176,12
30908,26120,4788,13880,49,40000,630,1000,0.63,526,0.526,156,0.156,12
31578,26651,4927,14349,50,41000,670,1000,0.67,469,0.469,139,0.139,12
32207,27133,5074,14867,51,42000,629,1000,0.629,518,0.518,147,0.147,12
32825,27586,5239,15414,52,43000,618,1000,0.618,547,0.547,165,0.165,12
33444,28037,5407,15963,53,44000,619,1000,0.619,549,0.549,168,0.168,12
34082,28506,5576,16494,54,45000,638,1000,0.638,531,0.531,169,0.169,12
34736,29019,5717,16981,55,46000,654,1000,0.654,487,0.487,141,0.141,12
35373,29487,5886,17513,56,47000,637,1000,0.637,532,0.532,169,0.169,12
35982,29925,6057,18075,57,48000,609,1000,0.609,562,0.562,171,0.171,12
36616,30415,6201,18585,58,49000,634,1000,0.634,510,0.51,144,0.144,12
37226,30845,6381,19155,59,50000,610,1000,0.61,570,0.57,180,0.18,12
37836,31297,6539,19703,60,51000,610,1000,0.61,548,0.548,158,0.158,12
38456,31756,6700,20244,61,52000,620,1000,0.62,541,0.541,161,0.161,12
39063,32192,6871,20808,62,53000,607,1000,0.607,564,0.564,171,0.171,12
39670,32644,7026,21356,63,54000,607,1000,0.607,548,0.548,155,0.155,12
40266,33074,7192,21926,64,55000,596,1000,0.596,570,0.57,166,0.166,12
40868,33518,7350,22482,65,56000,602,1000,0.602,556,0.556,158,0.158,12
41478,33972,7506,23028,66,57000,610,1000,0.61,546,0.546,156,0.156,12
42084,34417,7667,23583,67,58000,606,1000,0.606,555,0.555,161,0.161,12
42636,34792,7844,24208,68,59000,552,1000,0.552,625,0.625,177,0.177,12
43263,35262,8001,24738,69,60000,627,1000,0.627,530,0.53,157,0.157,12
43836,35635,8201,25365,70,61000,573,1000,0.573,627,0.627,200,0.2,12
44415,36032,8383,25968,71,62000,579,1000,0.579,603,0.603,182,0.182,12
44987,36421,8566,26579,72,63000,572,1000,0.572,611,0.611,183,0.183,12
45537,36809,8728,27191,73,64000,550,1000,0.55,612,0.612,162,0.162,12
46141,37260,8881,27740,74,65000,604,1000,0.604,549,0.549,153,0.153,12
46691,37638,9053,28362,75,66000,550,1000,0.55,622,0.622,172,0.172,12
47275,38049,9226,28951,76,67000,584,1000,0.584,589,0.589,173,0.173,12
47853,38476,9377,29524,77,68000,578,1000,0.578,573,0.573,151,0.151,12
48434,38904,9530,30096,78,69000,581,1000,0.581,572,0.572,153,0.153,12
48986,39290,9696,30710,79,70000,552,1000,0.552,614,0.614,166,0.166,12
49576,39733,9843,31267,80,71000,590,1000,0.59,557,0.557,147,0.147,12
50141,40137,10004,31863,81,72000,565,1000,0.565,596,0.596,161,0.161,12
50670,40495,10175,32505,82,73000,529,1000,0.529,642,0.642,171,0.171,12
51220,40884,10336,33116,83,74000,550,1000,0.55,611,0.611,161,0.161,12
51744,41220,10524,33780,84,75000,524,1000,0.524,664,0.664,188,0.188,12
52291,41598,10693,34402,85,76000,547,1000,0.547,622,0.622,169,0.169,12
52847,41990,10857,35010,86,77000,556,1000,0.556,608,0.608,164,0.164,12
53387,42357,11030,35643,87,78000,540,1000,0.54,633,0.633,173,0.173,12
53955,42753,11202,36247,88,79000,568,1000,0.568,604,0.604,172,0.172,12
54511,43148,11363,36852,89,80000,556,1000,0.556,605,0.605,161,0.161,12
55044,43500,11544,37500,90,81000,533,1000,0.533,648,0.648,181,0.181,12
55567,43855,11712,38145,91,82000,523,1000,0.523,645,0.645,168,0.168,12
56098,44204,11894,38796,92,83000,531,1000,0.531,651,0.651,182,0.182,12
56600,44532,12068,39468,93,84000,502,1000,0.502,672,0.672,174,0.174,12
57103,44861,12242,40139,94,85000,503,1000,0.503,671,0.671,174,0.174,12
57631,45214,12417,40786,95,86000,528,1000,0.528,647,0.647,175,0.175,12
58145,45543,12602,41457,96,87000,514,1000,0.514,671,0.671,185,0.185,12
58686,45930,12756,42070,97,88000,541,1000,0.541,613,0.613,154,0.154,12
59207,46275,12932,42725,98,89000,521,1000,0.521,655,0.655,176,0.176,12
59741,46655,13086,43345,99,90000,534,1000,0.534,620,0.62,154,0.154,12
60259,47012,13247,43988,100,91000,518,1000,0.518,643,0.643,161,0.161,12
60752,47340,13412,44660,101,92000,493,1000,0.493,672,0.672,165,0.165,12
61234,47635,13599,45365,102,93000,482,1000,0.482,705,0.705,187,0.187,12
61743,47969,13774,46031,103,94000,509,1000,0.509,666,0.666,175,0.175,12
62230,48267,13963,46733,104,95000,487,1000,0.487,702,0.702,189,0.189,12
62739,48629,14110,47371,105,96000,509,1000,0.509,638,0.638,147,0.147,12
63248,48970,14278,48030,106,97000,509,1000,0.509,659,0.659,168,0.168,12
63757,49308,14449,48692,107,98000,509,1000,0.509,662,0.662,171,0.171,12
64285,49650,14635,49350,108,99000,528,1000,0.528,658,0.658,186,0.186,12
64770,49971,14799,50029,109,100000,485,1000,0.485,679,0.679,164,0.164,12
65267,50298,14969,50702,110,101000,497,1000,0.497,673,0.673,170,0.17,12
65794,50659,15135,51341,111,102000,527,1000,0.527,639,0.639,166,0.166,12
66313,51000,15313,52000,112,103000,519,1000,0.519,659,0.659,178,0.178,12
66828,51360,15468,52640,113,104000,515,1000,0.515,640,0.64,155,0.155,12
67341,51730,15611,53270,114,105000,513,1000,0.513,630,0.63,143,0.143,12
67849,52082,15767,53918,115,106000,508,1000,0.508,648,0.648,156,0.156,12
68323,52381,15942,54619,116,107000,474,1000,0.474,701,0.701,175,0.175,12
68782,52636,16146,55364,117,108000,459,1000,0.459,745,0.745,204,0.204,12
69273,52949,16324,56051,118,109000,491,1000,0.491,687,0.687,178,0.178,12
69766,53274,16492,56726,119,110000,493,1000,0.493,675,0.675,168,0.168,12
70242,53552,16690,57448,120,111000,476,1000,0.476,722,0.722,198,0.198,12
70759,53897,16862,58103,121,112000,517,1000,0.517,655,0.655,172,0.172,12
71250,54220,17030,58780,122,113000,491,1000,0.491,677,0.677,168,0.168,12
71727,54533,17194,59467,123,114000,477,1000,0.477,687,0.687,164,0.164,12
71869,54638,17231,59660,124,114298,142,298,0.47651006711409394,193,0.6476510067114094,37,0.12416107382550336,12
100,100,0,0,1,100,NA,NA,NA,NA,NA,NA,NA,13
200,200,0,0,2,200,100,100,1,0,0,0,0,13
299,298,1,2,3,300,99,100,0.99,2,0.02,1,0.01,13
398,396,2,4,4,400,99,100,0.99,2,0.02,1,0.01,13
498,496,2,4,5,500,100,100,1,0,0,0,0,13
598,596,2,4,6,600,100,100,1,0,0,0,0,13
696,692,4,8,7,700,98,100,0.98,4,0.04,2,0.02,13
793,786,7,14,8,800,97,100,0.97,6,0.06,3,0.03,13
888,876,12,24,9,900,95,100,0.95,10,0.1,5,0.05,13
984,968,16,32,10,1000,96,100,0.96,8,0.08,4,0.04,13
1934,1878,56,122,11,2000,950,1000,0.95,90,0.09,40,0.04,13
2856,2747,109,253,12,3000,922,1000,0.922,131,0.131,53,0.053,13
3765,3595,170,405,13,4000,909,1000,0.909,152,0.152,61,0.061,13
4658,4411,247,589,14,5000,893,1000,0.893,184,0.184,77,0.077,13
5549,5227,322,773,15,6000,891,1000,0.891,184,0.184,75,0.075,13
6424,6031,393,969,16,7000,875,1000,0.875,196,0.196,71,0.071,13
7270,6787,483,1213,17,8000,846,1000,0.846,244,0.244,90,0.09,13
8119,7547,572,1453,18,9000,849,1000,0.849,240,0.24,89,0.089,13
8966,8300,666,1700,19,10000,847,1000,0.847,247,0.247,94,0.094,13
9783,9003,780,1997,20,11000,817,1000,0.817,297,0.297,114,0.114,13
10612,9737,875,2263,21,12000,829,1000,0.829,266,0.266,95,0.095,13
11412,10413,999,2587,22,13000,800,1000,0.8,324,0.324,124,0.124,13
12216,11106,1110,2894,23,14000,804,1000,0.804,307,0.307,111,0.111,13
13007,11777,1230,3223,24,15000,791,1000,0.791,329,0.329,120,0.12,13
13783,12433,1350,3567,25,16000,776,1000,0.776,344,0.344,120,0.12,13
14553,13086,1467,3914,26,17000,770,1000,0.77,347,0.347,117,0.117,13
15311,13705,1606,4295,27,18000,758,1000,0.758,381,0.381,139,0.139,13
16075,14337,1738,4663,28,19000,764,1000,0.764,368,0.368,132,0.132,13
16828,14961,1867,5039,29,20000,753,1000,0.753,376,0.376,129,0.129,13
17557,15542,2015,5458,30,21000,729,1000,0.729,419,0.419,148,0.148,13
18284,16134,2150,5866,31,22000,727,1000,0.727,408,0.408,135,0.135,13
19035,16775,2260,6225,32,23000,751,1000,0.751,359,0.359,110,0.11,13
19757,17358,2399,6642,33,24000,722,1000,0.722,417,0.417,139,0.139,13
20485,17956,2529,7044,34,25000,728,1000,0.728,402,0.402,130,0.13,13
21208,18557,2651,7443,35,26000,723,1000,0.723,399,0.399,122,0.122,13
21903,19105,2798,7895,36,27000,695,1000,0.695,452,0.452,147,0.147,13
22608,19656,2952,8344,37,28000,705,1000,0.705,449,0.449,154,0.154,13
23299,20194,3105,8806,38,29000,691,1000,0.691,462,0.462,153,0.153,13
23993,20739,3254,9261,39,30000,694,1000,0.694,455,0.455,149,0.149,13
24715,21327,3388,9673,40,31000,722,1000,0.722,412,0.412,134,0.134,13
25390,21830,3560,10170,41,32000,675,1000,0.675,497,0.497,172,0.172,13
26052,22337,3715,10663,42,33000,662,1000,0.662,493,0.493,155,0.155,13
26728,22857,3871,11143,43,34000,676,1000,0.676,480,0.48,156,0.156,13
27427,23423,4004,11577,44,35000,699,1000,0.699,434,0.434,133,0.133,13
28080,23920,4160,12080,45,36000,653,1000,0.653,503,0.503,156,0.156,13
28748,24425,4323,12575,46,37000,668,1000,0.668,495,0.495,163,0.163,13
29409,24929,4480,13071,47,38000,661,1000,0.661,496,0.496,157,0.157,13
30055,25421,4634,13579,48,39000,646,1000,0.646,508,0.508,154,0.154,13
30723,25934,4789,14066,49,40000,668,1000,0.668,487,0.487,155,0.155,13
31367,26400,4967,14600,50,41000,644,1000,0.644,534,0.534,178,0.178,13
32039,26931,5108,15069,51,42000,672,1000,0.672,469,0.469,141,0.141,13
32677,27410,5267,15590,52,43000,638,1000,0.638,521,0.521,159,0.159,13
33318,27890,5428,16110,53,44000,641,1000,0.641,520,0.52,161,0.161,13
33932,28321,5611,16679,54,45000,614,1000,0.614,569,0.569,183,0.183,13
34584,28833,5751,17167,55,46000,652,1000,0.652,488,0.488,140,0.14,13
35200,29279,5921,17721,56,47000,616,1000,0.616,554,0.554,170,0.17,13
35834,29764,6070,18236,57,48000,634,1000,0.634,515,0.515,149,0.149,13
36443,30198,6245,18802,58,49000,609,1000,0.609,566,0.566,175,0.175,13
37054,30647,6407,19353,59,50000,611,1000,0.611,551,0.551,162,0.162,13
37664,31095,6569,19905,60,51000,610,1000,0.61,552,0.552,162,0.162,13
38277,31552,6725,20448,61,52000,613,1000,0.613,543,0.543,156,0.156,13
38891,32014,6877,20986,62,53000,614,1000,0.614,538,0.538,152,0.152,13
39496,32456,7040,21544,63,54000,605,1000,0.605,558,0.558,163,0.163,13
40103,32896,7207,22104,64,55000,607,1000,0.607,560,0.56,167,0.167,13
40722,33354,7368,22646,65,56000,619,1000,0.619,542,0.542,161,0.161,13
41312,33766,7546,23234,66,57000,590,1000,0.59,588,0.588,178,0.178,13
41904,34196,7708,23804,67,58000,592,1000,0.592,570,0.57,162,0.162,13
42488,34610,7878,24390,68,59000,584,1000,0.584,586,0.586,170,0.17,13
43094,35061,8033,24939,69,60000,606,1000,0.606,549,0.549,155,0.155,13
43700,35508,8192,25492,70,61000,606,1000,0.606,553,0.553,159,0.159,13
44262,35895,8367,26105,71,62000,562,1000,0.562,613,0.613,175,0.175,13
44842,36296,8546,26704,72,63000,580,1000,0.58,599,0.599,179,0.179,13
45412,36697,8715,27303,73,64000,570,1000,0.57,599,0.599,169,0.169,13
45992,37089,8903,27911,74,65000,580,1000,0.58,608,0.608,188,0.188,13
46570,37503,9067,28497,75,66000,578,1000,0.578,586,0.586,164,0.164,13
47126,37890,9236,29110,76,67000,556,1000,0.556,613,0.613,169,0.169,13
47702,38292,9410,29708,77,68000,576,1000,0.576,598,0.598,174,0.174,13
48258,38671,9587,30329,78,69000,556,1000,0.556,621,0.621,177,0.177,13
48811,39049,9762,30951,79,70000,553,1000,0.553,622,0.622,175,0.175,13
49377,39449,9928,31551,80,71000,566,1000,0.566,600,0.6,166,0.166,13
49939,39820,10119,32180,81,72000,562,1000,0.562,629,0.629,191,0.191,13
50505,40221,10284,32779,82,73000,566,1000,0.566,599,0.599,165,0.165,13
51067,40618,10449,33382,83,74000,562,1000,0.562,603,0.603,165,0.165,13
51624,41006,10618,33994,84,75000,557,1000,0.557,612,0.612,169,0.169,13
52159,41366,10793,34634,85,76000,535,1000,0.535,640,0.64,175,0.175,13
52720,41752,10968,35248,86,77000,561,1000,0.561,614,0.614,175,0.175,13
53276,42144,11132,35856,87,78000,556,1000,0.556,608,0.608,164,0.164,13
53827,42514,11313,36486,88,79000,551,1000,0.551,630,0.63,181,0.181,13
54345,42851,11494,37149,89,80000,518,1000,0.518,663,0.663,181,0.181,13
54899,43256,11643,37744,90,81000,554,1000,0.554,595,0.595,149,0.149,13
55432,43630,11802,38370,91,82000,533,1000,0.533,626,0.626,159,0.159,13
55949,43959,11990,39041,92,83000,517,1000,0.517,671,0.671,188,0.188,13
56454,44298,12156,39702,93,84000,505,1000,0.505,661,0.661,166,0.166,13
56975,44643,12332,40357,94,85000,521,1000,0.521,655,0.655,176,0.176,13
57500,45005,12495,40995,95,86000,525,1000,0.525,638,0.638,163,0.163,13
58034,45383,12651,41617,96,87000,534,1000,0.534,622,0.622,156,0.156,13
58555,45744,12811,42256,97,88000,521,1000,0.521,639,0.639,160,0.16,13
59089,46119,12970,42881,98,89000,534,1000,0.534,625,0.625,159,0.159,13
59612,46479,13133,43521,99,90000,523,1000,0.523,640,0.64,163,0.163,13
60143,46829,13314,44171,100,91000,531,1000,0.531,650,0.65,181,0.181,13
60666,47185,13481,44815,101,92000,523,1000,0.523,644,0.644,167,0.167,13
61196,47558,13638,45442,102,93000,530,1000,0.53,627,0.627,157,0.157,13
61700,47909,13791,46091,103,94000,504,1000,0.504,649,0.649,153,0.153,13
62220,48250,13970,46750,104,95000,520,1000,0.52,659,0.659,179,0.179,13
62741,48605,14136,47395,105,96000,521,1000,0.521,645,0.645,166,0.166,13
63238,48910,14328,48090,106,97000,497,1000,0.497,695,0.695,192,0.192,13
63758,49271,14487,48729,107,98000,520,1000,0.52,639,0.639,159,0.159,13
64273,49620,14653,49380,108,99000,515,1000,0.515,651,0.651,166,0.166,13
64837,50052,14785,49948,109,100000,564,1000,0.564,568,0.568,132,0.132,13
65368,50445,14923,50555,110,101000,531,1000,0.531,607,0.607,138,0.138,13
65888,50789,15099,51211,111,102000,520,1000,0.52,656,0.656,176,0.176,13
66374,51096,15278,51904,112,103000,486,1000,0.486,693,0.693,179,0.179,13
66861,51408,15453,52592,113,104000,487,1000,0.487,688,0.688,175,0.175,13
67358,51737,15621,53263,114,105000,497,1000,0.497,671,0.671,168,0.168,13
67866,52088,15778,53912,115,106000,508,1000,0.508,649,0.649,157,0.157,13
68356,52399,15957,54601,116,107000,490,1000,0.49,689,0.689,179,0.179,13
68850,52725,16125,55275,117,108000,494,1000,0.494,674,0.674,168,0.168,13
69363,53081,16282,55919,118,109000,513,1000,0.513,644,0.644,157,0.157,13
69840,53388,16452,56612,119,110000,477,1000,0.477,693,0.693,170,0.17,13
70328,53716,16612,57284,120,111000,488,1000,0.488,672,0.672,160,0.16,13
70795,54010,16785,57990,121,112000,467,1000,0.467,706,0.706,173,0.173,13
71262,54286,16976,58714,122,113000,467,1000,0.467,724,0.724,191,0.191,13
71743,54577,17166,59423,123,114000,481,1000,0.481,709,0.709,190,0.19,13
71869,54638,17231,59660,124,114298,126,298,0.4228187919463087,237,0.7953020134228188,65,0.2181208053691275,13
100,100,0,0,1,100,NA,NA,NA,NA,NA,NA,NA,14
198,196,2,4,2,200,98,100,0.98,4,0.04,2,0.02,14
297,294,3,6,3,300,99,100,0.99,2,0.02,1,0.01,14
397,394,3,6,4,400,100,100,1,0,0,0,0,14
496,492,4,8,5,500,99,100,0.99,2,0.02,1,0.01,14
594,588,6,12,6,600,98,100,0.98,4,0.04,2,0.02,14
694,688,6,12,7,700,100,100,1,0,0,0,0,14
791,782,9,18,8,800,97,100,0.97,6,0.06,3,0.03,14
890,880,10,20,9,900,99,100,0.99,2,0.02,1,0.01,14
990,980,10,20,10,1000,100,100,1,0,0,0,0,14
1943,1894,49,106,11,2000,953,1000,0.953,86,0.086,39,0.039,14
2865,2759,106,241,12,3000,922,1000,0.922,135,0.135,57,0.057,14
3802,3657,145,343,13,4000,937,1000,0.937,102,0.102,39,0.039,14
4710,4507,203,493,14,5000,908,1000,0.908,150,0.15,58,0.058,14
5602,5319,283,681,15,6000,892,1000,0.892,188,0.188,80,0.08,14
6471,6097,374,903,16,7000,869,1000,0.869,222,0.222,91,0.091,14
7339,6888,451,1112,17,8000,868,1000,0.868,209,0.209,77,0.077,14
8189,7651,538,1349,18,9000,850,1000,0.85,237,0.237,87,0.087,14
9022,8387,635,1613,19,10000,833,1000,0.833,264,0.264,97,0.097,14
9863,9134,729,1866,20,11000,841,1000,0.841,253,0.253,94,0.094,14
10679,9842,837,2158,21,12000,816,1000,0.816,292,0.292,108,0.108,14
11464,10511,953,2489,22,13000,785,1000,0.785,331,0.331,116,0.116,14
12270,11213,1057,2787,23,14000,806,1000,0.806,298,0.298,104,0.104,14
13070,11895,1175,3105,24,15000,800,1000,0.8,318,0.318,118,0.118,14
13876,12588,1288,3412,25,16000,806,1000,0.806,307,0.307,113,0.113,14
14676,13286,1390,3714,26,17000,800,1000,0.8,302,0.302,102,0.102,14
15459,13955,1504,4045,27,18000,783,1000,0.783,331,0.331,114,0.114,14
16238,14603,1635,4397,28,19000,779,1000,0.779,352,0.352,131,0.131,14
17020,15271,1749,4729,29,20000,782,1000,0.782,332,0.332,114,0.114,14
17759,15880,1879,5120,30,21000,739,1000,0.739,391,0.391,130,0.13,14
18505,16489,2016,5511,31,22000,746,1000,0.746,391,0.391,137,0.137,14
19242,17085,2157,5915,32,23000,737,1000,0.737,404,0.404,141,0.141,14
19967,17653,2314,6347,33,24000,725,1000,0.725,432,0.432,157,0.157,14
20689,18228,2461,6772,34,25000,722,1000,0.722,425,0.425,147,0.147,14
21429,18821,2608,7179,35,26000,740,1000,0.74,407,0.407,147,0.147,14
22149,19401,2748,7599,36,27000,720,1000,0.72,420,0.42,140,0.14,14
22857,19970,2887,8030,37,28000,708,1000,0.708,431,0.431,139,0.139,14
23538,20484,3054,8516,38,29000,681,1000,0.681,486,0.486,167,0.167,14
24244,21044,3200,8956,39,30000,706,1000,0.706,440,0.44,146,0.146,14
24944,21602,3342,9398,40,31000,700,1000,0.7,442,0.442,142,0.142,14
25626,22137,3489,9863,41,32000,682,1000,0.682,465,0.465,147,0.147,14
26295,22659,3636,10341,42,33000,669,1000,0.669,478,0.478,147,0.147,14
26961,23155,3806,10845,43,34000,666,1000,0.666,504,0.504,170,0.17,14
27642,23682,3960,11318,44,35000,681,1000,0.681,473,0.473,154,0.154,14
28342,24258,4084,11742,45,36000,700,1000,0.7,424,0.424,124,0.124,14
29003,24754,4249,12246,46,37000,661,1000,0.661,504,0.504,165,0.165,14
29669,25249,4420,12751,47,38000,666,1000,0.666,505,0.505,171,0.171,14
30319,25735,4584,13265,48,39000,650,1000,0.65,514,0.514,164,0.164,14
30980,26253,4727,13747,49,40000,661,1000,0.661,482,0.482,143,0.143,14
31616,26727,4889,14273,50,41000,636,1000,0.636,526,0.526,162,0.162,14
32239,27199,5040,14801,51,42000,623,1000,0.623,528,0.528,151,0.151,14
32888,27704,5184,15296,52,43000,649,1000,0.649,495,0.495,144,0.144,14
33497,28136,5361,15864,53,44000,609,1000,0.609,568,0.568,177,0.177,14
34124,28585,5539,16415,54,45000,627,1000,0.627,551,0.551,178,0.178,14
34759,29050,5709,16950,55,46000,635,1000,0.635,535,0.535,170,0.17,14
35398,29542,5856,17458,56,47000,639,1000,0.639,508,0.508,147,0.147,14
36035,30026,6009,17974,57,48000,637,1000,0.637,516,0.516,153,0.153,14
36648,30472,6176,18528,58,49000,613,1000,0.613,554,0.554,167,0.167,14
37231,30861,6370,19139,59,50000,583,1000,0.583,611,0.611,194,0.194,14
37853,31323,6530,19677,60,51000,622,1000,0.622,538,0.538,160,0.16,14
38478,31786,6692,20214,61,52000,625,1000,0.625,537,0.537,162,0.162,14
39066,32181,6885,20819,62,53000,588,1000,0.588,605,0.605,193,0.193,14
39693,32653,7040,21347,63,54000,627,1000,0.627,528,0.528,155,0.155,14
40264,33042,7222,21958,64,55000,571,1000,0.571,611,0.611,182,0.182,14
40890,33516,7374,22484,65,56000,626,1000,0.626,526,0.526,152,0.152,14
41461,33919,7542,23081,66,57000,571,1000,0.571,597,0.597,168,0.168,14
42042,34341,7701,23659,67,58000,581,1000,0.581,578,0.578,159,0.159,14
42639,34765,7874,24235,68,59000,597,1000,0.597,576,0.576,173,0.173,14
43226,35209,8017,24791,69,60000,587,1000,0.587,556,0.556,143,0.143,14
43803,35596,8207,25404,70,61000,577,1000,0.577,613,0.613,190,0.19,14
44393,36033,8360,25967,71,62000,590,1000,0.59,563,0.563,153,0.153,14
44963,36433,8530,26567,72,63000,570,1000,0.57,600,0.6,170,0.17,14
45528,36827,8701,27173,73,64000,565,1000,0.565,606,0.606,171,0.171,14
46080,37204,8876,27796,74,65000,552,1000,0.552,623,0.623,175,0.175,14
46641,37595,9046,28405,75,66000,561,1000,0.561,609,0.609,170,0.17,14
47205,37983,9222,29017,76,67000,564,1000,0.564,612,0.612,176,0.176,14
47770,38379,9391,29621,77,68000,565,1000,0.565,604,0.604,169,0.169,14
48329,38771,9558,30229,78,69000,559,1000,0.559,608,0.608,167,0.167,14
48882,39158,9724,30842,79,70000,553,1000,0.553,613,0.613,166,0.166,14
49440,39544,9896,31456,80,71000,558,1000,0.558,614,0.614,172,0.172,14
50009,39956,10053,32044,81,72000,569,1000,0.569,588,0.588,157,0.157,14
50558,40321,10237,32679,82,73000,549,1000,0.549,635,0.635,184,0.184,14
51115,40714,10401,33286,83,74000,557,1000,0.557,607,0.607,164,0.164,14
51658,41087,10571,33913,84,75000,543,1000,0.543,627,0.627,170,0.17,14
52201,41451,10750,34549,85,76000,543,1000,0.543,636,0.636,179,0.179,14
52743,41819,10924,35181,86,77000,542,1000,0.542,632,0.632,174,0.174,14
53273,42183,11090,35817,87,78000,530,1000,0.53,636,0.636,166,0.166,14
53818,42539,11279,36461,88,79000,545,1000,0.545,644,0.644,189,0.189,14
54360,42909,11451,37091,89,80000,542,1000,0.542,630,0.63,172,0.172,14
54908,43278,11630,37722,90,81000,548,1000,0.548,631,0.631,179,0.179,14
55443,43654,11789,38346,91,82000,535,1000,0.535,624,0.624,159,0.159,14
55970,44009,11961,38991,92,83000,527,1000,0.527,645,0.645,172,0.172,14
56507,44376,12131,39624,93,84000,537,1000,0.537,633,0.633,170,0.17,14
57043,44735,12308,40265,94,85000,536,1000,0.536,641,0.641,177,0.177,14
57568,45099,12469,40901,95,86000,525,1000,0.525,636,0.636,161,0.161,14
58088,45438,12650,41562,96,87000,520,1000,0.52,661,0.661,181,0.181,14
58622,45826,12796,42174,97,88000,534,1000,0.534,612,0.612,146,0.146,14
59144,46180,12964,42820,98,89000,522,1000,0.522,646,0.646,168,0.168,14
59669,46542,13127,43458,99,90000,525,1000,0.525,638,0.638,163,0.163,14
60184,46888,13296,44112,100,91000,515,1000,0.515,654,0.654,169,0.169,14
60714,47257,13457,44743,101,92000,530,1000,0.53,631,0.631,161,0.161,14
61239,47630,13609,45370,102,93000,525,1000,0.525,627,0.627,152,0.152,14
61743,47951,13792,46049,103,94000,504,1000,0.504,679,0.679,183,0.183,14
62268,48300,13968,46700,104,95000,525,1000,0.525,651,0.651,176,0.176,14
62787,48660,14127,47340,105,96000,519,1000,0.519,640,0.64,159,0.159,14
63286,48982,14304,48018,106,97000,499,1000,0.499,678,0.678,177,0.177,14
63772,49290,14482,48710,107,98000,486,1000,0.486,692,0.692,178,0.178,14
64298,49652,14646,49348,108,99000,526,1000,0.526,638,0.638,164,0.164,14
64784,49967,14817,50033,109,100000,486,1000,0.486,685,0.685,171,0.171,14
65298,50317,14981,50683,110,101000,514,1000,0.514,650,0.65,164,0.164,14
65806,50660,15146,51340,111,102000,508,1000,0.508,657,0.657,165,0.165,14
66305,50997,15308,52003,112,103000,499,1000,0.499,663,0.663,162,0.162,14
66800,51321,15479,52679,113,104000,495,1000,0.495,676,0.676,171,0.171,14
67298,51650,15648,53350,114,105000,498,1000,0.498,671,0.671,169,0.169,14
67819,52010,15809,53990,115,106000,521,1000,0.521,640,0.64,161,0.161,14
68316,52323,15993,54677,116,107000,497,1000,0.497,687,0.687,184,0.184,14
68801,52642,16159,55358,117,108000,485,1000,0.485,681,0.681,166,0.166,14
69335,53031,16304,55969,118,109000,534,1000,0.534,611,0.611,145,0.145,14
69788,53292,16496,56708,119,110000,453,1000,0.453,739,0.739,192,0.192,14
70285,53615,16670,57385,120,111000,497,1000,0.497,677,0.677,174,0.174,14
70758,53920,16838,58080,121,112000,473,1000,0.473,695,0.695,168,0.168,14
71223,54215,17008,58785,122,113000,465,1000,0.465,705,0.705,170,0.17,14
71738,54568,17170,59432,123,114000,515,1000,0.515,647,0.647,162,0.162,14
71869,54638,17231,59660,124,114298,131,298,0.4395973154362416,228,0.7651006711409396,61,0.20469798657718122,14
100,100,0,0,1,100,NA,NA,NA,NA,NA,NA,NA,15
200,200,0,0,2,200,100,100,1,0,0,0,0,15
298,296,2,4,3,300,98,100,0.98,4,0.04,2,0.02,15
396,392,4,8,4,400,98,100,0.98,4,0.04,2,0.02,15
493,486,7,14,5,500,97,100,0.97,6,0.06,3,0.03,15
592,584,8,16,6,600,99,100,0.99,2,0.02,1,0.01,15
691,682,9,18,7,700,99,100,0.99,2,0.02,1,0.01,15
790,780,10,20,8,800,99,100,0.99,2,0.02,1,0.01,15
887,874,13,26,9,900,97,100,0.97,6,0.06,3,0.03,15
984,968,16,32,10,1000,97,100,0.97,6,0.06,3,0.03,15
1937,1889,48,111,11,2000,953,1000,0.953,79,0.079,32,0.032,15
2872,2773,99,227,12,3000,935,1000,0.935,116,0.116,51,0.051,15
3785,3630,155,370,13,4000,913,1000,0.913,143,0.143,56,0.056,15
4685,4464,221,536,14,5000,900,1000,0.9,166,0.166,66,0.066,15
5570,5271,299,729,15,6000,885,1000,0.885,193,0.193,78,0.078,15
6440,6048,392,952,16,7000,870,1000,0.87,223,0.223,93,0.093,15
7299,6823,476,1177,17,8000,859,1000,0.859,225,0.225,84,0.084,15
8158,7596,562,1404,18,9000,859,1000,0.859,227,0.227,86,0.086,15
8997,8343,654,1657,19,10000,839,1000,0.839,253,0.253,92,0.092,15
9837,9094,743,1906,20,11000,840,1000,0.84,249,0.249,89,0.089,15
10672,9826,846,2174,21,12000,835,1000,0.835,268,0.268,103,0.103,15
11505,10553,952,2447,22,13000,833,1000,0.833,273,0.273,106,0.106,15
12312,11259,1053,2741,23,14000,807,1000,0.807,294,0.294,101,0.101,15
13112,11930,1182,3070,24,15000,800,1000,0.8,329,0.329,129,0.129,15
13908,12612,1296,3388,25,16000,796,1000,0.796,318,0.318,114,0.114,15
14692,13275,1417,3725,26,17000,784,1000,0.784,337,0.337,121,0.121,15
15435,13866,1569,4134,27,18000,743,1000,0.743,409,0.409,152,0.152,15
16198,14505,1693,4495,28,19000,763,1000,0.763,361,0.361,124,0.124,15
16962,15143,1819,4857,29,20000,764,1000,0.764,362,0.362,126,0.126,15
17753,15818,1935,5182,30,21000,791,1000,0.791,325,0.325,116,0.116,15
18521,16468,2053,5532,31,22000,768,1000,0.768,350,0.35,118,0.118,15
19250,17049,2201,5951,32,23000,729,1000,0.729,419,0.419,148,0.148,15
19971,17637,2334,6363,33,24000,721,1000,0.721,412,0.412,133,0.133,15
20689,18207,2482,6793,34,25000,718,1000,0.718,430,0.43,148,0.148,15
21413,18784,2629,7216,35,26000,724,1000,0.724,423,0.423,147,0.147,15
22131,19340,2791,7660,36,27000,718,1000,0.718,444,0.444,162,0.162,15
22840,19894,2946,8106,37,28000,709,1000,0.709,446,0.446,155,0.155,15
23551,20468,3083,8532,38,29000,711,1000,0.711,426,0.426,137,0.137,15
24258,21029,3229,8971,39,30000,707,1000,0.707,439,0.439,146,0.146,15
24945,21547,3398,9453,40,31000,687,1000,0.687,482,0.482,169,0.169,15
25628,22069,3559,9931,41,32000,683,1000,0.683,478,0.478,161,0.161,15
26313,22600,3713,10400,42,33000,685,1000,0.685,469,0.469,154,0.154,15
27001,23148,3853,10852,43,34000,688,1000,0.688,452,0.452,140,0.14,15
27672,23674,3998,11326,44,35000,671,1000,0.671,474,0.474,145,0.145,15
28332,24192,4140,11808,45,36000,660,1000,0.66,482,0.482,142,0.142,15
28994,24682,4312,12318,46,37000,662,1000,0.662,510,0.51,172,0.172,15
29672,25205,4467,12795,47,38000,678,1000,0.678,477,0.477,155,0.155,15
30320,25686,4634,13314,48,39000,648,1000,0.648,519,0.519,167,0.167,15
30978,26182,4796,13818,49,40000,658,1000,0.658,504,0.504,162,0.162,15
31597,26642,4955,14358,50,41000,619,1000,0.619,540,0.54,159,0.159,15
32246,27132,5114,14868,51,42000,649,1000,0.649,510,0.51,159,0.159,15
32882,27595,5287,15405,52,43000,636,1000,0.636,537,0.537,173,0.173,15
33521,28082,5439,15918,53,44000,639,1000,0.639,513,0.513,152,0.152,15
34163,28571,5592,16429,54,45000,642,1000,0.642,511,0.511,153,0.153,15
34816,29090,5726,16910,55,46000,653,1000,0.653,481,0.481,134,0.134,15
35439,29561,5878,17439,56,47000,623,1000,0.623,529,0.529,152,0.152,15
36087,30069,6018,17931,57,48000,648,1000,0.648,492,0.492,140,0.14,15
36721,30550,6171,18450,58,49000,634,1000,0.634,519,0.519,153,0.153,15
37323,30979,6344,19021,59,50000,602,1000,0.602,571,0.571,173,0.173,15
37919,31410,6509,19590,60,51000,596,1000,0.596,569,0.569,165,0.165,15
38526,31856,6670,20144,61,52000,607,1000,0.607,554,0.554,161,0.161,15
39104,32245,6859,20755,62,53000,578,1000,0.578,611,0.611,189,0.189,15
39719,32696,7023,21304,63,54000,615,1000,0.615,549,0.549,164,0.164,15
40303,33099,7204,21901,64,55000,584,1000,0.584,597,0.597,181,0.181,15
40904,33540,7364,22460,65,56000,601,1000,0.601,559,0.559,160,0.16,15
41517,33989,7528,23011,66,57000,613,1000,0.613,551,0.551,164,0.164,15
42101,34397,7704,23603,67,58000,584,1000,0.584,592,0.592,176,0.176,15
42700,34835,7865,24165,68,59000,599,1000,0.599,562,0.562,161,0.161,15
43309,35299,8010,24701,69,60000,609,1000,0.609,536,0.536,145,0.145,15
43894,35721,8173,25279,70,61000,585,1000,0.585,578,0.578,163,0.163,15
44517,36201,8316,25799,71,62000,623,1000,0.623,520,0.52,143,0.143,15
45094,36615,8479,26385,72,63000,577,1000,0.577,586,0.586,163,0.163,15
45655,37015,8640,26985,73,64000,561,1000,0.561,600,0.6,161,0.161,15
46234,37423,8811,27577,74,65000,579,1000,0.579,592,0.592,171,0.171,15
46813,37826,8987,28174,75,66000,579,1000,0.579,597,0.597,176,0.176,15
47392,38229,9163,28771,76,67000,579,1000,0.579,597,0.597,176,0.176,15
47979,38656,9323,29344,77,68000,587,1000,0.587,573,0.573,160,0.16,15
48531,39034,9497,29966,78,69000,552,1000,0.552,622,0.622,174,0.174,15
49076,39392,9684,30608,79,70000,545,1000,0.545,642,0.642,187,0.187,15
49649,39803,9846,31197,80,71000,573,1000,0.573,589,0.589,162,0.162,15
50209,40202,10007,31798,81,72000,560,1000,0.56,601,0.601,161,0.161,15
50759,40575,10184,32425,82,73000,550,1000,0.55,627,0.627,177,0.177,15
51304,40951,10353,33049,83,74000,545,1000,0.545,624,0.624,169,0.169,15
51835,41290,10545,33710,84,75000,531,1000,0.531,661,0.661,192,0.192,15
52404,41694,10710,34306,85,76000,569,1000,0.569,596,0.596,165,0.165,15
52961,42066,10895,34934,86,77000,557,1000,0.557,628,0.628,185,0.185,15
53512,42454,11058,35546,87,78000,551,1000,0.551,612,0.612,163,0.163,15
54037,42807,11230,36193,88,79000,525,1000,0.525,647,0.647,172,0.172,15
54591,43189,11402,36811,89,80000,554,1000,0.554,618,0.618,172,0.172,15
55107,43541,11566,37459,90,81000,516,1000,0.516,648,0.648,164,0.164,15
55657,43924,11733,38076,91,82000,550,1000,0.55,617,0.617,167,0.167,15
56185,44284,11901,38716,92,83000,528,1000,0.528,640,0.64,168,0.168,15
56704,44636,12068,39364,93,84000,519,1000,0.519,648,0.648,167,0.167,15
57222,44972,12250,40028,94,85000,518,1000,0.518,664,0.664,182,0.182,15
57748,45324,12424,40676,95,86000,526,1000,0.526,648,0.648,174,0.174,15
58285,45686,12599,41314,96,87000,537,1000,0.537,638,0.638,175,0.175,15
58816,46045,12771,41955,97,88000,531,1000,0.531,641,0.641,172,0.172,15
59340,46384,12956,42616,98,89000,524,1000,0.524,661,0.661,185,0.185,15
59846,46706,13140,43294,99,90000,506,1000,0.506,678,0.678,184,0.184,15
60366,47081,13285,43919,100,91000,520,1000,0.52,625,0.625,145,0.145,15
60859,47405,13454,44595,101,92000,493,1000,0.493,676,0.676,169,0.169,15
61374,47763,13611,45237,102,93000,515,1000,0.515,642,0.642,157,0.157,15
61884,48093,13791,45907,103,94000,510,1000,0.51,670,0.67,180,0.18,15
62387,48444,13943,46556,104,95000,503,1000,0.503,649,0.649,152,0.152,15
62898,48771,14127,47229,105,96000,511,1000,0.511,673,0.673,184,0.184,15
63399,49097,14302,47903,106,97000,501,1000,0.501,674,0.674,175,0.175,15
63898,49425,14473,48575,107,98000,499,1000,0.499,672,0.672,171,0.171,15
64406,49769,14637,49231,108,99000,508,1000,0.508,656,0.656,164,0.164,15
64895,50082,14813,49918,109,100000,489,1000,0.489,687,0.687,176,0.176,15
65390,50400,14990,50600,110,101000,495,1000,0.495,682,0.682,177,0.177,15
65867,50694,15173,51306,111,102000,477,1000,0.477,706,0.706,183,0.183,15
66354,51009,15345,51991,112,103000,487,1000,0.487,685,0.685,172,0.172,15
66841,51331,15510,52669,113,104000,487,1000,0.487,678,0.678,165,0.165,15
67321,51653,15668,53347,114,105000,480,1000,0.48,678,0.678,158,0.158,15
67812,51968,15844,54032,115,106000,491,1000,0.491,685,0.685,176,0.176,15
68288,52276,16012,54724,116,107000,476,1000,0.476,692,0.692,168,0.168,15
68765,52593,16172,55407,117,108000,477,1000,0.477,683,0.683,160,0.16,15
69248,52905,16343,56095,118,109000,483,1000,0.483,688,0.688,171,0.171,15
69759,53262,16497,56738,119,110000,511,1000,0.511,643,0.643,154,0.154,15
70252,53559,16693,57441,120,111000,493,1000,0.493,703,0.703,196,0.196,15
70737,53886,16851,58114,121,112000,485,1000,0.485,673,0.673,158,0.158,15
71256,54245,17011,58755,122,113000,519,1000,0.519,641,0.641,160,0.16,15
71738,54568,17170,59432,123,114000,482,1000,0.482,677,0.677,159,0.159,15
71869,54638,17231,59660,124,114298,131,298,0.4395973154362416,228,0.7651006711409396,61,0.20469798657718122,15
100,100,0,0,1,100,NA,NA,NA,NA,NA,NA,NA,16
199,198,1,2,2,200,99,100,0.99,2,0.02,1,0.01,16
297,294,3,6,3,300,98,100,0.98,4,0.04,2,0.02,16
396,392,4,8,4,400,99,100,0.99,2,0.02,1,0.01,16
495,490,5,10,5,500,99,100,0.99,2,0.02,1,0.01,16
593,586,7,14,6,600,98,100,0.98,4,0.04,2,0.02,16
690,680,10,20,7,700,97,100,0.97,6,0.06,3,0.03,16
784,770,14,30,8,800,94,100,0.94,10,0.1,4,0.04,16
883,868,15,32,9,900,99,100,0.99,2,0.02,1,0.01,16
982,966,16,34,10,1000,99,100,0.99,2,0.02,1,0.01,16
1943,1896,47,104,11,2000,961,1000,0.961,70,0.07,31,0.031,16
2882,2788,94,212,12,3000,939,1000,0.939,108,0.108,47,0.047,16
3791,3631,160,369,13,4000,909,1000,0.909,157,0.157,66,0.066,16
4688,4457,231,543,14,5000,897,1000,0.897,174,0.174,71,0.071,16
5591,5297,294,703,15,6000,903,1000,0.903,160,0.16,63,0.063,16
6469,6087,382,913,16,7000,878,1000,0.878,210,0.21,88,0.088,16
7327,6861,466,1139,17,8000,858,1000,0.858,226,0.226,84,0.084,16
8174,7610,564,1390,18,9000,847,1000,0.847,251,0.251,98,0.098,16
9021,8363,658,1637,19,10000,847,1000,0.847,247,0.247,94,0.094,16
9857,9094,763,1906,20,11000,836,1000,0.836,269,0.269,105,0.105,16
10680,9804,876,2196,21,12000,823,1000,0.823,290,0.29,113,0.113,16
11498,10515,983,2485,22,13000,818,1000,0.818,289,0.289,107,0.107,16
12305,11205,1100,2795,23,14000,807,1000,0.807,310,0.31,117,0.117,16
13090,11867,1223,3133,24,15000,785,1000,0.785,338,0.338,123,0.123,16
13886,12552,1334,3448,25,16000,796,1000,0.796,315,0.315,111,0.111,16
14675,13230,1445,3770,26,17000,789,1000,0.789,322,0.322,111,0.111,16
15434,13860,1574,4140,27,18000,759,1000,0.759,370,0.37,129,0.129,16
16202,14507,1695,4493,28,19000,768,1000,0.768,353,0.353,121,0.121,16
16957,15128,1829,4872,29,20000,755,1000,0.755,379,0.379,134,0.134,16
17699,15726,1973,5274,30,21000,742,1000,0.742,402,0.402,144,0.144,16
18416,16292,2124,5708,31,22000,717,1000,0.717,434,0.434,151,0.151,16
19127,16832,2295,6168,32,23000,711,1000,0.711,460,0.46,171,0.171,16
19851,17411,2440,6589,33,24000,724,1000,0.724,421,0.421,145,0.145,16
20584,18007,2577,6993,34,25000,733,1000,0.733,404,0.404,137,0.137,16
21290,18571,2719,7429,35,26000,706,1000,0.706,436,0.436,142,0.142,16
22010,19147,2863,7853,36,27000,720,1000,0.72,424,0.424,144,0.144,16
22708,19696,3012,8304,37,28000,698,1000,0.698,451,0.451,149,0.149,16
23413,20263,3150,8737,38,29000,705,1000,0.705,433,0.433,138,0.138,16
24121,20840,3281,9160,39,30000,708,1000,0.708,423,0.423,131,0.131,16
24823,21395,3428,9605,40,31000,702,1000,0.702,445,0.445,147,0.147,16
25520,21939,3581,10061,41,32000,697,1000,0.697,456,0.456,153,0.153,16
26194,22461,3733,10539,42,33000,674,1000,0.674,478,0.478,152,0.152,16
26865,22977,3888,11023,43,34000,671,1000,0.671,484,0.484,155,0.155,16
27540,23489,4051,11511,44,35000,675,1000,0.675,488,0.488,163,0.163,16
28195,23969,4226,12031,45,36000,655,1000,0.655,520,0.52,175,0.175,16
28868,24491,4377,12509,46,37000,673,1000,0.673,478,0.478,151,0.151,16
29537,25021,4516,12979,47,38000,669,1000,0.669,470,0.47,139,0.139,16
30200,25530,4670,13470,48,39000,663,1000,0.663,491,0.491,154,0.154,16
30864,26049,4815,13951,49,40000,664,1000,0.664,481,0.481,145,0.145,16
31507,26529,4978,14471,50,41000,643,1000,0.643,520,0.52,163,0.163,16
32168,27046,5122,14954,51,42000,661,1000,0.661,483,0.483,144,0.144,16
32800,27516,5284,15484,52,43000,632,1000,0.632,530,0.53,162,0.162,16
33437,27994,5443,16006,53,44000,637,1000,0.637,522,0.522,159,0.159,16
34100,28504,5596,16496,54,45000,663,1000,0.663,490,0.49,153,0.153,16
34708,28936,5772,17064,55,46000,608,1000,0.608,568,0.568,176,0.176,16
35342,29398,5944,17602,56,47000,634,1000,0.634,538,0.538,172,0.172,16
35965,29858,6107,18142,57,48000,623,1000,0.623,540,0.54,163,0.163,16
36583,30301,6282,18699,58,49000,618,1000,0.618,557,0.557,175,0.175,16
37211,30768,6443,19232,59,50000,628,1000,0.628,533,0.533,161,0.161,16
37820,31218,6602,19782,60,51000,609,1000,0.609,550,0.55,159,0.159,16
38436,31680,6756,20320,61,52000,616,1000,0.616,538,0.538,154,0.154,16
39069,32157,6912,20843,62,53000,633,1000,0.633,523,0.523,156,0.156,16
39655,32572,7083,21428,63,54000,586,1000,0.586,585,0.585,171,0.171,16
40271,33032,7239,21968,64,55000,616,1000,0.616,540,0.54,156,0.156,16
40881,33494,7387,22506,65,56000,610,1000,0.61,538,0.538,148,0.148,16
41469,33910,7559,23090,66,57000,588,1000,0.588,584,0.584,172,0.172,16
42050,34321,7729,23679,67,58000,581,1000,0.581,589,0.589,170,0.17,16
42657,34779,7878,24221,68,59000,607,1000,0.607,542,0.542,149,0.149,16
43261,35221,8040,24779,69,60000,604,1000,0.604,558,0.558,162,0.162,16
43852,35659,8193,25341,70,61000,591,1000,0.591,562,0.562,153,0.153,16
44439,36072,8367,25928,71,62000,587,1000,0.587,587,0.587,174,0.174,16
45024,36508,8516,26492,72,63000,585,1000,0.585,564,0.564,149,0.149,16
45632,36966,8666,27034,73,64000,608,1000,0.608,542,0.542,150,0.15,16
46199,37352,8847,27648,74,65000,567,1000,0.567,614,0.614,181,0.181,16
46764,37755,9009,28245,75,66000,565,1000,0.565,597,0.597,162,0.162,16
47317,38138,9179,28862,76,67000,553,1000,0.553,617,0.617,170,0.17,16
47882,38556,9326,29444,77,68000,565,1000,0.565,582,0.582,147,0.147,16
48462,38966,9496,30034,78,69000,580,1000,0.58,590,0.59,170,0.17,16
49028,39339,9689,30661,79,70000,566,1000,0.566,627,0.627,193,0.193,16
49595,39738,9857,31262,80,71000,567,1000,0.567,601,0.601,168,0.168,16
50188,40173,10015,31827,81,72000,593,1000,0.593,565,0.565,158,0.158,16
50747,40556,10191,32444,82,73000,559,1000,0.559,617,0.617,176,0.176,16
51297,40916,10381,33084,83,74000,550,1000,0.55,640,0.64,190,0.19,16
51846,41308,10538,33692,84,75000,549,1000,0.549,608,0.608,157,0.157,16
52384,41676,10708,34324,85,76000,538,1000,0.538,632,0.632,170,0.17,16
52925,42053,10872,34947,86,77000,541,1000,0.541,623,0.623,164,0.164,16
53478,42454,11024,35546,87,78000,553,1000,0.553,599,0.599,152,0.152,16
54019,42822,11197,36178,88,79000,541,1000,0.541,632,0.632,173,0.173,16
54566,43215,11351,36785,89,80000,547,1000,0.547,607,0.607,154,0.154,16
55098,43568,11530,37432,90,81000,532,1000,0.532,647,0.647,179,0.179,16
55659,43969,11690,38031,91,82000,561,1000,0.561,599,0.599,160,0.16,16
56209,44349,11860,38651,92,83000,550,1000,0.55,620,0.62,170,0.17,16
56731,44700,12031,39300,93,84000,522,1000,0.522,649,0.649,171,0.171,16
57249,45046,12203,39954,94,85000,518,1000,0.518,654,0.654,172,0.172,16
57769,45409,12360,40591,95,86000,520,1000,0.52,637,0.637,157,0.157,16
58281,45735,12546,41265,96,87000,512,1000,0.512,674,0.674,186,0.186,16
58799,46075,12724,41925,97,88000,518,1000,0.518,660,0.66,178,0.178,16
59301,46404,12897,42596,98,89000,502,1000,0.502,671,0.671,173,0.173,16
59825,46756,13069,43244,99,90000,524,1000,0.524,648,0.648,172,0.172,16
60353,47110,13243,43890,100,91000,528,1000,0.528,646,0.646,174,0.174,16
60833,47419,13414,44581,101,92000,480,1000,0.48,691,0.691,171,0.171,16
61334,47745,13589,45255,102,93000,501,1000,0.501,674,0.674,175,0.175,16
61850,48098,13752,45902,103,94000,516,1000,0.516,647,0.647,163,0.163,16
62365,48438,13927,46562,104,95000,515,1000,0.515,660,0.66,175,0.175,16
62893,48808,14085,47192,105,96000,528,1000,0.528,630,0.63,158,0.158,16
63394,49131,14263,47869,106,97000,501,1000,0.501,677,0.677,178,0.178,16
63905,49474,14431,48526,107,98000,511,1000,0.511,657,0.657,168,0.168,16
64441,49866,14575,49134,108,99000,536,1000,0.536,608,0.608,144,0.144,16
64946,50194,14752,49806,109,100000,505,1000,0.505,672,0.672,177,0.177,16
65429,50508,14921,50492,110,101000,483,1000,0.483,686,0.686,169,0.169,16
65905,50806,15099,51194,111,102000,476,1000,0.476,702,0.702,178,0.178,16
66379,51105,15274,51895,112,103000,474,1000,0.474,701,0.701,175,0.175,16
66889,51454,15435,52546,113,104000,510,1000,0.51,651,0.651,161,0.161,16
67364,51748,15616,53252,114,105000,475,1000,0.475,706,0.706,181,0.181,16
67869,52079,15790,53921,115,106000,505,1000,0.505,669,0.669,174,0.174,16
68358,52401,15957,54599,116,107000,489,1000,0.489,678,0.678,167,0.167,16
68854,52715,16139,55285,117,108000,496,1000,0.496,686,0.686,182,0.182,16
69329,53023,16306,55977,118,109000,475,1000,0.475,692,0.692,167,0.167,16
69804,53317,16487,56683,119,110000,475,1000,0.475,706,0.706,181,0.181,16
70278,53616,16662,57384,120,111000,474,1000,0.474,701,0.701,175,0.175,16
70738,53892,16846,58108,121,112000,460,1000,0.46,724,0.724,184,0.184,16
71238,54228,17010,58772,122,113000,500,1000,0.5,664,0.664,164,0.164,16
71726,54544,17182,59456,123,114000,488,1000,0.488,684,0.684,172,0.172,16
71869,54638,17231,59660,124,114298,143,298,0.4798657718120805,204,0.6845637583892618,49,0.1644295302013423,16
100,100,0,0,1,100,NA,NA,NA,NA,NA,NA,NA,17
197,194,3,6,2,200,97,100,0.97,6,0.06,3,0.03,17
297,294,3,6,3,300,100,100,1,0,0,0,0,17
395,390,5,10,4,400,98,100,0.98,4,0.04,2,0.02,17
493,486,7,14,5,500,98,100,0.98,4,0.04,2,0.02,17
591,582,9,18,6,600,98,100,0.98,4,0.04,2,0.02,17
690,680,10,20,7,700,99,100,0.99,2,0.02,1,0.01,17
789,778,11,22,8,800,99,100,0.99,2,0.02,1,0.01,17
887,874,13,26,9,900,98,100,0.98,4,0.04,2,0.02,17
985,970,15,30,10,1000,98,100,0.98,4,0.04,2,0.02,17
1938,1890,48,110,11,2000,953,1000,0.953,80,0.08,33,0.033,17
2886,2793,93,207,12,3000,948,1000,0.948,97,0.097,45,0.045,17
3815,3671,144,329,13,4000,929,1000,0.929,122,0.122,51,0.051,17
4724,4531,193,469,14,5000,909,1000,0.909,140,0.14,49,0.049,17
5621,5358,263,642,15,6000,897,1000,0.897,173,0.173,70,0.07,17
6500,6155,345,845,16,7000,879,1000,0.879,203,0.203,82,0.082,17
7374,6947,427,1053,17,8000,874,1000,0.874,208,0.208,82,0.082,17
8216,7697,519,1303,18,9000,842,1000,0.842,250,0.25,92,0.092,17
9064,8451,613,1549,19,10000,848,1000,0.848,246,0.246,94,0.094,17
9892,9173,719,1827,20,11000,828,1000,0.828,278,0.278,106,0.106,17
10722,9890,832,2110,21,12000,830,1000,0.83,283,0.283,113,0.113,17
11547,10611,936,2389,22,13000,825,1000,0.825,279,0.279,104,0.104,17
12353,11310,1043,2690,23,14000,806,1000,0.806,301,0.301,107,0.107,17
13144,11981,1163,3019,24,15000,791,1000,0.791,329,0.329,120,0.12,17
13935,12646,1289,3354,25,16000,791,1000,0.791,335,0.335,126,0.126,17
14729,13330,1399,3670,26,17000,794,1000,0.794,316,0.316,110,0.11,17
15497,13966,1531,4034,27,18000,768,1000,0.768,364,0.364,132,0.132,17
16264,14599,1665,4401,28,19000,767,1000,0.767,367,0.367,134,0.134,17
17009,15220,1789,4780,29,20000,745,1000,0.745,379,0.379,124,0.124,17
17743,15830,1913,5170,30,21000,734,1000,0.734,390,0.39,124,0.124,17
18485,16422,2063,5578,31,22000,742,1000,0.742,408,0.408,150,0.15,17
19193,16978,2215,6022,32,23000,708,1000,0.708,444,0.444,152,0.152,17
19927,17587,2340,6413,33,24000,734,1000,0.734,391,0.391,125,0.125,17
20674,18195,2479,6805,34,25000,747,1000,0.747,392,0.392,139,0.139,17
21418,18809,2609,7191,35,26000,744,1000,0.744,386,0.386,130,0.13,17
22134,19380,2754,7620,36,27000,716,1000,0.716,429,0.429,145,0.145,17
22858,19975,2883,8025,37,28000,724,1000,0.724,405,0.405,129,0.129,17
23560,20523,3037,8477,38,29000,702,1000,0.702,452,0.452,154,0.154,17
24256,21077,3179,8923,39,30000,696,1000,0.696,446,0.446,142,0.142,17
24961,21632,3329,9368,40,31000,705,1000,0.705,445,0.445,150,0.15,17
25661,22180,3481,9820,41,32000,700,1000,0.7,452,0.452,152,0.152,17
26329,22689,3640,10311,42,33000,668,1000,0.668,491,0.491,159,0.159,17
27024,23240,3784,10760,43,34000,695,1000,0.695,449,0.449,144,0.144,17
27693,23767,3926,11233,44,35000,669,1000,0.669,473,0.473,142,0.142,17
28402,24336,4066,11664,45,36000,709,1000,0.709,431,0.431,140,0.14,17
29078,24859,4219,12141,46,37000,676,1000,0.676,477,0.477,153,0.153,17
29748,25367,4381,12633,47,38000,670,1000,0.67,492,0.492,162,0.162,17
30386,25835,4551,13165,48,39000,638,1000,0.638,532,0.532,170,0.17,17
31029,26304,4725,13696,49,40000,643,1000,0.643,531,0.531,174,0.174,17
31674,26793,4881,14207,50,41000,645,1000,0.645,511,0.511,156,0.156,17
32335,27301,5034,14699,51,42000,661,1000,0.661,492,0.492,153,0.153,17
32963,27752,5211,15248,52,43000,628,1000,0.628,549,0.549,177,0.177,17
33577,28210,5367,15790,53,44000,614,1000,0.614,542,0.542,156,0.156,17
34204,28684,5520,16316,54,45000,627,1000,0.627,526,0.526,153,0.153,17
34835,29151,5684,16849,55,46000,631,1000,0.631,533,0.533,164,0.164,17
35458,29624,5834,17376,56,47000,623,1000,0.623,527,0.527,150,0.15,17
36084,30090,5994,17910,57,48000,626,1000,0.626,534,0.534,160,0.16,17
36704,30576,6128,18424,58,49000,620,1000,0.62,514,0.514,134,0.134,17
37315,31015,6300,18985,59,50000,611,1000,0.611,561,0.561,172,0.172,17
37932,31473,6459,19527,60,51000,617,1000,0.617,542,0.542,159,0.159,17
38538,31912,6626,20088,61,52000,606,1000,0.606,561,0.561,167,0.167,17
39143,32352,6791,20648,62,53000,605,1000,0.605,560,0.56,165,0.165,17
39775,32827,6948,21173,63,54000,632,1000,0.632,525,0.525,157,0.157,17
40362,33233,7129,21767,64,55000,587,1000,0.587,594,0.594,181,0.181,17
40953,33656,7297,22344,65,56000,591,1000,0.591,577,0.577,168,0.168,17
41565,34110,7455,22890,66,57000,612,1000,0.612,546,0.546,158,0.158,17
42166,34551,7615,23449,67,58000,601,1000,0.601,559,0.559,160,0.16,17
42748,34985,7763,24015,68,59000,582,1000,0.582,566,0.566,148,0.148,17
43320,35384,7936,24616,69,60000,572,1000,0.572,601,0.601,173,0.173,17
43885,35781,8104,25219,70,61000,565,1000,0.565,603,0.603,168,0.168,17
44463,36190,8273,25810,71,62000,578,1000,0.578,591,0.591,169,0.169,17
45016,36560,8456,26440,72,63000,553,1000,0.553,630,0.63,183,0.183,17
45581,36942,8639,27058,73,64000,565,1000,0.565,618,0.618,183,0.183,17
46142,37344,8798,27656,74,65000,561,1000,0.561,598,0.598,159,0.159,17
46705,37720,8985,28280,75,66000,563,1000,0.563,624,0.624,187,0.187,17
47266,38090,9176,28910,76,67000,561,1000,0.561,630,0.63,191,0.191,17
47837,38498,9339,29502,77,68000,571,1000,0.571,592,0.592,163,0.163,17
48438,38925,9513,30075,78,69000,601,1000,0.601,573,0.573,174,0.174,17
49026,39355,9671,30645,79,70000,588,1000,0.588,570,0.57,158,0.158,17
49584,39742,9842,31258,80,71000,558,1000,0.558,613,0.613,171,0.171,17
50125,40094,10031,31906,81,72000,541,1000,0.541,648,0.648,189,0.189,17
50667,40461,10206,32539,82,73000,542,1000,0.542,633,0.633,175,0.175,17
51234,40866,10368,33134,83,74000,567,1000,0.567,595,0.595,162,0.162,17
51784,41256,10528,33744,84,75000,550,1000,0.55,610,0.61,160,0.16,17
52322,41613,10709,34387,85,76000,538,1000,0.538,643,0.643,181,0.181,17
52848,41974,10874,35026,86,77000,526,1000,0.526,639,0.639,165,0.165,17
53402,42371,11031,35629,87,78000,554,1000,0.554,603,0.603,157,0.157,17
53937,42730,11207,36270,88,79000,535,1000,0.535,641,0.641,176,0.176,17
54449,43039,11410,36961,89,80000,512,1000,0.512,691,0.691,203,0.203,17
55012,43442,11570,37558,90,81000,563,1000,0.563,597,0.597,160,0.16,17
55583,43838,11745,38162,91,82000,571,1000,0.571,604,0.604,175,0.175,17
56133,44218,11915,38782,92,83000,550,1000,0.55,620,0.62,170,0.17,17
56645,44549,12096,39451,93,84000,512,1000,0.512,669,0.669,181,0.181,17
57180,44908,12272,40092,94,85000,535,1000,0.535,641,0.641,176,0.176,17
57727,45309,12418,40691,95,86000,547,1000,0.547,599,0.599,146,0.146,17
58238,45642,12596,41358,96,87000,511,1000,0.511,667,0.667,178,0.178,17
58742,45970,12772,42030,97,88000,504,1000,0.504,672,0.672,176,0.176,17
59270,46328,12942,42672,98,89000,528,1000,0.528,642,0.642,170,0.17,17
59806,46695,13111,43305,99,90000,536,1000,0.536,633,0.633,169,0.169,17
60338,47053,13285,43947,100,91000,532,1000,0.532,642,0.642,174,0.174,17
60849,47388,13461,44612,101,92000,511,1000,0.511,665,0.665,176,0.176,17
61344,47715,13629,45285,102,93000,495,1000,0.495,673,0.673,168,0.168,17
61863,48065,13798,45935,103,94000,519,1000,0.519,650,0.65,169,0.169,17
62391,48432,13959,46568,104,95000,528,1000,0.528,633,0.633,161,0.161,17
62902,48782,14120,47218,105,96000,511,1000,0.511,650,0.65,161,0.161,17
63401,49098,14303,47902,106,97000,499,1000,0.499,684,0.684,183,0.183,17
63905,49423,14482,48577,107,98000,504,1000,0.504,675,0.675,179,0.179,17
64394,49728,14666,49272,108,99000,489,1000,0.489,695,0.695,184,0.184,17
64884,50047,14837,49953,109,100000,490,1000,0.49,681,0.681,171,0.171,17
65391,50378,15013,50622,110,101000,507,1000,0.507,669,0.669,176,0.176,17
65896,50719,15177,51281,111,102000,505,1000,0.505,659,0.659,164,0.164,17
66384,51035,15349,51965,112,103000,488,1000,0.488,684,0.684,172,0.172,17
66873,51362,15511,52638,113,104000,489,1000,0.489,673,0.673,162,0.162,17
67387,51711,15676,53289,114,105000,514,1000,0.514,651,0.651,165,0.165,17
67858,52010,15848,53990,115,106000,471,1000,0.471,701,0.701,172,0.172,17
68342,52337,16005,54663,116,107000,484,1000,0.484,673,0.673,157,0.157,17
68825,52651,16174,55349,117,108000,483,1000,0.483,686,0.686,169,0.169,17
69320,52969,16351,56031,118,109000,495,1000,0.495,682,0.682,177,0.177,17
69807,53283,16524,56717,119,110000,487,1000,0.487,686,0.686,173,0.173,17
70283,53585,16698,57415,120,111000,476,1000,0.476,698,0.698,174,0.174,17
70762,53905,16857,58095,121,112000,479,1000,0.479,680,0.68,159,0.159,17
71249,54232,17017,58768,122,113000,487,1000,0.487,673,0.673,160,0.16,17
71725,54543,17182,59457,123,114000,476,1000,0.476,689,0.689,165,0.165,17
71869,54638,17231,59660,124,114298,144,298,0.48322147651006714,203,0.6812080536912751,49,0.1644295302013423,17
100,100,0,0,1,100,NA,NA,NA,NA,NA,NA,NA,18
200,200,0,0,2,200,100,100,1,0,0,0,0,18
298,296,2,4,3,300,98,100,0.98,4,0.04,2,0.02,18
397,394,3,6,4,400,99,100,0.99,2,0.02,1,0.01,18
496,492,4,8,5,500,99,100,0.99,2,0.02,1,0.01,18
594,588,6,12,6,600,98,100,0.98,4,0.04,2,0.02,18
693,686,7,14,7,700,99,100,0.99,2,0.02,1,0.01,18
792,784,8,16,8,800,99,100,0.99,2,0.02,1,0.01,18
891,882,9,18,9,900,99,100,0.99,2,0.02,1,0.01,18
987,974,13,26,10,1000,96,100,0.96,8,0.08,4,0.04,18
1933,1885,48,115,11,2000,946,1000,0.946,89,0.089,35,0.035,18
2862,2769,93,231,12,3000,929,1000,0.929,116,0.116,45,0.045,18
3762,3597,165,403,13,4000,900,1000,0.9,172,0.172,72,0.072,18
4660,4425,235,575,14,5000,898,1000,0.898,172,0.172,70,0.07,18
5547,5248,299,752,15,6000,887,1000,0.887,177,0.177,64,0.064,18
6422,6041,381,959,16,7000,875,1000,0.875,207,0.207,82,0.082,18
7288,6821,467,1179,17,8000,866,1000,0.866,220,0.22,86,0.086,18
8134,7579,555,1421,18,9000,846,1000,0.846,242,0.242,88,0.088,18
8953,8280,673,1720,19,10000,819,1000,0.819,299,0.299,118,0.118,18
9764,8978,786,2022,20,11000,811,1000,0.811,302,0.302,113,0.113,18
10586,9680,906,2320,21,12000,822,1000,0.822,298,0.298,120,0.12,18
11389,10376,1013,2624,22,13000,803,1000,0.803,304,0.304,107,0.107,18
12184,11046,1138,2954,23,14000,795,1000,0.795,330,0.33,125,0.125,18
12969,11714,1255,3286,24,15000,785,1000,0.785,332,0.332,117,0.117,18
13763,12389,1374,3611,25,16000,794,1000,0.794,325,0.325,119,0.119,18
14555,13061,1494,3939,26,17000,792,1000,0.792,328,0.328,120,0.12,18
15314,13711,1603,4289,27,18000,759,1000,0.759,350,0.35,109,0.109,18
16070,14338,1732,4662,28,19000,756,1000,0.756,373,0.373,129,0.129,18
16832,14969,1863,5031,29,20000,762,1000,0.762,369,0.369,131,0.131,18
17562,15556,2006,5444,30,21000,730,1000,0.73,413,0.413,143,0.143,18
18323,16192,2131,5808,31,22000,761,1000,0.761,364,0.364,125,0.125,18
19059,16783,2276,6217,32,23000,736,1000,0.736,409,0.409,145,0.145,18
19763,17337,2426,6663,33,24000,704,1000,0.704,446,0.446,150,0.15,18
20502,17959,2543,7041,34,25000,739,1000,0.739,378,0.378,117,0.117,18
21208,18498,2710,7502,35,26000,706,1000,0.706,461,0.461,167,0.167,18
21904,19031,2873,7969,36,27000,696,1000,0.696,467,0.467,163,0.163,18
22617,19614,3003,8386,37,28000,713,1000,0.713,417,0.417,130,0.13,18
23302,20127,3175,8873,38,29000,685,1000,0.685,487,0.487,172,0.172,18
23987,20659,3328,9341,39,30000,685,1000,0.685,468,0.468,153,0.153,18
24694,21230,3464,9770,40,31000,707,1000,0.707,429,0.429,136,0.136,18
25381,21789,3592,10211,41,32000,687,1000,0.687,441,0.441,128,0.128,18
26099,22367,3732,10633,42,33000,718,1000,0.718,422,0.422,140,0.14,18
26766,22884,3882,11116,43,34000,667,1000,0.667,483,0.483,150,0.15,18
27455,23407,4048,11593,44,35000,689,1000,0.689,477,0.477,166,0.166,18
28124,23917,4207,12083,45,36000,669,1000,0.669,490,0.49,159,0.159,18
28809,24452,4357,12548,46,37000,685,1000,0.685,465,0.465,150,0.15,18
29462,24942,4520,13058,47,38000,653,1000,0.653,510,0.51,163,0.163,18
30120,25432,4688,13568,48,39000,658,1000,0.658,510,0.51,168,0.168,18
30763,25916,4847,14084,49,40000,643,1000,0.643,516,0.516,159,0.159,18
31398,26381,5017,14619,50,41000,635,1000,0.635,535,0.535,170,0.17,18
32061,26896,5165,15104,51,42000,663,1000,0.663,485,0.485,148,0.148,18
32697,27343,5354,15657,52,43000,636,1000,0.636,553,0.553,189,0.189,18
33338,27840,5498,16160,53,44000,641,1000,0.641,503,0.503,144,0.144,18
33955,28292,5663,16708,54,45000,617,1000,0.617,548,0.548,165,0.165,18
34596,28778,5818,17222,55,46000,641,1000,0.641,514,0.514,155,0.155,18
35213,29225,5988,17775,56,47000,617,1000,0.617,553,0.553,170,0.17,18
35849,29718,6131,18282,57,48000,636,1000,0.636,507,0.507,143,0.143,18
36492,30223,6269,18777,58,49000,643,1000,0.643,495,0.495,138,0.138,18
37117,30685,6432,19315,59,50000,625,1000,0.625,538,0.538,163,0.163,18
37741,31145,6596,19855,60,51000,624,1000,0.624,540,0.54,164,0.164,18
38349,31589,6760,20411,61,52000,608,1000,0.608,556,0.556,164,0.164,18
38943,32027,6916,20973,62,53000,594,1000,0.594,562,0.562,156,0.156,18
39555,32467,7088,21533,63,54000,612,1000,0.612,560,0.56,172,0.172,18
40155,32887,7268,22113,64,55000,600,1000,0.6,580,0.58,180,0.18,18
40798,33387,7411,22613,65,56000,643,1000,0.643,500,0.5,143,0.143,18
41395,33825,7570,23175,66,57000,597,1000,0.597,562,0.562,159,0.159,18
41983,34243,7740,23757,67,58000,588,1000,0.588,582,0.582,170,0.17,18
42582,34681,7901,24319,68,59000,599,1000,0.599,562,0.562,161,0.161,18
43170,35095,8075,24905,69,60000,588,1000,0.588,586,0.586,174,0.174,18
43737,35486,8251,25514,70,61000,567,1000,0.567,609,0.609,176,0.176,18
44321,35886,8435,26114,71,62000,584,1000,0.584,600,0.6,184,0.184,18
44910,36315,8595,26685,72,63000,589,1000,0.589,571,0.571,160,0.16,18
45472,36715,8757,27285,73,64000,562,1000,0.562,600,0.6,162,0.162,18
46029,37099,8930,27901,74,65000,557,1000,0.557,616,0.616,173,0.173,18
46593,37507,9086,28493,75,66000,564,1000,0.564,592,0.592,156,0.156,18
47191,37943,9248,29057,76,67000,598,1000,0.598,564,0.564,162,0.162,18
47768,38373,9395,29627,77,68000,577,1000,0.577,570,0.57,147,0.147,18
48333,38772,9561,30228,78,69000,565,1000,0.565,601,0.601,166,0.166,18
48891,39144,9747,30856,79,70000,558,1000,0.558,628,0.628,186,0.186,18
49455,39548,9907,31452,80,71000,564,1000,0.564,596,0.596,160,0.16,18
50019,39946,10073,32054,81,72000,564,1000,0.564,602,0.602,166,0.166,18
50596,40366,10230,32634,82,73000,577,1000,0.577,580,0.58,157,0.157,18
51166,40774,10392,33226,83,74000,570,1000,0.57,592,0.592,162,0.162,18
51707,41135,10572,33865,84,75000,541,1000,0.541,639,0.639,180,0.18,18
52250,41498,10752,34502,85,76000,543,1000,0.543,637,0.637,180,0.18,18
52789,41882,10907,35118,86,77000,539,1000,0.539,616,0.616,155,0.155,18
53344,42271,11073,35729,87,78000,555,1000,0.555,611,0.611,166,0.166,18
53877,42644,11233,36356,88,79000,533,1000,0.533,627,0.627,160,0.16,18
54416,43024,11392,36976,89,80000,539,1000,0.539,620,0.62,159,0.159,18
54963,43403,11560,37597,90,81000,547,1000,0.547,621,0.621,168,0.168,18
55489,43762,11727,38238,91,82000,526,1000,0.526,641,0.641,167,0.167,18
56025,44127,11898,38873,92,83000,536,1000,0.536,635,0.635,171,0.171,18
56568,44505,12063,39495,93,84000,543,1000,0.543,622,0.622,165,0.165,18
57104,44872,12232,40128,94,85000,536,1000,0.536,633,0.633,169,0.169,18
57619,45205,12414,40795,95,86000,515,1000,0.515,667,0.667,182,0.182,18
58119,45517,12602,41483,96,87000,500,1000,0.5,688,0.688,188,0.188,18
58649,45890,12759,42110,97,88000,530,1000,0.53,627,0.627,157,0.157,18
59186,46287,12899,42713,98,89000,537,1000,0.537,603,0.603,140,0.14,18
59740,46687,13053,43313,99,90000,554,1000,0.554,600,0.6,154,0.154,18
60280,47079,13201,43921,100,91000,540,1000,0.54,608,0.608,148,0.148,18
60821,47465,13356,44535,101,92000,541,1000,0.541,614,0.614,155,0.155,18
61323,47795,13528,45205,102,93000,502,1000,0.502,670,0.67,172,0.172,18
61828,48128,13700,45872,103,94000,505,1000,0.505,667,0.667,172,0.172,18
62345,48474,13871,46526,104,95000,517,1000,0.517,654,0.654,171,0.171,18
62833,48772,14061,47228,105,96000,488,1000,0.488,702,0.702,190,0.19,18
63335,49118,14217,47882,106,97000,502,1000,0.502,654,0.654,156,0.156,18
63857,49472,14385,48528,107,98000,522,1000,0.522,646,0.646,168,0.168,18
64335,49766,14569,49234,108,99000,478,1000,0.478,706,0.706,184,0.184,18
64866,50124,14742,49876,109,100000,531,1000,0.531,642,0.642,173,0.173,18
65358,50430,14928,50570,110,101000,492,1000,0.492,694,0.694,186,0.186,18
65860,50764,15096,51236,111,102000,502,1000,0.502,666,0.666,168,0.168,18
66370,51087,15283,51913,112,103000,510,1000,0.51,677,0.677,187,0.187,18
66872,51417,15455,52583,113,104000,502,1000,0.502,670,0.67,172,0.172,18
67346,51712,15634,53288,114,105000,474,1000,0.474,705,0.705,179,0.179,18
67821,52015,15806,53985,115,106000,475,1000,0.475,697,0.697,172,0.172,18
68338,52374,15964,54626,116,107000,517,1000,0.517,641,0.641,158,0.158,18
68821,52677,16144,55323,117,108000,483,1000,0.483,697,0.697,180,0.18,18
69304,52996,16308,56004,118,109000,483,1000,0.483,681,0.681,164,0.164,18
69771,53283,16488,56717,119,110000,467,1000,0.467,713,0.713,180,0.18,18
70244,53588,16656,57412,120,111000,473,1000,0.473,695,0.695,168,0.168,18
70742,53924,16818,58076,121,112000,498,1000,0.498,664,0.664,162,0.162,18
71214,54203,17011,58797,122,113000,472,1000,0.472,721,0.721,193,0.193,18
71719,54540,17179,59460,123,114000,505,1000,0.505,663,0.663,168,0.168,18
71869,54638,17231,59660,124,114298,150,298,0.5033557046979866,200,0.6711409395973155,52,0.174496644295302,18
98,96,2,4,1,100,NA,NA,NA,NA,NA,NA,NA,19
198,196,2,4,2,200,100,100,1,0,0,0,0,19
296,293,3,7,3,300,98,100,0.98,3,0.03,1,0.01,19
393,387,6,13,4,400,97,100,0.97,6,0.06,3,0.03,19
492,486,6,14,5,500,99,100,0.99,1,0.01,0,0,19
590,583,7,17,6,600,98,100,0.98,3,0.03,1,0.01,19
689,681,8,19,7,700,99,100,0.99,2,0.02,1,0.01,19
787,777,10,23,8,800,98,100,0.98,4,0.04,2,0.02,19
884,872,12,28,9,900,97,100,0.97,5,0.05,2,0.02,19
983,971,12,29,10,1000,99,100,0.99,1,0.01,0,0,19
1941,1896,45,104,11,2000,958,1000,0.958,75,0.075,33,0.033,19
2874,2780,94,220,12,3000,933,1000,0.933,116,0.116,49,0.049,19
3779,3618,161,382,13,4000,905,1000,0.905,162,0.162,67,0.067,19
4680,4442,238,558,14,5000,901,1000,0.901,176,0.176,77,0.077,19
5561,5250,311,750,15,6000,881,1000,0.881,192,0.192,73,0.073,19
6435,6048,387,952,16,7000,874,1000,0.874,202,0.202,76,0.076,19
7285,6805,480,1195,17,8000,850,1000,0.85,243,0.243,93,0.093,19
8131,7554,577,1446,18,9000,846,1000,0.846,251,0.251,97,0.097,19
8958,8273,685,1727,19,10000,827,1000,0.827,281,0.281,108,0.108,19
9789,9015,774,1985,20,11000,831,1000,0.831,258,0.258,89,0.089,19
10590,9690,900,2310,21,12000,801,1000,0.801,325,0.325,126,0.126,19
11412,10406,1006,2594,22,13000,822,1000,0.822,284,0.284,106,0.106,19
12211,11090,1121,2910,23,14000,799,1000,0.799,316,0.316,115,0.115,19
12984,11736,1248,3264,24,15000,773,1000,0.773,354,0.354,127,0.127,19
13756,12395,1361,3605,25,16000,772,1000,0.772,341,0.341,113,0.113,19
14554,13085,1469,3915,26,17000,798,1000,0.798,310,0.31,108,0.108,19
15307,13716,1591,4284,27,18000,753,1000,0.753,369,0.369,122,0.122,19
16081,14366,1715,4634,28,19000,774,1000,0.774,350,0.35,124,0.124,19
16846,15012,1834,4988,29,20000,765,1000,0.765,354,0.354,119,0.119,19
17596,15621,1975,5379,30,21000,750,1000,0.75,391,0.391,141,0.141,19
18372,16270,2102,5730,31,22000,776,1000,0.776,351,0.351,127,0.127,19
19102,16861,2241,6139,32,23000,730,1000,0.73,409,0.409,139,0.139,19
19835,17454,2381,6546,33,24000,733,1000,0.733,407,0.407,140,0.14,19
20558,18038,2520,6962,34,25000,723,1000,0.723,416,0.416,139,0.139,19
21280,18609,2671,7391,35,26000,722,1000,0.722,429,0.429,151,0.151,19
21994,19184,2810,7816,36,27000,714,1000,0.714,425,0.425,139,0.139,19
22685,19732,2953,8268,37,28000,691,1000,0.691,452,0.452,143,0.143,19
23404,20316,3088,8684,38,29000,719,1000,0.719,416,0.416,135,0.135,19
24120,20880,3240,9120,39,30000,716,1000,0.716,436,0.436,152,0.152,19
24799,21378,3421,9622,40,31000,679,1000,0.679,502,0.502,181,0.181,19
25526,21963,3563,10037,41,32000,727,1000,0.727,415,0.415,142,0.142,19
26228,22522,3706,10478,42,33000,702,1000,0.702,441,0.441,143,0.143,19
26896,23027,3869,10973,43,34000,668,1000,0.668,495,0.495,163,0.163,19
27568,23556,4012,11444,44,35000,672,1000,0.672,471,0.471,143,0.143,19
28246,24082,4164,11918,45,36000,678,1000,0.678,474,0.474,152,0.152,19
28898,24577,4321,12423,46,37000,652,1000,0.652,505,0.505,157,0.157,19
29580,25126,4454,12874,47,38000,682,1000,0.682,451,0.451,133,0.133,19
30241,25625,4616,13375,48,39000,661,1000,0.661,501,0.501,162,0.162,19
30890,26101,4789,13899,49,40000,649,1000,0.649,524,0.524,173,0.173,19
31517,26569,4948,14431,50,41000,627,1000,0.627,532,0.532,159,0.159,19
32157,27048,5109,14952,51,42000,640,1000,0.64,521,0.521,161,0.161,19
32798,27531,5267,15469,52,43000,641,1000,0.641,517,0.517,158,0.158,19
33437,28014,5423,15986,53,44000,639,1000,0.639,517,0.517,156,0.156,19
34088,28522,5566,16478,54,45000,651,1000,0.651,492,0.492,143,0.143,19
34734,29016,5718,16984,55,46000,646,1000,0.646,506,0.506,152,0.152,19
35355,29459,5896,17541,56,47000,621,1000,0.621,557,0.557,178,0.178,19
35954,29876,6078,18124,57,48000,599,1000,0.599,583,0.583,182,0.182,19
36595,30354,6241,18646,58,49000,641,1000,0.641,522,0.522,163,0.163,19
37192,30772,6420,19228,59,50000,597,1000,0.597,582,0.582,179,0.179,19
37800,31194,6606,19806,60,51000,608,1000,0.608,578,0.578,186,0.186,19
38422,31665,6757,20335,61,52000,622,1000,0.622,529,0.529,151,0.151,19
39052,32139,6913,20861,62,53000,630,1000,0.63,526,0.526,156,0.156,19
39678,32603,7075,21397,63,54000,626,1000,0.626,536,0.536,162,0.162,19
40275,33041,7234,21959,64,55000,597,1000,0.597,562,0.562,159,0.159,19
40883,33485,7398,22515,65,56000,608,1000,0.608,556,0.556,164,0.164,19
41508,33960,7548,23040,66,57000,625,1000,0.625,525,0.525,150,0.15,19
42119,34422,7697,23578,67,58000,611,1000,0.611,538,0.538,149,0.149,19
42713,34847,7866,24153,68,59000,594,1000,0.594,575,0.575,169,0.169,19
43292,35260,8032,24740,69,60000,579,1000,0.579,587,0.587,166,0.166,19
43865,35661,8204,25339,70,61000,573,1000,0.573,599,0.599,172,0.172,19
44465,36108,8357,25892,71,62000,600,1000,0.6,553,0.553,153,0.153,19
45048,36525,8523,26475,72,63000,583,1000,0.583,583,0.583,166,0.166,19
45624,36936,8688,27064,73,64000,576,1000,0.576,589,0.589,165,0.165,19
46206,37340,8866,27660,74,65000,582,1000,0.582,596,0.596,178,0.178,19
46786,37751,9035,28249,75,66000,580,1000,0.58,589,0.589,169,0.169,19
47386,38198,9188,28802,76,67000,600,1000,0.6,553,0.553,153,0.153,19
47924,38562,9362,29438,77,68000,538,1000,0.538,636,0.636,174,0.174,19
48498,38977,9521,30023,78,69000,574,1000,0.574,585,0.585,159,0.159,19
49032,39323,9709,30677,79,70000,534,1000,0.534,654,0.654,188,0.188,19
49592,39709,9883,31291,80,71000,560,1000,0.56,614,0.614,174,0.174,19
50124,40056,10068,31944,81,72000,532,1000,0.532,653,0.653,185,0.185,19
50688,40460,10228,32540,82,73000,564,1000,0.564,596,0.596,160,0.16,19
51241,40838,10403,33162,83,74000,553,1000,0.553,622,0.622,175,0.175,19
51820,41258,10562,33742,84,75000,579,1000,0.579,580,0.58,159,0.159,19
52362,41640,10722,34360,85,76000,542,1000,0.542,618,0.618,160,0.16,19
52896,41981,10915,35019,86,77000,534,1000,0.534,659,0.659,193,0.193,19
53425,42329,11096,35671,87,78000,529,1000,0.529,652,0.652,181,0.181,19
53972,42700,11272,36300,88,79000,547,1000,0.547,629,0.629,176,0.176,19
54508,43067,11441,36933,89,80000,536,1000,0.536,633,0.633,169,0.169,19
55061,43455,11606,37545,90,81000,553,1000,0.553,612,0.612,165,0.165,19
55614,43849,11765,38151,91,82000,553,1000,0.553,606,0.606,159,0.159,19
56113,44153,11960,38847,92,83000,499,1000,0.499,696,0.696,195,0.195,19
56647,44520,12127,39480,93,84000,534,1000,0.534,633,0.633,167,0.167,19
57144,44813,12331,40187,94,85000,497,1000,0.497,707,0.707,204,0.204,19
57661,45150,12511,40850,95,86000,517,1000,0.517,663,0.663,180,0.18,19
58201,45534,12667,41466,96,87000,540,1000,0.54,616,0.616,156,0.156,19
58686,45845,12841,42155,97,88000,485,1000,0.485,689,0.689,174,0.174,19
59241,46257,12984,42743,98,89000,555,1000,0.555,588,0.588,143,0.143,19
59761,46617,13144,43383,99,90000,520,1000,0.52,640,0.64,160,0.16,19
60287,46979,13308,44021,100,91000,526,1000,0.526,638,0.638,164,0.164,19
60804,47346,13458,44654,101,92000,517,1000,0.517,633,0.633,150,0.15,19
61300,47678,13622,45322,102,93000,496,1000,0.496,668,0.668,164,0.164,19
61785,47987,13798,46013,103,94000,485,1000,0.485,691,0.691,176,0.176,19
62300,48347,13953,46653,104,95000,515,1000,0.515,640,0.64,155,0.155,19
62841,48727,14114,47273,105,96000,541,1000,0.541,620,0.62,161,0.161,19
63340,49065,14275,47935,106,97000,499,1000,0.499,662,0.662,161,0.161,19
63861,49424,14437,48576,107,98000,521,1000,0.521,641,0.641,162,0.162,19
64381,49777,14604,49223,108,99000,520,1000,0.52,647,0.647,167,0.167,19
64854,50072,14782,49928,109,100000,473,1000,0.473,705,0.705,178,0.178,19
65365,50416,14949,50584,110,101000,511,1000,0.511,656,0.656,167,0.167,19
65837,50702,15135,51298,111,102000,472,1000,0.472,714,0.714,186,0.186,19
66350,51047,15303,51953,112,103000,513,1000,0.513,655,0.655,168,0.168,19
66840,51353,15487,52647,113,104000,490,1000,0.49,694,0.694,184,0.184,19
67317,51644,15673,53356,114,105000,477,1000,0.477,709,0.709,186,0.186,19
67829,51997,15832,54003,115,106000,512,1000,0.512,647,0.647,159,0.159,19
68344,52338,16006,54662,116,107000,515,1000,0.515,659,0.659,174,0.174,19
68812,52625,16187,55375,117,108000,468,1000,0.468,713,0.713,181,0.181,19
69303,52954,16349,56046,118,109000,491,1000,0.491,671,0.671,162,0.162,19
69797,53285,16512,56715,119,110000,494,1000,0.494,669,0.669,163,0.163,19
70298,53630,16668,57370,120,111000,501,1000,0.501,655,0.655,156,0.156,19
70776,53944,16832,58056,121,112000,478,1000,0.478,686,0.686,164,0.164,19
71267,54270,16997,58730,122,113000,491,1000,0.491,674,0.674,165,0.165,19
71732,54556,17176,59444,123,114000,465,1000,0.465,714,0.714,179,0.179,19
71869,54638,17231,59660,124,114298,137,298,0.4597315436241611,216,0.7248322147651006,55,0.18456375838926176,19
100,100,0,0,1,100,NA,NA,NA,NA,NA,NA,NA,20
200,200,0,0,2,200,100,100,1,0,0,0,0,20
300,300,0,0,3,300,100,100,1,0,0,0,0,20
397,394,3,6,4,400,97,100,0.97,6,0.06,3,0.03,20
496,492,4,8,5,500,99,100,0.99,2,0.02,1,0.01,20
594,588,6,12,6,600,98,100,0.98,4,0.04,2,0.02,20
692,684,8,16,7,700,98,100,0.98,4,0.04,2,0.02,20
790,780,10,20,8,800,98,100,0.98,4,0.04,2,0.02,20
890,880,10,20,9,900,100,100,1,0,0,0,0,20
988,976,12,24,10,1000,98,100,0.98,4,0.04,2,0.02,20
1936,1885,51,115,11,2000,948,1000,0.948,91,0.091,39,0.039,20
2867,2767,100,233,12,3000,931,1000,0.931,118,0.118,49,0.049,20
3788,3635,153,365,13,4000,921,1000,0.921,132,0.132,53,0.053,20
4665,4432,233,568,14,5000,877,1000,0.877,203,0.203,80,0.08,20
5559,5264,295,736,15,6000,894,1000,0.894,168,0.168,62,0.062,20
6460,6102,358,898,16,7000,901,1000,0.901,162,0.162,63,0.063,20
7330,6892,438,1108,17,8000,870,1000,0.87,210,0.21,80,0.08,20
8185,7649,536,1351,18,9000,855,1000,0.855,243,0.243,98,0.098,20
9042,8418,624,1582,19,10000,857,1000,0.857,231,0.231,88,0.088,20
9889,9180,709,1820,20,11000,847,1000,0.847,238,0.238,85,0.085,20
10689,9861,828,2139,21,12000,800,1000,0.8,319,0.319,119,0.119,20
11493,10551,942,2449,22,13000,804,1000,0.804,310,0.31,114,0.114,20
12282,11217,1065,2783,23,14000,789,1000,0.789,334,0.334,123,0.123,20
13077,11883,1194,3117,24,15000,795,1000,0.795,334,0.334,129,0.129,20
13882,12573,1309,3427,25,16000,805,1000,0.805,310,0.31,115,0.115,20
14661,13230,1431,3770,26,17000,779,1000,0.779,343,0.343,122,0.122,20
15427,13859,1568,4141,27,18000,766,1000,0.766,371,0.371,137,0.137,20
16202,14513,1689,4487,28,19000,775,1000,0.775,346,0.346,121,0.121,20
16946,15124,1822,4876,29,20000,744,1000,0.744,389,0.389,133,0.133,20
17691,15737,1954,5263,30,21000,745,1000,0.745,387,0.387,132,0.132,20
18447,16359,2088,5641,31,22000,756,1000,0.756,378,0.378,134,0.134,20
19185,16960,2225,6040,32,23000,738,1000,0.738,399,0.399,137,0.137,20
19920,17562,2358,6438,33,24000,735,1000,0.735,398,0.398,133,0.133,20
20666,18179,2487,6821,34,25000,746,1000,0.746,383,0.383,129,0.129,20
21407,18805,2602,7195,35,26000,741,1000,0.741,374,0.374,115,0.115,20
22106,19357,2749,7643,36,27000,699,1000,0.699,448,0.448,147,0.147,20
22831,19941,2890,8059,37,28000,725,1000,0.725,416,0.416,141,0.141,20
23538,20500,3038,8500,38,29000,707,1000,0.707,441,0.441,148,0.148,20
24226,21044,3182,8956,39,30000,688,1000,0.688,456,0.456,144,0.144,20
24949,21643,3306,9357,40,31000,723,1000,0.723,401,0.401,124,0.124,20
25639,22177,3462,9823,41,32000,690,1000,0.69,466,0.466,156,0.156,20
26318,22686,3632,10314,42,33000,679,1000,0.679,491,0.491,170,0.17,20
26981,23196,3785,10804,43,34000,663,1000,0.663,490,0.49,153,0.153,20
27645,23713,3932,11287,44,35000,664,1000,0.664,483,0.483,147,0.147,20
28313,24235,4078,11765,45,36000,668,1000,0.668,478,0.478,146,0.146,20
28973,24736,4237,12264,46,37000,660,1000,0.66,499,0.499,159,0.159,20
29610,25212,4398,12788,47,38000,637,1000,0.637,524,0.524,161,0.161,20
30241,25676,4565,13324,48,39000,631,1000,0.631,536,0.536,167,0.167,20
30901,26179,4722,13821,49,40000,660,1000,0.66,497,0.497,157,0.157,20
31566,26697,4869,14303,50,41000,665,1000,0.665,482,0.482,147,0.147,20
32228,27190,5038,14810,51,42000,662,1000,0.662,507,0.507,169,0.169,20
32882,27685,5197,15315,52,43000,654,1000,0.654,505,0.505,159,0.159,20
33505,28143,5362,15857,53,44000,623,1000,0.623,542,0.542,165,0.165,20
34134,28629,5505,16371,54,45000,629,1000,0.629,514,0.514,143,0.143,20
34811,29172,5639,16828,55,46000,677,1000,0.677,457,0.457,134,0.134,20
35440,29638,5802,17362,56,47000,629,1000,0.629,534,0.534,163,0.163,20
36095,30144,5951,17856,57,48000,655,1000,0.655,494,0.494,149,0.149,20
36691,30559,6132,18441,58,49000,596,1000,0.596,585,0.585,181,0.181,20
37299,30989,6310,19011,59,50000,608,1000,0.608,570,0.57,178,0.178,20
37884,31392,6492,19608,60,51000,585,1000,0.585,597,0.597,182,0.182,20
38506,31863,6643,20137,61,52000,622,1000,0.622,529,0.529,151,0.151,20
39113,32305,6808,20695,62,53000,607,1000,0.607,558,0.558,165,0.165,20
39714,32738,6976,21262,63,54000,601,1000,0.601,567,0.567,168,0.168,20
40304,33150,7154,21850,64,55000,590,1000,0.59,588,0.588,178,0.178,20
40909,33599,7310,22401,65,56000,605,1000,0.605,551,0.551,156,0.156,20
41519,34045,7474,22955,66,57000,610,1000,0.61,554,0.554,164,0.164,20
42107,34475,7632,23525,67,58000,588,1000,0.588,570,0.57,158,0.158,20
42690,34889,7801,24111,68,59000,583,1000,0.583,586,0.586,169,0.169,20
43301,35351,7950,24649,69,60000,611,1000,0.611,538,0.538,149,0.149,20
43881,35765,8116,25235,70,61000,580,1000,0.58,586,0.586,166,0.166,20
44479,36187,8292,25813,71,62000,598,1000,0.598,578,0.578,176,0.176,20
45056,36603,8453,26397,72,63000,577,1000,0.577,584,0.584,161,0.161,20
45622,36997,8625,27003,73,64000,566,1000,0.566,606,0.606,172,0.172,20
46215,37422,8793,27578,74,65000,593,1000,0.593,575,0.575,168,0.168,20
46777,37809,8968,28191,75,66000,562,1000,0.562,613,0.613,175,0.175,20
47325,38190,9135,28810,76,67000,548,1000,0.548,619,0.619,167,0.167,20
47888,38583,9305,29417,77,68000,563,1000,0.563,607,0.607,170,0.17,20
48457,38968,9489,30032,78,69000,569,1000,0.569,615,0.615,184,0.184,20
49036,39390,9646,30610,79,70000,579,1000,0.579,578,0.578,157,0.157,20
49588,39761,9827,31239,80,71000,552,1000,0.552,629,0.629,181,0.181,20
50175,40182,9993,31818,81,72000,587,1000,0.587,579,0.579,166,0.166,20
50741,40585,10156,32415,82,73000,566,1000,0.566,597,0.597,163,0.163,20
51299,40980,10319,33020,83,74000,558,1000,0.558,605,0.605,163,0.163,20
51842,41354,10488,33646,84,75000,543,1000,0.543,626,0.626,169,0.169,20
52377,41721,10656,34279,85,76000,535,1000,0.535,633,0.633,168,0.168,20
52918,42075,10843,34925,86,77000,541,1000,0.541,646,0.646,187,0.187,20
53458,42441,11017,35559,87,78000,540,1000,0.54,634,0.634,174,0.174,20
53979,42776,11203,36224,88,79000,521,1000,0.521,665,0.665,186,0.186,20
54518,43160,11358,36840,89,80000,539,1000,0.539,616,0.616,155,0.155,20
55053,43543,11510,37457,90,81000,535,1000,0.535,617,0.617,152,0.152,20
55596,43907,11689,38093,91,82000,543,1000,0.543,636,0.636,179,0.179,20
56118,44249,11869,38751,92,83000,522,1000,0.522,658,0.658,180,0.18,20
56650,44628,12022,39372,93,84000,532,1000,0.532,621,0.621,153,0.153,20
57201,45008,12193,39992,94,85000,551,1000,0.551,620,0.62,171,0.171,20
57716,45356,12360,40644,95,86000,515,1000,0.515,652,0.652,167,0.167,20
58246,45718,12528,41282,96,87000,530,1000,0.53,638,0.638,168,0.168,20
58754,46050,12704,41950,97,88000,508,1000,0.508,668,0.668,176,0.176,20
59266,46394,12872,42606,98,89000,512,1000,0.512,656,0.656,168,0.168,20
59799,46766,13033,43234,99,90000,533,1000,0.533,628,0.628,161,0.161,20
60296,47077,13219,43923,100,91000,497,1000,0.497,689,0.689,186,0.186,20
60810,47429,13381,44571,101,92000,514,1000,0.514,648,0.648,162,0.162,20
61320,47780,13540,45220,102,93000,510,1000,0.51,649,0.649,159,0.159,20
61825,48132,13693,45868,103,94000,505,1000,0.505,648,0.648,153,0.153,20
62310,48435,13875,46565,104,95000,485,1000,0.485,697,0.697,182,0.182,20
62834,48795,14039,47205,105,96000,524,1000,0.524,640,0.64,164,0.164,20
63352,49139,14213,47861,106,97000,518,1000,0.518,656,0.656,174,0.174,20
63842,49459,14383,48541,107,98000,490,1000,0.49,680,0.68,170,0.17,20
64328,49767,14561,49233,108,99000,486,1000,0.486,692,0.692,178,0.178,20
64846,50132,14714,49868,109,100000,518,1000,0.518,635,0.635,153,0.153,20
65356,50474,14882,50526,110,101000,510,1000,0.51,658,0.658,168,0.168,20
65842,50769,15073,51231,111,102000,486,1000,0.486,705,0.705,191,0.191,20
66357,51093,15264,51907,112,103000,515,1000,0.515,676,0.676,191,0.191,20
66859,51421,15438,52579,113,104000,502,1000,0.502,672,0.672,174,0.174,20
67361,51768,15593,53232,114,105000,502,1000,0.502,653,0.653,155,0.155,20
67860,52106,15754,53894,115,106000,499,1000,0.499,662,0.662,161,0.161,20
68332,52384,15948,54616,116,107000,472,1000,0.472,722,0.722,194,0.194,20
68825,52711,16114,55289,117,108000,493,1000,0.493,673,0.673,166,0.166,20
69340,53059,16281,55941,118,109000,515,1000,0.515,652,0.652,167,0.167,20
69804,53341,16463,56659,119,110000,464,1000,0.464,718,0.718,182,0.182,20
70272,53607,16665,57393,120,111000,468,1000,0.468,734,0.734,202,0.202,20
70755,53918,16837,58082,121,112000,483,1000,0.483,689,0.689,172,0.172,20
71232,54212,17020,58788,122,113000,477,1000,0.477,706,0.706,183,0.183,20
71739,54559,17180,59441,123,114000,507,1000,0.507,653,0.653,160,0.16,20
71869,54638,17231,59660,124,114298,130,298,0.436241610738255,219,0.7348993288590604,51,0.17114093959731544,20
99,98,1,2,1,100,NA,NA,NA,NA,NA,NA,NA,21
198,196,2,4,2,200,99,100,0.99,2,0.02,1,0.01,21
296,292,4,8,3,300,98,100,0.98,4,0.04,2,0.02,21
395,390,5,10,4,400,99,100,0.99,2,0.02,1,0.01,21
491,482,9,18,5,500,96,100,0.96,8,0.08,4,0.04,21
590,580,10,20,6,600,99,100,0.99,2,0.02,1,0.01,21
687,674,13,26,7,700,97,100,0.97,6,0.06,3,0.03,21
786,772,14,28,8,800,99,100,0.99,2,0.02,1,0.01,21
878,857,21,43,9,900,92,100,0.92,15,0.15,7,0.07,21
976,954,22,46,10,1000,98,100,0.98,3,0.03,1,0.01,21
1918,1856,62,144,11,2000,942,1000,0.942,98,0.098,40,0.04,21
2857,2758,99,242,12,3000,939,1000,0.939,98,0.098,37,0.037,21
3771,3611,160,389,13,4000,914,1000,0.914,147,0.147,61,0.061,21
4678,4456,222,544,14,5000,907,1000,0.907,155,0.155,62,0.062,21
5572,5285,287,715,15,6000,894,1000,0.894,171,0.171,65,0.065,21
6432,6053,379,947,16,7000,860,1000,0.86,232,0.232,92,0.092,21
7294,6832,462,1168,17,8000,862,1000,0.862,221,0.221,83,0.083,21
8128,7573,555,1427,18,9000,834,1000,0.834,259,0.259,93,0.093,21
8946,8291,655,1709,19,10000,818,1000,0.818,282,0.282,100,0.1,21
9771,9016,755,1984,20,11000,825,1000,0.825,275,0.275,100,0.1,21
10602,9748,854,2252,21,12000,831,1000,0.831,268,0.268,99,0.099,21
11408,10436,972,2564,22,13000,806,1000,0.806,312,0.312,118,0.118,21
12208,11113,1095,2887,23,14000,800,1000,0.8,323,0.323,123,0.123,21
12993,11786,1207,3214,24,15000,785,1000,0.785,327,0.327,112,0.112,21
13794,12473,1321,3527,25,16000,801,1000,0.801,313,0.313,114,0.114,21
14571,13116,1455,3884,26,17000,777,1000,0.777,357,0.357,134,0.134,21
15346,13746,1600,4254,27,18000,775,1000,0.775,370,0.37,145,0.145,21
16109,14384,1725,4616,28,19000,763,1000,0.763,362,0.362,125,0.125,21
16865,15001,1864,4999,29,20000,756,1000,0.756,383,0.383,139,0.139,21
17615,15621,1994,5379,30,21000,750,1000,0.75,380,0.38,130,0.13,21
18326,16176,2150,5824,31,22000,711,1000,0.711,445,0.445,156,0.156,21
19070,16788,2282,6212,32,23000,744,1000,0.744,388,0.388,132,0.132,21
19788,17355,2433,6645,33,24000,718,1000,0.718,433,0.433,151,0.151,21
20529,17966,2563,7034,34,25000,741,1000,0.741,389,0.389,130,0.13,21
21281,18597,2684,7403,35,26000,752,1000,0.752,369,0.369,121,0.121,21
22016,19198,2818,7802,36,27000,735,1000,0.735,399,0.399,134,0.134,21
22715,19743,2972,8257,37,28000,699,1000,0.699,455,0.455,154,0.154,21
23421,20301,3120,8699,38,29000,706,1000,0.706,442,0.442,148,0.148,21
24110,20833,3277,9167,39,30000,689,1000,0.689,468,0.468,157,0.157,21
24795,21362,3433,9638,40,31000,685,1000,0.685,471,0.471,156,0.156,21
25496,21925,3571,10075,41,32000,701,1000,0.701,437,0.437,138,0.138,21
26169,22448,3721,10552,42,33000,673,1000,0.673,477,0.477,150,0.15,21
26846,22978,3868,11022,43,34000,677,1000,0.677,470,0.47,147,0.147,21
27536,23519,4017,11481,44,35000,690,1000,0.69,459,0.459,149,0.149,21
28229,24079,4150,11921,45,36000,693,1000,0.693,440,0.44,133,0.133,21
28914,24620,4294,12380,46,37000,685,1000,0.685,459,0.459,144,0.144,21
29587,25140,4447,12860,47,38000,673,1000,0.673,480,0.48,153,0.153,21
30254,25657,4597,13343,48,39000,667,1000,0.667,483,0.483,150,0.15,21
30918,26169,4749,13831,49,40000,664,1000,0.664,488,0.488,152,0.152,21
31545,26636,4909,14364,50,41000,627,1000,0.627,533,0.533,160,0.16,21
32202,27131,5071,14869,51,42000,657,1000,0.657,505,0.505,162,0.162,21
32858,27624,5234,15376,52,43000,656,1000,0.656,507,0.507,163,0.163,21
33472,28062,5410,15938,53,44000,614,1000,0.614,562,0.562,176,0.176,21
34097,28530,5567,16470,54,45000,625,1000,0.625,532,0.532,157,0.157,21
34736,29018,5718,16982,55,46000,639,1000,0.639,512,0.512,151,0.151,21
35333,29454,5879,17546,56,47000,597,1000,0.597,564,0.564,161,0.161,21
35933,29879,6054,18121,57,48000,600,1000,0.6,575,0.575,175,0.175,21
36567,30370,6197,18630,58,49000,634,1000,0.634,509,0.509,143,0.143,21
37178,30827,6351,19173,59,50000,611,1000,0.611,543,0.543,154,0.154,21
37786,31268,6518,19732,60,51000,608,1000,0.608,559,0.559,167,0.167,21
38418,31753,6665,20247,61,52000,632,1000,0.632,515,0.515,147,0.147,21
39029,32206,6823,20794,62,53000,611,1000,0.611,547,0.547,158,0.158,21
39622,32635,6987,21365,63,54000,593,1000,0.593,571,0.571,164,0.164,21
40231,33087,7144,21913,64,55000,609,1000,0.609,548,0.548,157,0.157,21
40870,33588,7282,22412,65,56000,639,1000,0.639,499,0.499,138,0.138,21
41471,34015,7456,22985,66,57000,601,1000,0.601,573,0.573,174,0.174,21
42074,34449,7625,23551,67,58000,603,1000,0.603,566,0.566,169,0.169,21
42652,34844,7808,24156,68,59000,578,1000,0.578,605,0.605,183,0.183,21
43261,35301,7960,24699,69,60000,609,1000,0.609,543,0.543,152,0.152,21
43843,35696,8147,25304,70,61000,582,1000,0.582,605,0.605,187,0.187,21
44431,36116,8315,25884,71,62000,588,1000,0.588,580,0.58,168,0.168,21
45001,36508,8493,26492,72,63000,570,1000,0.57,608,0.608,178,0.178,21
45568,36907,8661,27093,73,64000,567,1000,0.567,601,0.601,168,0.168,21
46153,37322,8831,27678,74,65000,585,1000,0.585,585,0.585,170,0.17,21
46727,37736,8991,28264,75,66000,574,1000,0.574,586,0.586,160,0.16,21
47284,38126,9158,28874,76,67000,557,1000,0.557,610,0.61,167,0.167,21
47846,38504,9342,29496,77,68000,562,1000,0.562,622,0.622,184,0.184,21
48429,38930,9499,30070,78,69000,583,1000,0.583,574,0.574,157,0.157,21
49029,39374,9655,30626,79,70000,600,1000,0.6,556,0.556,156,0.156,21
49585,39767,9818,31233,80,71000,556,1000,0.556,607,0.607,163,0.163,21
50125,40127,9998,31873,81,72000,540,1000,0.54,640,0.64,180,0.18,21
50678,40499,10179,32501,82,73000,553,1000,0.553,628,0.628,181,0.181,21
51211,40844,10367,33156,83,74000,533,1000,0.533,655,0.655,188,0.188,21
51762,41222,10540,33778,84,75000,551,1000,0.551,622,0.622,173,0.173,21
52302,41585,10717,34415,85,76000,540,1000,0.54,637,0.637,177,0.177,21
52850,41961,10889,35039,86,77000,548,1000,0.548,624,0.624,172,0.172,21
53399,42334,11065,35666,87,78000,549,1000,0.549,627,0.627,176,0.176,21
53941,42714,11227,36286,88,79000,542,1000,0.542,620,0.62,162,0.162,21
54455,43039,11416,36961,89,80000,514,1000,0.514,675,0.675,189,0.189,21
54991,43400,11591,37600,90,81000,536,1000,0.536,639,0.639,175,0.175,21
55519,43762,11757,38238,91,82000,528,1000,0.528,638,0.638,166,0.166,21
56056,44123,11933,38877,92,83000,537,1000,0.537,639,0.639,176,0.176,21
56575,44479,12096,39521,93,84000,519,1000,0.519,644,0.644,163,0.163,21
57085,44811,12274,40189,94,85000,510,1000,0.51,668,0.668,178,0.178,21
57620,45178,12442,40822,95,86000,535,1000,0.535,633,0.633,168,0.168,21
58129,45510,12619,41490,96,87000,509,1000,0.509,668,0.668,177,0.177,21
58669,45887,12782,42113,97,88000,540,1000,0.54,623,0.623,163,0.163,21
59170,46218,12952,42782,98,89000,501,1000,0.501,669,0.669,170,0.17,21
59699,46586,13113,43414,99,90000,529,1000,0.529,632,0.632,161,0.161,21
60235,46970,13265,44030,100,91000,536,1000,0.536,616,0.616,152,0.152,21
60745,47309,13436,44691,101,92000,510,1000,0.51,661,0.661,171,0.171,21
61272,47659,13613,45341,102,93000,527,1000,0.527,650,0.65,177,0.177,21
61783,48004,13779,45996,103,94000,511,1000,0.511,655,0.655,166,0.166,21
62303,48355,13948,46645,104,95000,520,1000,0.52,649,0.649,169,0.169,21
62830,48709,14121,47291,105,96000,527,1000,0.527,646,0.646,173,0.173,21
63353,49048,14305,47952,106,97000,523,1000,0.523,661,0.661,184,0.184,21
63849,49382,14467,48618,107,98000,496,1000,0.496,666,0.666,162,0.162,21
64343,49707,14636,49293,108,99000,494,1000,0.494,675,0.675,169,0.169,21
64854,50058,14796,49942,109,100000,511,1000,0.511,649,0.649,160,0.16,21
65370,50396,14974,50604,110,101000,516,1000,0.516,662,0.662,178,0.178,21
65885,50751,15134,51249,111,102000,515,1000,0.515,645,0.645,160,0.16,21
66380,51089,15291,51911,112,103000,495,1000,0.495,662,0.662,157,0.157,21
66872,51410,15462,52590,113,104000,492,1000,0.492,679,0.679,171,0.171,21
67364,51719,15645,53281,114,105000,492,1000,0.492,691,0.691,183,0.183,21
67861,52038,15823,53962,115,106000,497,1000,0.497,681,0.681,178,0.178,21
68339,52349,15990,54651,116,107000,478,1000,0.478,689,0.689,167,0.167,21
68804,52618,16186,55382,117,108000,465,1000,0.465,731,0.731,196,0.196,21
69286,52939,16347,56061,118,109000,482,1000,0.482,679,0.679,161,0.161,21
69771,53257,16514,56743,119,110000,485,1000,0.485,682,0.682,167,0.167,21
70254,53579,16675,57421,120,111000,483,1000,0.483,678,0.678,161,0.161,21
70733,53902,16831,58098,121,112000,479,1000,0.479,677,0.677,156,0.156,21
71229,54225,17004,58775,122,113000,496,1000,0.496,677,0.677,173,0.173,21
71727,54556,17171,59444,123,114000,498,1000,0.498,669,0.669,167,0.167,21
71869,54638,17231,59660,124,114298,142,298,0.47651006711409394,216,0.7248322147651006,60,0.20134228187919462,21
100,100,0,0,1,100,NA,NA,NA,NA,NA,NA,NA,22
200,200,0,0,2,200,100,100,1,0,0,0,0,22
299,298,1,2,3,300,99,100,0.99,2,0.02,1,0.01,22
399,398,1,2,4,400,100,100,1,0,0,0,0,22
498,496,2,4,5,500,99,100,0.99,2,0.02,1,0.01,22
597,594,3,6,6,600,99,100,0.99,2,0.02,1,0.01,22
695,691,4,9,7,700,98,100,0.98,3,0.03,1,0.01,22
794,789,5,11,8,800,99,100,0.99,2,0.02,1,0.01,22
889,879,10,21,9,900,95,100,0.95,10,0.1,5,0.05,22
987,975,12,25,10,1000,98,100,0.98,4,0.04,2,0.02,22
1942,1894,48,106,11,2000,955,1000,0.955,81,0.081,36,0.036,22
2875,2778,97,222,12,3000,933,1000,0.933,116,0.116,49,0.049,22
3796,3641,155,359,13,4000,921,1000,0.921,137,0.137,58,0.058,22
4704,4479,225,521,14,5000,908,1000,0.908,162,0.162,70,0.07,22
5597,5305,292,695,15,6000,893,1000,0.893,174,0.174,67,0.067,22
6463,6084,379,916,16,7000,866,1000,0.866,221,0.221,87,0.087,22
7310,6831,479,1169,17,8000,847,1000,0.847,253,0.253,100,0.1,22
8144,7545,599,1455,18,9000,834,1000,0.834,286,0.286,120,0.12,22
8987,8300,687,1700,19,10000,843,1000,0.843,245,0.245,88,0.088,22
9824,9033,791,1967,20,11000,837,1000,0.837,267,0.267,104,0.104,22
10639,9743,896,2257,21,12000,815,1000,0.815,290,0.29,105,0.105,22
11429,10410,1019,2590,22,13000,790,1000,0.79,333,0.333,123,0.123,22
12238,11109,1129,2891,23,14000,809,1000,0.809,301,0.301,110,0.11,22
13035,11800,1235,3200,24,15000,797,1000,0.797,309,0.309,106,0.106,22
13820,12462,1358,3538,25,16000,785,1000,0.785,338,0.338,123,0.123,22
14595,13114,1481,3886,26,17000,775,1000,0.775,348,0.348,123,0.123,22
15385,13786,1599,4214,27,18000,790,1000,0.79,328,0.328,118,0.118,22
16161,14442,1719,4558,28,19000,776,1000,0.776,344,0.344,120,0.12,22
16913,15064,1849,4936,29,20000,752,1000,0.752,378,0.378,130,0.13,22
17672,15692,1980,5308,30,21000,759,1000,0.759,372,0.372,131,0.131,22
18441,16343,2098,5657,31,22000,769,1000,0.769,349,0.349,118,0.118,22
19158,16903,2255,6097,32,23000,717,1000,0.717,440,0.44,157,0.157,22
19896,17498,2398,6502,33,24000,738,1000,0.738,405,0.405,143,0.143,22
20606,18075,2531,6925,34,25000,710,1000,0.71,423,0.423,133,0.133,22
21313,18627,2686,7373,35,26000,707,1000,0.707,448,0.448,155,0.155,22
22041,19224,2817,7776,36,27000,728,1000,0.728,403,0.403,131,0.131,22
22755,19808,2947,8192,37,28000,714,1000,0.714,416,0.416,130,0.13,22
23468,20381,3087,8619,38,29000,713,1000,0.713,427,0.427,140,0.14,22
24151,20909,3242,9091,39,30000,683,1000,0.683,472,0.472,155,0.155,22
24826,21434,3392,9566,40,31000,675,1000,0.675,475,0.475,150,0.15,22
25513,21974,3539,10026,41,32000,687,1000,0.687,460,0.46,147,0.147,22
26216,22532,3684,10468,42,33000,703,1000,0.703,442,0.442,145,0.145,22
26878,23029,3849,10971,43,34000,662,1000,0.662,503,0.503,165,0.165,22
27557,23561,3996,11439,44,35000,679,1000,0.679,468,0.468,147,0.147,22
28211,24063,4148,11937,45,36000,654,1000,0.654,498,0.498,152,0.152,22
28866,24546,4320,12454,46,37000,655,1000,0.655,517,0.517,172,0.172,22
29520,25034,4486,12966,47,38000,654,1000,0.654,512,0.512,166,0.166,22
30182,25541,4641,13459,48,39000,662,1000,0.662,493,0.493,155,0.155,22
30844,26053,4791,13947,49,40000,662,1000,0.662,488,0.488,150,0.15,22
31496,26536,4960,14464,50,41000,652,1000,0.652,517,0.517,169,0.169,22
32144,27049,5095,14951,51,42000,648,1000,0.648,487,0.487,135,0.135,22
32787,27516,5271,15484,52,43000,643,1000,0.643,533,0.533,176,0.176,22
33442,28013,5429,15987,53,44000,655,1000,0.655,503,0.503,158,0.158,22
34089,28511,5578,16489,54,45000,647,1000,0.647,502,0.502,149,0.149,22
34725,29007,5718,16993,55,46000,636,1000,0.636,504,0.504,140,0.14,22
35358,29496,5862,17504,56,47000,633,1000,0.633,511,0.511,144,0.144,22
35977,29956,6021,18044,57,48000,619,1000,0.619,540,0.54,159,0.159,22
36619,30434,6185,18566,58,49000,642,1000,0.642,522,0.522,164,0.164,22
37240,30896,6344,19104,59,50000,621,1000,0.621,538,0.538,159,0.159,22
37867,31366,6501,19634,60,51000,627,1000,0.627,530,0.53,157,0.157,22
38486,31826,6660,20174,61,52000,619,1000,0.619,540,0.54,159,0.159,22
39091,32260,6831,20740,62,53000,605,1000,0.605,566,0.566,171,0.171,22
39672,32669,7003,21331,63,54000,581,1000,0.581,591,0.591,172,0.172,22
40268,33103,7165,21897,64,55000,596,1000,0.596,566,0.566,162,0.162,22
40855,33530,7325,22470,65,56000,587,1000,0.587,573,0.573,160,0.16,22
41453,33974,7479,23026,66,57000,598,1000,0.598,556,0.556,154,0.154,22
42047,34404,7643,23596,67,58000,594,1000,0.594,570,0.57,164,0.164,22
42601,34778,7823,24222,68,59000,554,1000,0.554,626,0.626,180,0.18,22
43183,35196,7987,24804,69,60000,582,1000,0.582,582,0.582,164,0.164,22
43780,35620,8160,25380,70,61000,597,1000,0.597,576,0.576,173,0.173,22
44380,36050,8330,25950,71,62000,600,1000,0.6,570,0.57,170,0.17,22
44939,36449,8490,26551,72,63000,559,1000,0.559,601,0.601,160,0.16,22
45528,36887,8641,27113,73,64000,589,1000,0.589,562,0.562,151,0.151,22
46078,37274,8804,27726,74,65000,550,1000,0.55,613,0.613,163,0.163,22
46649,37675,8974,28325,75,66000,571,1000,0.571,599,0.599,170,0.17,22
47224,38068,9156,28932,76,67000,575,1000,0.575,607,0.607,182,0.182,22
47758,38429,9329,29571,77,68000,534,1000,0.534,639,0.639,173,0.173,22
48306,38792,9514,30208,78,69000,548,1000,0.548,637,0.637,185,0.185,22
48868,39185,9683,30815,79,70000,562,1000,0.562,607,0.607,169,0.169,22
49410,39557,9853,31443,80,71000,542,1000,0.542,628,0.628,170,0.17,22
49964,39955,10009,32045,81,72000,554,1000,0.554,602,0.602,156,0.156,22
50513,40328,10185,32672,82,73000,549,1000,0.549,627,0.627,176,0.176,22
51042,40672,10370,33328,83,74000,529,1000,0.529,656,0.656,185,0.185,22
51611,41072,10539,33928,84,75000,569,1000,0.569,600,0.6,169,0.169,22
52167,41463,10704,34537,85,76000,556,1000,0.556,609,0.609,165,0.165,22
52710,41832,10878,35168,86,77000,543,1000,0.543,631,0.631,174,0.174,22
53242,42179,11063,35821,87,78000,532,1000,0.532,653,0.653,185,0.185,22
53799,42570,11229,36430,88,79000,557,1000,0.557,609,0.609,166,0.166,22
54348,42939,11409,37061,89,80000,549,1000,0.549,631,0.631,180,0.18,22
54900,43342,11558,37658,90,81000,552,1000,0.552,597,0.597,149,0.149,22
55429,43694,11735,38306,91,82000,529,1000,0.529,648,0.648,177,0.177,22
55946,44022,11924,38978,92,83000,517,1000,0.517,672,0.672,189,0.189,22
56467,44376,12091,39624,93,84000,521,1000,0.521,646,0.646,167,0.167,22
56978,44715,12263,40285,94,85000,511,1000,0.511,661,0.661,172,0.172,22
57549,45131,12418,40869,95,86000,571,1000,0.571,584,0.584,155,0.155,22
58063,45487,12576,41513,96,87000,514,1000,0.514,644,0.644,158,0.158,22
58578,45826,12752,42174,97,88000,515,1000,0.515,661,0.661,176,0.176,22
59101,46168,12933,42832,98,89000,523,1000,0.523,658,0.658,181,0.181,22
59647,46547,13100,43453,99,90000,546,1000,0.546,621,0.621,167,0.167,22
60198,46940,13258,44060,100,91000,551,1000,0.551,607,0.607,158,0.158,22
60709,47252,13457,44748,101,92000,511,1000,0.511,688,0.688,199,0.199,22
61218,47572,13646,45428,102,93000,509,1000,0.509,680,0.68,189,0.189,22
61747,47931,13816,46069,103,94000,529,1000,0.529,641,0.641,170,0.17,22
62257,48282,13975,46718,104,95000,510,1000,0.51,649,0.649,159,0.159,22
62755,48628,14127,47372,105,96000,498,1000,0.498,654,0.654,152,0.152,22
63262,48960,14302,48040,106,97000,507,1000,0.507,668,0.668,175,0.175,22
63772,49298,14474,48702,107,98000,510,1000,0.51,662,0.662,172,0.172,22
64279,49625,14654,49375,108,99000,507,1000,0.507,673,0.673,180,0.18,22
64788,49959,14829,50041,109,100000,509,1000,0.509,666,0.666,175,0.175,22
65305,50330,14975,50670,110,101000,517,1000,0.517,629,0.629,146,0.146,22
65788,50634,15154,51366,111,102000,483,1000,0.483,696,0.696,179,0.179,22
66289,50952,15337,52048,112,103000,501,1000,0.501,682,0.682,183,0.183,22
66792,51280,15512,52720,113,104000,503,1000,0.503,672,0.672,175,0.175,22
67280,51579,15701,53421,114,105000,488,1000,0.488,701,0.701,189,0.189,22
67813,51959,15854,54041,115,106000,533,1000,0.533,620,0.62,153,0.153,22
68290,52272,16018,54728,116,107000,477,1000,0.477,687,0.687,164,0.164,22
68792,52598,16194,55402,117,108000,502,1000,0.502,674,0.674,176,0.176,22
69327,52990,16337,56010,118,109000,535,1000,0.535,608,0.608,143,0.143,22
69788,53300,16488,56700,119,110000,461,1000,0.461,690,0.69,151,0.151,22
70267,53603,16664,57397,120,111000,479,1000,0.479,697,0.697,176,0.176,22
70753,53916,16837,58084,121,112000,486,1000,0.486,687,0.687,173,0.173,22
71242,54227,17015,58773,122,113000,489,1000,0.489,689,0.689,178,0.178,22
71727,54553,17174,59447,123,114000,485,1000,0.485,674,0.674,159,0.159,22
71869,54638,17231,59660,124,114298,142,298,0.47651006711409394,213,0.714765100671141,57,0.1912751677852349,22
100,100,0,0,1,100,NA,NA,NA,NA,NA,NA,NA,23
196,193,3,7,2,200,96,100,0.96,7,0.07,3,0.03,23
295,291,4,9,3,300,99,100,0.99,2,0.02,1,0.01,23
395,391,4,9,4,400,100,100,1,0,0,0,0,23
493,487,6,13,5,500,98,100,0.98,4,0.04,2,0.02,23
592,585,7,15,6,600,99,100,0.99,2,0.02,1,0.01,23
691,683,8,17,7,700,99,100,0.99,2,0.02,1,0.01,23
790,781,9,19,8,800,99,100,0.99,2,0.02,1,0.01,23
889,879,10,21,9,900,99,100,0.99,2,0.02,1,0.01,23
987,976,11,24,10,1000,98,100,0.98,3,0.03,1,0.01,23
1945,1901,44,99,11,2000,958,1000,0.958,75,0.075,33,0.033,23
2867,2765,102,235,12,3000,922,1000,0.922,136,0.136,58,0.058,23
3776,3613,163,387,13,4000,909,1000,0.909,152,0.152,61,0.061,23
4684,4461,223,539,14,5000,908,1000,0.908,152,0.152,60,0.06,23
5551,5242,309,758,15,6000,867,1000,0.867,219,0.219,86,0.086,23
6414,6023,391,977,16,7000,863,1000,0.863,219,0.219,82,0.082,23
7261,6769,492,1231,17,8000,847,1000,0.847,254,0.254,101,0.101,23
8099,7501,598,1499,18,9000,838,1000,0.838,268,0.268,106,0.106,23
8935,8241,694,1759,19,10000,836,1000,0.836,260,0.26,96,0.096,23
9753,8961,792,2039,20,11000,818,1000,0.818,280,0.28,98,0.098,23
10559,9653,906,2347,21,12000,806,1000,0.806,308,0.308,114,0.114,23
11369,10363,1006,2637,22,13000,810,1000,0.81,290,0.29,100,0.1,23
12185,11074,1111,2926,23,14000,816,1000,0.816,289,0.289,105,0.105,23
12963,11731,1232,3269,24,15000,778,1000,0.778,343,0.343,121,0.121,23
13751,12404,1347,3596,25,16000,788,1000,0.788,327,0.327,115,0.115,23
14532,13068,1464,3932,26,17000,781,1000,0.781,336,0.336,117,0.117,23
15304,13719,1585,4281,27,18000,772,1000,0.772,349,0.349,121,0.121,23
16061,14336,1725,4664,28,19000,757,1000,0.757,383,0.383,140,0.14,23
16827,14976,1851,5024,29,20000,766,1000,0.766,360,0.36,126,0.126,23
17558,15558,2000,5442,30,21000,731,1000,0.731,418,0.418,149,0.149,23
18282,16130,2152,5870,31,22000,724,1000,0.724,428,0.428,152,0.152,23
18998,16697,2301,6303,32,23000,716,1000,0.716,433,0.433,149,0.149,23
19723,17289,2434,6711,33,24000,725,1000,0.725,408,0.408,133,0.133,23
20455,17891,2564,7109,34,25000,732,1000,0.732,398,0.398,130,0.13,23
21188,18490,2698,7510,35,26000,733,1000,0.733,401,0.401,134,0.134,23
21935,19107,2828,7893,36,27000,747,1000,0.747,383,0.383,130,0.13,23
22652,19687,2965,8313,37,28000,717,1000,0.717,420,0.42,137,0.137,23
23355,20258,3097,8742,38,29000,703,1000,0.703,429,0.429,132,0.132,23
24035,20789,3246,9211,39,30000,680,1000,0.68,469,0.469,149,0.149,23
24735,21355,3380,9645,40,31000,700,1000,0.7,434,0.434,134,0.134,23
25408,21867,3541,10133,41,32000,673,1000,0.673,488,0.488,161,0.161,23
26095,22405,3690,10595,42,33000,687,1000,0.687,462,0.462,149,0.149,23
26808,22981,3827,11019,43,34000,713,1000,0.713,424,0.424,137,0.137,23
27485,23508,3977,11492,44,35000,677,1000,0.677,473,0.473,150,0.15,23
28177,24064,4113,11936,45,36000,692,1000,0.692,444,0.444,136,0.136,23
28829,24548,4281,12452,46,37000,652,1000,0.652,516,0.516,168,0.168,23
29455,25002,4453,12998,47,38000,626,1000,0.626,546,0.546,172,0.172,23
30118,25510,4608,13490,48,39000,663,1000,0.663,492,0.492,155,0.155,23
30765,25993,4772,14007,49,40000,647,1000,0.647,517,0.517,164,0.164,23
31398,26466,4932,14534,50,41000,633,1000,0.633,527,0.527,160,0.16,23
32057,26995,5062,15005,51,42000,659,1000,0.659,471,0.471,130,0.13,23
32702,27479,5223,15521,52,43000,645,1000,0.645,516,0.516,161,0.161,23
33333,27964,5369,16036,53,44000,631,1000,0.631,515,0.515,146,0.146,23
33994,28477,5517,16523,54,45000,661,1000,0.661,487,0.487,148,0.148,23
34627,28943,5684,17057,55,46000,633,1000,0.633,534,0.534,167,0.167,23
35264,29420,5844,17580,56,47000,637,1000,0.637,523,0.523,160,0.16,23
35862,29843,6019,18157,57,48000,598,1000,0.598,577,0.577,175,0.175,23
36513,30357,6156,18643,58,49000,651,1000,0.651,486,0.486,137,0.137,23
37116,30790,6326,19210,59,50000,603,1000,0.603,567,0.567,170,0.17,23
37730,31244,6486,19756,60,51000,614,1000,0.614,546,0.546,160,0.16,23
38352,31729,6623,20271,61,52000,622,1000,0.622,515,0.515,137,0.137,23
38967,32174,6793,20826,62,53000,615,1000,0.615,555,0.555,170,0.17,23
39602,32664,6938,21336,63,54000,635,1000,0.635,510,0.51,145,0.145,23
40203,33102,7101,21898,64,55000,601,1000,0.601,562,0.562,163,0.163,23
40810,33546,7264,22454,65,56000,607,1000,0.607,556,0.556,163,0.163,23
41425,34023,7402,22977,66,57000,615,1000,0.615,523,0.523,138,0.138,23
42031,34475,7556,23525,67,58000,606,1000,0.606,548,0.548,154,0.154,23
42585,34850,7735,24150,68,59000,554,1000,0.554,625,0.625,179,0.179,23
43215,35329,7886,24671,69,60000,630,1000,0.63,521,0.521,151,0.151,23
43807,35757,8050,25243,70,61000,592,1000,0.592,572,0.572,164,0.164,23
44370,36136,8234,25864,71,62000,563,1000,0.563,621,0.621,184,0.184,23
44950,36557,8393,26443,72,63000,580,1000,0.58,579,0.579,159,0.159,23
45522,36972,8550,27028,73,64000,572,1000,0.572,585,0.585,157,0.157,23
46094,37398,8696,27602,74,65000,572,1000,0.572,574,0.574,146,0.146,23
46649,37776,8873,28224,75,66000,555,1000,0.555,622,0.622,177,0.177,23
47222,38175,9047,28825,76,67000,573,1000,0.573,601,0.601,174,0.174,23
47799,38584,9215,29416,77,68000,577,1000,0.577,591,0.591,168,0.168,23
48355,38964,9391,30036,78,69000,556,1000,0.556,620,0.62,176,0.176,23
48927,39370,9557,30630,79,70000,572,1000,0.572,594,0.594,166,0.166,23
49481,39748,9733,31252,80,71000,554,1000,0.554,622,0.622,176,0.176,23
50036,40107,9929,31893,81,72000,555,1000,0.555,641,0.641,196,0.196,23
50602,40516,10086,32484,82,73000,566,1000,0.566,591,0.591,157,0.157,23
51116,40845,10271,33155,83,74000,514,1000,0.514,671,0.671,185,0.185,23
51662,41215,10447,33785,84,75000,546,1000,0.546,630,0.63,176,0.176,23
52187,41553,10634,34447,85,76000,525,1000,0.525,662,0.662,187,0.187,23
52760,41970,10790,35030,86,77000,573,1000,0.573,583,0.583,156,0.156,23
53298,42329,10969,35671,87,78000,538,1000,0.538,641,0.641,179,0.179,23
53832,42690,11142,36310,88,79000,534,1000,0.534,639,0.639,173,0.173,23
54359,43050,11309,36950,89,80000,527,1000,0.527,640,0.64,167,0.167,23
54894,43427,11467,37573,90,81000,535,1000,0.535,623,0.623,158,0.158,23
55428,43780,11648,38220,91,82000,534,1000,0.534,647,0.647,181,0.181,23
55949,44135,11814,38865,92,83000,521,1000,0.521,645,0.645,166,0.166,23
56504,44507,11997,39493,93,84000,555,1000,0.555,628,0.628,183,0.183,23
57030,44872,12158,40128,94,85000,526,1000,0.526,635,0.635,161,0.161,23
57564,45225,12339,40775,95,86000,534,1000,0.534,647,0.647,181,0.181,23
58098,45601,12497,41399,96,87000,534,1000,0.534,624,0.624,158,0.158,23
58624,45952,12672,42048,97,88000,526,1000,0.526,649,0.649,175,0.175,23
59162,46317,12845,42683,98,89000,538,1000,0.538,635,0.635,173,0.173,23
59691,46683,13008,43317,99,90000,529,1000,0.529,634,0.634,163,0.163,23
60198,46995,13203,44005,100,91000,507,1000,0.507,688,0.688,195,0.195,23
60740,47369,13371,44631,101,92000,542,1000,0.542,626,0.626,168,0.168,23
61268,47724,13544,45276,102,93000,528,1000,0.528,645,0.645,173,0.173,23
61776,48076,13700,45924,103,94000,508,1000,0.508,648,0.648,156,0.156,23
62268,48379,13889,46621,104,95000,492,1000,0.492,697,0.697,189,0.189,23
62752,48697,14055,47303,105,96000,484,1000,0.484,682,0.682,166,0.166,23
63282,49054,14228,47946,106,97000,530,1000,0.53,643,0.643,173,0.173,23
63796,49421,14375,48579,107,98000,514,1000,0.514,633,0.633,147,0.147,23
64308,49766,14542,49234,108,99000,512,1000,0.512,655,0.655,167,0.167,23
64802,50085,14717,49915,109,100000,494,1000,0.494,681,0.681,175,0.175,23
65309,50411,14898,50589,110,101000,507,1000,0.507,674,0.674,181,0.181,23
65823,50752,15071,51248,111,102000,514,1000,0.514,659,0.659,173,0.173,23
66324,51061,15263,51939,112,103000,501,1000,0.501,691,0.691,192,0.192,23
66821,51396,15425,52604,113,104000,497,1000,0.497,665,0.665,162,0.162,23
67306,51712,15594,53288,114,105000,485,1000,0.485,684,0.684,169,0.169,23
67830,52054,15776,53946,115,106000,524,1000,0.524,658,0.658,182,0.182,23
68321,52375,15946,54625,116,107000,491,1000,0.491,679,0.679,170,0.17,23
68824,52711,16113,55289,117,108000,503,1000,0.503,664,0.664,167,0.167,23
69320,53030,16290,55970,118,109000,496,1000,0.496,681,0.681,177,0.177,23
69806,53341,16465,56659,119,110000,486,1000,0.486,689,0.689,175,0.175,23
70319,53687,16632,57313,120,111000,513,1000,0.513,654,0.654,167,0.167,23
70796,53990,16806,58010,121,112000,477,1000,0.477,697,0.697,174,0.174,23
71297,54315,16982,58685,122,113000,501,1000,0.501,675,0.675,176,0.176,23
71735,54559,17176,59441,123,114000,438,1000,0.438,756,0.756,194,0.194,23
71869,54638,17231,59660,124,114298,134,298,0.44966442953020136,219,0.7348993288590604,55,0.18456375838926176,23
100,100,0,0,1,100,NA,NA,NA,NA,NA,NA,NA,24
199,198,1,2,2,200,99,100,0.99,2,0.02,1,0.01,24
299,298,1,2,3,300,100,100,1,0,0,0,0,24
398,396,2,4,4,400,99,100,0.99,2,0.02,1,0.01,24
496,492,4,8,5,500,98,100,0.98,4,0.04,2,0.02,24
594,588,6,12,6,600,98,100,0.98,4,0.04,2,0.02,24
694,688,6,12,7,700,100,100,1,0,0,0,0,24
791,782,9,18,8,800,97,100,0.97,6,0.06,3,0.03,24
888,879,9,21,9,900,97,100,0.97,3,0.03,0,0,24
986,976,10,24,10,1000,98,100,0.98,3,0.03,1,0.01,24
1932,1880,52,120,11,2000,946,1000,0.946,96,0.096,42,0.042,24
2867,2768,99,232,12,3000,935,1000,0.935,112,0.112,47,0.047,24
3798,3655,143,345,13,4000,931,1000,0.931,113,0.113,44,0.044,24
4698,4490,208,510,14,5000,900,1000,0.9,165,0.165,65,0.065,24
5576,5290,286,710,15,6000,878,1000,0.878,200,0.2,78,0.078,24
6465,6107,358,893,16,7000,889,1000,0.889,183,0.183,72,0.072,24
7318,6862,456,1138,17,8000,853,1000,0.853,245,0.245,98,0.098,24
8152,7593,559,1407,18,9000,834,1000,0.834,269,0.269,103,0.103,24
8980,8323,657,1677,19,10000,828,1000,0.828,270,0.27,98,0.098,24
9788,9021,767,1979,20,11000,808,1000,0.808,302,0.302,110,0.11,24
10635,9770,865,2230,21,12000,847,1000,0.847,251,0.251,98,0.098,24
11455,10473,982,2527,22,13000,820,1000,0.82,297,0.297,117,0.117,24
12241,11132,1109,2868,23,14000,786,1000,0.786,341,0.341,127,0.127,24
13045,11818,1227,3182,24,15000,804,1000,0.804,314,0.314,118,0.118,24
13832,12495,1337,3505,25,16000,787,1000,0.787,323,0.323,110,0.11,24
14602,13146,1456,3854,26,17000,770,1000,0.77,349,0.349,119,0.119,24
15375,13799,1576,4201,27,18000,773,1000,0.773,347,0.347,120,0.12,24
16142,14443,1699,4557,28,19000,767,1000,0.767,356,0.356,123,0.123,24
16890,15066,1824,4934,29,20000,748,1000,0.748,377,0.377,125,0.125,24
17652,15705,1947,5295,30,21000,762,1000,0.762,361,0.361,123,0.123,24
18412,16343,2069,5657,31,22000,760,1000,0.76,362,0.362,122,0.122,24
19147,16927,2220,6073,32,23000,735,1000,0.735,416,0.416,151,0.151,24
19897,17550,2347,6450,33,24000,750,1000,0.75,377,0.377,127,0.127,24
20642,18161,2481,6839,34,25000,745,1000,0.745,389,0.389,134,0.134,24
21380,18767,2613,7233,35,26000,738,1000,0.738,394,0.394,132,0.132,24
22088,19336,2752,7664,36,27000,708,1000,0.708,431,0.431,139,0.139,24
22781,19879,2902,8121,37,28000,693,1000,0.693,457,0.457,150,0.15,24
23473,20413,3060,8587,38,29000,692,1000,0.692,466,0.466,158,0.158,24
24164,20944,3220,9056,39,30000,691,1000,0.691,469,0.469,160,0.16,24
24876,21510,3366,9490,40,31000,712,1000,0.712,434,0.434,146,0.146,24
25574,22060,3514,9940,41,32000,698,1000,0.698,450,0.45,148,0.148,24
26271,22607,3664,10393,42,33000,697,1000,0.697,453,0.453,150,0.15,24
26942,23139,3803,10861,43,34000,671,1000,0.671,468,0.468,139,0.139,24
27610,23633,3977,11367,44,35000,668,1000,0.668,506,0.506,174,0.174,24
28255,24120,4135,11880,45,36000,645,1000,0.645,513,0.513,158,0.158,24
28920,24635,4285,12365,46,37000,665,1000,0.665,485,0.485,150,0.15,24
29605,25187,4418,12813,47,38000,685,1000,0.685,448,0.448,133,0.133,24
30239,25665,4574,13335,48,39000,634,1000,0.634,522,0.522,156,0.156,24
30868,26120,4748,13880,49,40000,629,1000,0.629,545,0.545,174,0.174,24
31522,26617,4905,14383,50,41000,654,1000,0.654,503,0.503,157,0.157,24
32185,27127,5058,14873,51,42000,663,1000,0.663,490,0.49,153,0.153,24
32833,27622,5211,15378,52,43000,648,1000,0.648,505,0.505,153,0.153,24
33507,28163,5344,15837,53,44000,674,1000,0.674,459,0.459,133,0.133,24
34168,28671,5497,16329,54,45000,661,1000,0.661,492,0.492,153,0.153,24
34789,29138,5651,16862,55,46000,621,1000,0.621,533,0.533,154,0.154,24
35415,29592,5823,17408,56,47000,626,1000,0.626,546,0.546,172,0.172,24
36031,30030,6001,17970,57,48000,616,1000,0.616,562,0.562,178,0.178,24
36620,30439,6181,18561,58,49000,589,1000,0.589,591,0.591,180,0.18,24
37241,30908,6333,19092,59,50000,621,1000,0.621,531,0.531,152,0.152,24
37861,31357,6504,19643,60,51000,620,1000,0.62,551,0.551,171,0.171,24
38473,31811,6662,20189,61,52000,612,1000,0.612,546,0.546,158,0.158,24
39079,32230,6849,20770,62,53000,606,1000,0.606,581,0.581,187,0.187,24
39686,32672,7014,21328,63,54000,607,1000,0.607,558,0.558,165,0.165,24
40285,33099,7186,21901,64,55000,599,1000,0.599,573,0.573,172,0.172,24
40912,33573,7339,22427,65,56000,627,1000,0.627,526,0.526,153,0.153,24
41502,33991,7511,23009,66,57000,590,1000,0.59,582,0.582,172,0.172,24
42088,34389,7699,23611,67,58000,586,1000,0.586,602,0.602,188,0.188,24
42701,34825,7876,24175,68,59000,613,1000,0.613,564,0.564,177,0.177,24
43299,35250,8049,24750,69,60000,598,1000,0.598,575,0.575,173,0.173,24
43908,35707,8201,25293,70,61000,609,1000,0.609,543,0.543,152,0.152,24
44479,36084,8395,25916,71,62000,571,1000,0.571,623,0.623,194,0.194,24
45049,36474,8575,26526,72,63000,570,1000,0.57,610,0.61,180,0.18,24
45615,36855,8760,27145,73,64000,566,1000,0.566,619,0.619,185,0.185,24
46174,37232,8942,27768,74,65000,559,1000,0.559,623,0.623,182,0.182,24
46733,37628,9105,28372,75,66000,559,1000,0.559,604,0.604,163,0.163,24
47355,38112,9243,28888,76,67000,622,1000,0.622,516,0.516,138,0.138,24
47925,38531,9394,29469,77,68000,570,1000,0.57,581,0.581,151,0.151,24
48477,38902,9575,30098,78,69000,552,1000,0.552,629,0.629,181,0.181,24
49030,39280,9750,30720,79,70000,553,1000,0.553,622,0.622,175,0.175,24
49584,39669,9915,31331,80,71000,554,1000,0.554,611,0.611,165,0.165,24
50145,40057,10088,31943,81,72000,561,1000,0.561,612,0.612,173,0.173,24
50690,40439,10251,32561,82,73000,545,1000,0.545,618,0.618,163,0.163,24
51251,40837,10414,33163,83,74000,561,1000,0.561,602,0.602,163,0.163,24
51788,41209,10579,33791,84,75000,537,1000,0.537,628,0.628,165,0.165,24
52342,41603,10739,34397,85,76000,554,1000,0.554,606,0.606,160,0.16,24
52868,41952,10916,35048,86,77000,526,1000,0.526,651,0.651,177,0.177,24
53393,42301,11092,35699,87,78000,525,1000,0.525,651,0.651,176,0.176,24
53938,42693,11245,36307,88,79000,545,1000,0.545,608,0.608,153,0.153,24
54476,43076,11400,36924,89,80000,538,1000,0.538,617,0.617,155,0.155,24
55018,43444,11574,37556,90,81000,542,1000,0.542,632,0.632,174,0.174,24
55554,43813,11741,38187,91,82000,536,1000,0.536,631,0.631,167,0.167,24
56068,44150,11918,38850,92,83000,514,1000,0.514,663,0.663,177,0.177,24
56612,44514,12098,39486,93,84000,544,1000,0.544,636,0.636,180,0.18,24
57159,44891,12268,40109,94,85000,547,1000,0.547,623,0.623,170,0.17,24
57700,45264,12436,40736,95,86000,541,1000,0.541,627,0.627,168,0.168,24
58239,45649,12590,41351,96,87000,539,1000,0.539,615,0.615,154,0.154,24
58777,46019,12758,41981,97,88000,538,1000,0.538,630,0.63,168,0.168,24
59282,46357,12925,42643,98,89000,505,1000,0.505,662,0.662,167,0.167,24
59788,46700,13088,43300,99,90000,506,1000,0.506,657,0.657,163,0.163,24
60303,47029,13274,43971,100,91000,515,1000,0.515,671,0.671,186,0.186,24
60798,47328,13470,44672,101,92000,495,1000,0.495,701,0.701,196,0.196,24
61322,47692,13630,45308,102,93000,524,1000,0.524,636,0.636,160,0.16,24
61840,48039,13801,45961,103,94000,518,1000,0.518,653,0.653,171,0.171,24
62392,48443,13949,46557,104,95000,552,1000,0.552,596,0.596,148,0.148,24
62914,48795,14119,47205,105,96000,522,1000,0.522,648,0.648,170,0.17,24
63407,49121,14286,47879,106,97000,493,1000,0.493,674,0.674,167,0.167,24
63893,49437,14456,48563,107,98000,486,1000,0.486,684,0.684,170,0.17,24
64380,49756,14624,49244,108,99000,487,1000,0.487,681,0.681,168,0.168,24
64907,50097,14810,49903,109,100000,527,1000,0.527,659,0.659,186,0.186,24
65397,50413,14984,50587,110,101000,490,1000,0.49,684,0.684,174,0.174,24
65911,50750,15161,51250,111,102000,514,1000,0.514,663,0.663,177,0.177,24
66417,51094,15323,51906,112,103000,506,1000,0.506,656,0.656,162,0.162,24
66926,51436,15490,52564,113,104000,509,1000,0.509,658,0.658,167,0.167,24
67402,51734,15668,53266,114,105000,476,1000,0.476,702,0.702,178,0.178,24
67862,52003,15859,53997,115,106000,460,1000,0.46,731,0.731,191,0.191,24
68382,52382,16000,54618,116,107000,520,1000,0.52,621,0.621,141,0.141,24
68890,52729,16161,55271,117,108000,508,1000,0.508,653,0.653,161,0.161,24
69364,53050,16314,55950,118,109000,474,1000,0.474,679,0.679,153,0.153,24
69840,53363,16477,56637,119,110000,476,1000,0.476,687,0.687,163,0.163,24
70310,53657,16653,57343,120,111000,470,1000,0.47,706,0.706,176,0.176,24
70751,53918,16833,58082,121,112000,441,1000,0.441,739,0.739,180,0.18,24
71235,54235,17000,58765,122,113000,484,1000,0.484,683,0.683,167,0.167,24
71724,54542,17182,59458,123,114000,489,1000,0.489,693,0.693,182,0.182,24
71869,54638,17231,59660,124,114298,145,298,0.4865771812080537,202,0.6778523489932886,49,0.1644295302013423,24
100,100,0,0,1,100,NA,NA,NA,NA,NA,NA,NA,25
200,200,0,0,2,200,100,100,1,0,0,0,0,25
298,296,2,4,3,300,98,100,0.98,4,0.04,2,0.02,25
398,396,2,4,4,400,100,100,1,0,0,0,0,25
497,494,3,6,5,500,99,100,0.99,2,0.02,1,0.01,25
594,588,6,12,6,600,97,100,0.97,6,0.06,3,0.03,25
692,684,8,16,7,700,98,100,0.98,4,0.04,2,0.02,25
791,782,9,18,8,800,99,100,0.99,2,0.02,1,0.01,25
890,880,10,20,9,900,99,100,0.99,2,0.02,1,0.01,25
989,979,10,21,10,1000,99,100,0.99,1,0.01,0,0,25
1945,1901,44,99,11,2000,956,1000,0.956,78,0.078,34,0.034,25
2890,2800,90,200,12,3000,945,1000,0.945,101,0.101,46,0.046,25
3805,3651,154,349,13,4000,915,1000,0.915,149,0.149,64,0.064,25
4697,4476,221,524,14,5000,892,1000,0.892,175,0.175,67,0.067,25
5589,5304,285,696,15,6000,892,1000,0.892,172,0.172,64,0.064,25
6446,6066,380,934,16,7000,857,1000,0.857,238,0.238,95,0.095,25
7306,6842,464,1158,17,8000,860,1000,0.86,224,0.224,84,0.084,25
8157,7608,549,1392,18,9000,851,1000,0.851,234,0.234,85,0.085,25
8992,8340,652,1660,19,10000,835,1000,0.835,268,0.268,103,0.103,25
9830,9091,739,1909,20,11000,838,1000,0.838,249,0.249,87,0.087,25
10659,9811,848,2189,21,12000,829,1000,0.829,280,0.28,109,0.109,25
11458,10491,967,2509,22,13000,799,1000,0.799,320,0.32,119,0.119,25
12246,11158,1088,2842,23,14000,788,1000,0.788,333,0.333,121,0.121,25
13036,11819,1217,3181,24,15000,790,1000,0.79,339,0.339,129,0.129,25
13825,12493,1332,3507,25,16000,789,1000,0.789,326,0.326,115,0.115,25
14642,13207,1435,3793,26,17000,817,1000,0.817,286,0.286,103,0.103,25
15417,13853,1564,4147,27,18000,775,1000,0.775,354,0.354,129,0.129,25
16171,14478,1693,4522,28,19000,754,1000,0.754,375,0.375,129,0.129,25
16924,15104,1820,4896,29,20000,753,1000,0.753,374,0.374,127,0.127,25
17678,15756,1922,5244,30,21000,754,1000,0.754,348,0.348,102,0.102,25
18405,16336,2069,5664,31,22000,727,1000,0.727,420,0.42,147,0.147,25
19129,16901,2228,6099,32,23000,724,1000,0.724,435,0.435,159,0.159,25
19855,17487,2368,6513,33,24000,726,1000,0.726,414,0.414,140,0.14,25
20579,18073,2506,6927,34,25000,724,1000,0.724,414,0.414,138,0.138,25
21290,18624,2666,7376,35,26000,711,1000,0.711,449,0.449,160,0.16,25
22002,19194,2808,7806,36,27000,712,1000,0.712,430,0.43,142,0.142,25
22716,19771,2945,8229,37,28000,714,1000,0.714,423,0.423,137,0.137,25
23434,20360,3074,8640,38,29000,718,1000,0.718,411,0.411,129,0.129,25
24129,20911,3218,9089,39,30000,695,1000,0.695,449,0.449,144,0.144,25
24830,21464,3366,9536,40,31000,701,1000,0.701,447,0.447,148,0.148,25
25524,22019,3505,9981,41,32000,694,1000,0.694,445,0.445,139,0.139,25
26223,22586,3637,10414,42,33000,699,1000,0.699,433,0.433,132,0.132,25
26883,23093,3790,10907,43,34000,660,1000,0.66,493,0.493,153,0.153,25
27543,23601,3942,11399,44,35000,660,1000,0.66,492,0.492,152,0.152,25
28228,24152,4076,11848,45,36000,685,1000,0.685,449,0.449,134,0.134,25
28902,24685,4217,12315,46,37000,674,1000,0.674,467,0.467,141,0.141,25
29576,25205,4371,12795,47,38000,674,1000,0.674,480,0.48,154,0.154,25
30221,25698,4523,13302,48,39000,645,1000,0.645,507,0.507,152,0.152,25
30874,26197,4677,13803,49,40000,653,1000,0.653,501,0.501,154,0.154,25
31509,26662,4847,14338,50,41000,635,1000,0.635,535,0.535,170,0.17,25
32173,27181,4992,14819,51,42000,664,1000,0.664,481,0.481,145,0.145,25
32791,27626,5165,15374,52,43000,618,1000,0.618,555,0.555,173,0.173,25
33447,28135,5312,15865,53,44000,656,1000,0.656,491,0.491,147,0.147,25
34059,28584,5475,16416,54,45000,612,1000,0.612,551,0.551,163,0.163,25
34695,29069,5626,16931,55,46000,636,1000,0.636,515,0.515,151,0.151,25
35335,29541,5794,17459,56,47000,640,1000,0.64,528,0.528,168,0.168,25
35978,30040,5938,17960,57,48000,643,1000,0.643,501,0.501,144,0.144,25
36606,30511,6095,18489,58,49000,628,1000,0.628,529,0.529,157,0.157,25
37208,30925,6283,19075,59,50000,602,1000,0.602,586,0.586,188,0.188,25
37838,31393,6445,19607,60,51000,630,1000,0.63,532,0.532,162,0.162,25
38450,31853,6597,20147,61,52000,612,1000,0.612,540,0.54,152,0.152,25
39064,32308,6756,20692,62,53000,614,1000,0.614,545,0.545,159,0.159,25
39666,32730,6936,21270,63,54000,602,1000,0.602,578,0.578,180,0.18,25
40272,33167,7105,21833,64,55000,606,1000,0.606,563,0.563,169,0.169,25
40851,33545,7306,22455,65,56000,579,1000,0.579,622,0.622,201,0.201,25
41480,33989,7491,23011,66,57000,629,1000,0.629,556,0.556,185,0.185,25
42086,34434,7652,23566,67,58000,606,1000,0.606,555,0.555,161,0.161,25
42675,34849,7826,24151,68,59000,589,1000,0.589,585,0.585,174,0.174,25
43276,35290,7986,24710,69,60000,601,1000,0.601,559,0.559,160,0.16,25
43858,35706,8152,25294,70,61000,582,1000,0.582,584,0.584,166,0.166,25
44461,36155,8306,25845,71,62000,603,1000,0.603,551,0.551,154,0.154,25
45053,36578,8475,26422,72,63000,592,1000,0.592,577,0.577,169,0.169,25
45603,36940,8663,27060,73,64000,550,1000,0.55,638,0.638,188,0.188,25
46192,37350,8842,27650,74,65000,589,1000,0.589,590,0.59,179,0.179,25
46777,37770,9007,28230,75,66000,585,1000,0.585,580,0.58,165,0.165,25
47339,38171,9168,28829,76,67000,562,1000,0.562,599,0.599,161,0.161,25
47897,38566,9331,29434,77,68000,558,1000,0.558,605,0.605,163,0.163,25
48435,38911,9524,30089,78,69000,538,1000,0.538,655,0.655,193,0.193,25
49002,39307,9695,30693,79,70000,567,1000,0.567,604,0.604,171,0.171,25
49579,39718,9861,31282,80,71000,577,1000,0.577,589,0.589,166,0.166,25
50156,40130,10026,31870,81,72000,577,1000,0.577,588,0.588,165,0.165,25
50723,40552,10171,32448,82,73000,567,1000,0.567,578,0.578,145,0.145,25
51285,40954,10331,33046,83,74000,562,1000,0.562,598,0.598,160,0.16,25
51850,41352,10498,33648,84,75000,565,1000,0.565,602,0.602,167,0.167,25
52414,41742,10672,34258,85,76000,564,1000,0.564,610,0.61,174,0.174,25
52954,42115,10839,34885,86,77000,540,1000,0.54,627,0.627,167,0.167,25
53529,42535,10994,35465,87,78000,575,1000,0.575,580,0.58,155,0.155,25
54081,42910,11171,36090,88,79000,552,1000,0.552,625,0.625,177,0.177,25
54584,43234,11350,36766,89,80000,503,1000,0.503,676,0.676,179,0.179,25
55123,43609,11514,37391,90,81000,539,1000,0.539,625,0.625,164,0.164,25
55659,43987,11672,38013,91,82000,536,1000,0.536,622,0.622,158,0.158,25
56168,44337,11831,38663,92,83000,509,1000,0.509,650,0.65,159,0.159,25
56686,44687,11999,39313,93,84000,518,1000,0.518,650,0.65,168,0.168,25
57225,45050,12175,39950,94,85000,539,1000,0.539,637,0.637,176,0.176,25
57748,45409,12339,40591,95,86000,523,1000,0.523,641,0.641,164,0.164,25
58267,45761,12506,41239,96,87000,519,1000,0.519,648,0.648,167,0.167,25
58792,46104,12688,41896,97,88000,525,1000,0.525,657,0.657,182,0.182,25
59292,46431,12861,42569,98,89000,500,1000,0.5,673,0.673,173,0.173,25
59817,46785,13032,43215,99,90000,525,1000,0.525,646,0.646,171,0.171,25
60308,47085,13223,43915,100,91000,491,1000,0.491,700,0.7,191,0.191,25
60813,47416,13397,44584,101,92000,505,1000,0.505,669,0.669,174,0.174,25
61332,47752,13580,45248,102,93000,519,1000,0.519,664,0.664,183,0.183,25
61844,48103,13741,45897,103,94000,512,1000,0.512,649,0.649,161,0.161,25
62355,48434,13921,46566,104,95000,511,1000,0.511,669,0.669,180,0.18,25
62840,48736,14104,47264,105,96000,485,1000,0.485,698,0.698,183,0.183,25
63362,49074,14288,47926,106,97000,522,1000,0.522,662,0.662,184,0.184,25
63863,49405,14458,48595,107,98000,501,1000,0.501,669,0.669,170,0.17,25
64377,49752,14625,49248,108,99000,514,1000,0.514,653,0.653,167,0.167,25
64866,50068,14798,49932,109,100000,489,1000,0.489,684,0.684,173,0.173,25
65403,50437,14966,50563,110,101000,537,1000,0.537,631,0.631,168,0.168,25
65883,50762,15121,51238,111,102000,480,1000,0.48,675,0.675,155,0.155,25
66391,51098,15293,51902,112,103000,508,1000,0.508,664,0.664,172,0.172,25
66876,51400,15476,52600,113,104000,485,1000,0.485,698,0.698,183,0.183,25
67353,51690,15663,53310,114,105000,477,1000,0.477,710,0.71,187,0.187,25
67859,52026,15833,53974,115,106000,506,1000,0.506,664,0.664,170,0.17,25
68361,52342,16019,54658,116,107000,502,1000,0.502,684,0.684,186,0.186,25
68843,52644,16199,55356,117,108000,482,1000,0.482,698,0.698,180,0.18,25
69346,52994,16352,56006,118,109000,503,1000,0.503,650,0.65,153,0.153,25
69834,53317,16517,56683,119,110000,488,1000,0.488,677,0.677,165,0.165,25
70288,53601,16687,57399,120,111000,454,1000,0.454,716,0.716,170,0.17,25
70762,53913,16849,58087,121,112000,474,1000,0.474,688,0.688,162,0.162,25
71242,54225,17017,58775,122,113000,480,1000,0.48,688,0.688,168,0.168,25
71721,54536,17185,59464,123,114000,479,1000,0.479,689,0.689,168,0.168,25
71869,54638,17231,59660,124,114298,148,298,0.49664429530201343,196,0.6577181208053692,46,0.15436241610738255,25
100,100,0,0,1,100,NA,NA,NA,NA,NA,NA,NA,26
199,198,1,2,2,200,99,100,0.99,2,0.02,1,0.01,26
298,296,2,4,3,300,99,100,0.99,2,0.02,1,0.01,26
398,396,2,4,4,400,100,100,1,0,0,0,0,26
495,490,5,10,5,500,97,100,0.97,6,0.06,3,0.03,26
592,584,8,16,6,600,97,100,0.97,6,0.06,3,0.03,26
689,678,11,22,7,700,97,100,0.97,6,0.06,3,0.03,26
785,770,15,30,8,800,96,100,0.96,8,0.08,4,0.04,26
882,864,18,36,9,900,97,100,0.97,6,0.06,3,0.03,26
979,958,21,42,10,1000,97,100,0.97,6,0.06,3,0.03,26
1940,1890,50,110,11,2000,961,1000,0.961,68,0.068,29,0.029,26
2872,2770,102,230,12,3000,932,1000,0.932,120,0.12,52,0.052,26
3790,3637,153,363,13,4000,918,1000,0.918,133,0.133,51,0.051,26
4679,4454,225,546,14,5000,889,1000,0.889,183,0.183,72,0.072,26
5578,5281,297,719,15,6000,899,1000,0.899,173,0.173,72,0.072,26
6443,6061,382,939,16,7000,865,1000,0.865,220,0.22,85,0.085,26
7307,6834,473,1166,17,8000,864,1000,0.864,227,0.227,91,0.091,26
8164,7605,559,1395,18,9000,857,1000,0.857,229,0.229,86,0.086,26
9009,8355,654,1645,19,10000,845,1000,0.845,250,0.25,95,0.095,26
9825,9065,760,1935,20,11000,816,1000,0.816,290,0.29,106,0.106,26
10640,9769,871,2231,21,12000,815,1000,0.815,296,0.296,111,0.111,26
11464,10485,979,2515,22,13000,824,1000,0.824,284,0.284,108,0.108,26
12264,11170,1094,2830,23,14000,800,1000,0.8,315,0.315,115,0.115,26
13051,11836,1215,3164,24,15000,787,1000,0.787,334,0.334,121,0.121,26
13855,12540,1315,3460,25,16000,804,1000,0.804,296,0.296,100,0.1,26
14626,13176,1450,3824,26,17000,771,1000,0.771,364,0.364,135,0.135,26
15377,13787,1590,4213,27,18000,751,1000,0.751,389,0.389,140,0.14,26
16137,14422,1715,4578,28,19000,760,1000,0.76,365,0.365,125,0.125,26
16883,15042,1841,4958,29,20000,746,1000,0.746,380,0.38,126,0.126,26
17626,15649,1977,5351,30,21000,743,1000,0.743,393,0.393,136,0.136,26
18386,16289,2097,5711,31,22000,760,1000,0.76,360,0.36,120,0.12,26
19143,16915,2228,6085,32,23000,757,1000,0.757,374,0.374,131,0.131,26
19884,17521,2363,6479,33,24000,741,1000,0.741,394,0.394,135,0.135,26
20602,18077,2525,6923,34,25000,718,1000,0.718,444,0.444,162,0.162,26
21322,18651,2671,7349,35,26000,720,1000,0.72,426,0.426,146,0.146,26
22042,19249,2793,7751,36,27000,720,1000,0.72,402,0.402,122,0.122,26
22776,19852,2924,8148,37,28000,734,1000,0.734,397,0.397,131,0.131,26
23476,20409,3067,8591,38,29000,700,1000,0.7,443,0.443,143,0.143,26
24174,20951,3223,9049,39,30000,698,1000,0.698,458,0.458,156,0.156,26
24871,21504,3367,9496,40,31000,697,1000,0.697,447,0.447,144,0.144,26
25546,22015,3531,9985,41,32000,675,1000,0.675,489,0.489,164,0.164,26
26212,22532,3680,10468,42,33000,666,1000,0.666,483,0.483,149,0.149,26
26911,23084,3827,10916,43,34000,699,1000,0.699,448,0.448,147,0.147,26
27588,23599,3989,11401,44,35000,677,1000,0.677,485,0.485,162,0.162,26
28238,24091,4147,11909,45,36000,650,1000,0.65,508,0.508,158,0.158,26
28880,24570,4310,12430,46,37000,642,1000,0.642,521,0.521,163,0.163,26
29552,25086,4466,12914,47,38000,672,1000,0.672,484,0.484,156,0.156,26
30235,25619,4616,13381,48,39000,683,1000,0.683,467,0.467,150,0.15,26
30889,26119,4770,13881,49,40000,654,1000,0.654,500,0.5,154,0.154,26
31547,26612,4935,14388,50,41000,658,1000,0.658,507,0.507,165,0.165,26
32169,27055,5114,14945,51,42000,622,1000,0.622,557,0.557,179,0.179,26
32805,27533,5272,15467,52,43000,636,1000,0.636,522,0.522,158,0.158,26
33448,28012,5436,15988,53,44000,643,1000,0.643,521,0.521,164,0.164,26
34069,28477,5592,16523,54,45000,621,1000,0.621,535,0.535,156,0.156,26
34685,28927,5758,17073,55,46000,616,1000,0.616,550,0.55,166,0.166,26
35312,29390,5922,17610,56,47000,627,1000,0.627,537,0.537,164,0.164,26
35931,29834,6097,18166,57,48000,619,1000,0.619,556,0.556,175,0.175,26
36551,30292,6259,18708,58,49000,620,1000,0.62,542,0.542,162,0.162,26
37167,30721,6446,19279,59,50000,616,1000,0.616,571,0.571,187,0.187,26
37789,31184,6605,19816,60,51000,622,1000,0.622,537,0.537,159,0.159,26
38416,31660,6756,20340,61,52000,627,1000,0.627,524,0.524,151,0.151,26
39032,32126,6906,20874,62,53000,616,1000,0.616,534,0.534,150,0.15,26
39662,32617,7045,21383,63,54000,630,1000,0.63,509,0.509,139,0.139,26
40247,33033,7214,21967,64,55000,585,1000,0.585,584,0.584,169,0.169,26
40826,33436,7390,22564,65,56000,579,1000,0.579,597,0.597,176,0.176,26
41414,33857,7557,23143,66,57000,588,1000,0.588,579,0.579,167,0.167,26
42018,34304,7714,23696,67,58000,604,1000,0.604,553,0.553,157,0.157,26
42622,34748,7874,24252,68,59000,604,1000,0.604,556,0.556,160,0.16,26
43216,35186,8030,24814,69,60000,594,1000,0.594,562,0.562,156,0.156,26
43810,35626,8184,25374,70,61000,594,1000,0.594,560,0.56,154,0.154,26
44384,36024,8360,25976,71,62000,574,1000,0.574,602,0.602,176,0.176,26
44959,36424,8535,26576,72,63000,575,1000,0.575,600,0.6,175,0.175,26
45539,36848,8691,27152,73,64000,580,1000,0.58,576,0.576,156,0.156,26
46116,37244,8872,27756,74,65000,577,1000,0.577,604,0.604,181,0.181,26
46690,37655,9035,28345,75,66000,574,1000,0.574,589,0.589,163,0.163,26
47274,38096,9178,28904,76,67000,584,1000,0.584,559,0.559,143,0.143,26
47836,38479,9357,29521,77,68000,562,1000,0.562,617,0.617,179,0.179,26
48415,38893,9522,30107,78,69000,579,1000,0.579,586,0.586,165,0.165,26
49004,39309,9695,30691,79,70000,589,1000,0.589,584,0.584,173,0.173,26
49589,39755,9834,31245,80,71000,585,1000,0.585,554,0.554,139,0.139,26
50100,40071,10029,31929,81,72000,511,1000,0.511,684,0.684,195,0.195,26
50684,40511,10173,32489,82,73000,584,1000,0.584,560,0.56,144,0.144,26
51249,40905,10344,33095,83,74000,565,1000,0.565,606,0.606,171,0.171,26
51800,41284,10516,33716,84,75000,551,1000,0.551,621,0.621,172,0.172,26
52338,41641,10697,34359,85,76000,538,1000,0.538,643,0.643,181,0.181,26
52877,42005,10872,34995,86,77000,539,1000,0.539,636,0.636,175,0.175,26
53404,42356,11048,35644,87,78000,527,1000,0.527,649,0.649,176,0.176,26
53966,42756,11210,36244,88,79000,562,1000,0.562,600,0.6,162,0.162,26
54513,43149,11364,36851,89,80000,547,1000,0.547,607,0.607,154,0.154,26
55029,43496,11533,37504,90,81000,516,1000,0.516,653,0.653,169,0.169,26
55571,43888,11683,38112,91,82000,542,1000,0.542,608,0.608,150,0.15,26
56113,44278,11835,38722,92,83000,542,1000,0.542,610,0.61,152,0.152,26
56637,44620,12017,39380,93,84000,524,1000,0.524,658,0.658,182,0.182,26
57175,44998,12177,40002,94,85000,538,1000,0.538,622,0.622,160,0.16,26
57699,45324,12375,40676,95,86000,524,1000,0.524,674,0.674,198,0.198,26
58235,45693,12542,41307,96,87000,536,1000,0.536,631,0.631,167,0.167,26
58763,46056,12707,41944,97,88000,528,1000,0.528,637,0.637,165,0.165,26
59281,46405,12876,42595,98,89000,518,1000,0.518,651,0.651,169,0.169,26
59790,46741,13049,43259,99,90000,509,1000,0.509,664,0.664,173,0.173,26
60302,47082,13220,43918,100,91000,512,1000,0.512,659,0.659,171,0.171,26
60810,47421,13389,44579,101,92000,508,1000,0.508,661,0.661,169,0.169,26
61293,47731,13562,45269,102,93000,483,1000,0.483,690,0.69,173,0.173,26
61788,48061,13727,45939,103,94000,495,1000,0.495,670,0.67,165,0.165,26
62261,48348,13913,46652,104,95000,473,1000,0.473,713,0.713,186,0.186,26
62779,48698,14081,47302,105,96000,518,1000,0.518,650,0.65,168,0.168,26
63291,49042,14249,47958,106,97000,512,1000,0.512,656,0.656,168,0.168,26
63802,49367,14435,48633,107,98000,511,1000,0.511,675,0.675,186,0.186,26
64302,49692,14610,49308,108,99000,500,1000,0.5,675,0.675,175,0.175,26
64785,50000,14785,50000,109,100000,483,1000,0.483,692,0.692,175,0.175,26
65284,50322,14962,50678,110,101000,499,1000,0.499,678,0.678,177,0.177,26
65802,50659,15143,51341,111,102000,518,1000,0.518,663,0.663,181,0.181,26
66331,51028,15303,51972,112,103000,529,1000,0.529,631,0.631,160,0.16,26
66829,51360,15469,52640,113,104000,498,1000,0.498,668,0.668,166,0.166,26
67315,51682,15633,53318,114,105000,486,1000,0.486,678,0.678,164,0.164,26
67802,51992,15810,54008,115,106000,487,1000,0.487,690,0.69,177,0.177,26
68287,52282,16005,54718,116,107000,485,1000,0.485,710,0.71,195,0.195,26
68785,52618,16167,55382,117,108000,498,1000,0.498,664,0.664,162,0.162,26
69280,52944,16336,56056,118,109000,495,1000,0.495,674,0.674,169,0.169,26
69780,53266,16514,56734,119,110000,500,1000,0.5,678,0.678,178,0.178,26
70271,53600,16671,57400,120,111000,491,1000,0.491,666,0.666,157,0.157,26
70758,53921,16837,58079,121,112000,487,1000,0.487,679,0.679,166,0.166,26
71272,54270,17002,58730,122,113000,514,1000,0.514,651,0.651,165,0.165,26
71728,54549,17179,59451,123,114000,456,1000,0.456,721,0.721,177,0.177,26
71869,54638,17231,59660,124,114298,141,298,0.47315436241610737,209,0.7013422818791947,52,0.174496644295302,26
99,98,1,2,1,100,NA,NA,NA,NA,NA,NA,NA,27
199,198,1,2,2,200,100,100,1,0,0,0,0,27
299,298,1,2,3,300,100,100,1,0,0,0,0,27
399,398,1,2,4,400,100,100,1,0,0,0,0,27
494,488,6,12,5,500,95,100,0.95,10,0.1,5,0.05,27
593,586,7,14,6,600,99,100,0.99,2,0.02,1,0.01,27
691,682,9,18,7,700,98,100,0.98,4,0.04,2,0.02,27
789,778,11,22,8,800,98,100,0.98,4,0.04,2,0.02,27
885,871,14,29,9,900,96,100,0.96,7,0.07,3,0.03,27
981,963,18,37,10,1000,96,100,0.96,8,0.08,4,0.04,27
1933,1876,57,124,11,2000,952,1000,0.952,87,0.087,39,0.039,27
2859,2752,107,248,12,3000,926,1000,0.926,124,0.124,50,0.05,27
3780,3620,160,380,13,4000,921,1000,0.921,132,0.132,53,0.053,27
4681,4460,221,540,14,5000,901,1000,0.901,160,0.16,61,0.061,27
5573,5278,295,722,15,6000,892,1000,0.892,182,0.182,74,0.074,27
6453,6078,375,922,16,7000,880,1000,0.88,200,0.2,80,0.08,27
7300,6825,475,1175,17,8000,847,1000,0.847,253,0.253,100,0.1,27
8139,7564,575,1436,18,9000,839,1000,0.839,261,0.261,100,0.1,27
8968,8274,694,1726,19,10000,829,1000,0.829,290,0.29,119,0.119,27
9808,9015,793,1985,20,11000,840,1000,0.84,259,0.259,99,0.099,27
10629,9724,905,2276,21,12000,821,1000,0.821,291,0.291,112,0.112,27
11434,10415,1019,2585,22,13000,805,1000,0.805,309,0.309,114,0.114,27
12226,11077,1149,2923,23,14000,792,1000,0.792,338,0.338,130,0.13,27
13025,11757,1268,3243,24,15000,799,1000,0.799,320,0.32,119,0.119,27
13822,12441,1381,3559,25,16000,797,1000,0.797,316,0.316,113,0.113,27
14570,13057,1513,3943,26,17000,748,1000,0.748,384,0.384,132,0.132,27
15330,13706,1624,4294,27,18000,760,1000,0.76,351,0.351,111,0.111,27
16085,14337,1748,4663,28,19000,755,1000,0.755,369,0.369,124,0.124,27
16865,14996,1869,5004,29,20000,780,1000,0.78,341,0.341,121,0.121,27
17620,15608,2012,5392,30,21000,755,1000,0.755,388,0.388,143,0.143,27
18344,16179,2165,5821,31,22000,724,1000,0.724,429,0.429,153,0.153,27
19055,16753,2302,6247,32,23000,711,1000,0.711,426,0.426,137,0.137,27
19778,17339,2439,6661,33,24000,723,1000,0.723,414,0.414,137,0.137,27
20486,17904,2582,7096,34,25000,708,1000,0.708,435,0.435,143,0.143,27
21217,18500,2717,7500,35,26000,731,1000,0.731,404,0.404,135,0.135,27
21921,19059,2862,7941,36,27000,704,1000,0.704,441,0.441,145,0.145,27
22615,19606,3009,8394,37,28000,694,1000,0.694,453,0.453,147,0.147,27
23324,20172,3152,8828,38,29000,709,1000,0.709,434,0.434,143,0.143,27
24023,20732,3291,9268,39,30000,699,1000,0.699,440,0.44,139,0.139,27
24701,21239,3462,9761,40,31000,678,1000,0.678,493,0.493,171,0.171,27
25389,21785,3604,10215,41,32000,688,1000,0.688,454,0.454,142,0.142,27
26084,22320,3764,10680,42,33000,695,1000,0.695,465,0.465,160,0.16,27
26750,22832,3918,11168,43,34000,666,1000,0.666,488,0.488,154,0.154,27
27427,23359,4068,11641,44,35000,677,1000,0.677,473,0.473,150,0.15,27
28108,23905,4203,12095,45,36000,681,1000,0.681,454,0.454,135,0.135,27
28795,24445,4350,12555,46,37000,687,1000,0.687,460,0.46,147,0.147,27
29474,24988,4486,13012,47,38000,679,1000,0.679,457,0.457,136,0.136,27
30116,25470,4646,13530,48,39000,642,1000,0.642,518,0.518,160,0.16,27
30808,26024,4784,13976,49,40000,692,1000,0.692,446,0.446,138,0.138,27
31478,26554,4924,14446,50,41000,670,1000,0.67,470,0.47,140,0.14,27
32118,27025,5093,14975,51,42000,640,1000,0.64,529,0.529,169,0.169,27
32781,27540,5241,15460,52,43000,663,1000,0.663,485,0.485,148,0.148,27
33429,28024,5405,15976,53,44000,648,1000,0.648,516,0.516,164,0.164,27
34078,28525,5553,16475,54,45000,649,1000,0.649,499,0.499,148,0.148,27
34729,29031,5698,16969,55,46000,651,1000,0.651,494,0.494,145,0.145,27
35356,29487,5869,17513,56,47000,627,1000,0.627,544,0.544,171,0.171,27
35983,29944,6039,18056,57,48000,627,1000,0.627,543,0.543,170,0.17,27
36603,30411,6192,18589,58,49000,620,1000,0.62,533,0.533,153,0.153,27
37236,30901,6335,19099,59,50000,633,1000,0.633,510,0.51,143,0.143,27
37850,31349,6501,19651,60,51000,614,1000,0.614,552,0.552,166,0.166,27
38446,31783,6663,20217,61,52000,596,1000,0.596,566,0.566,162,0.162,27
39064,32236,6828,20764,62,53000,618,1000,0.618,547,0.547,165,0.165,27
39663,32668,6995,21332,63,54000,599,1000,0.599,568,0.568,167,0.167,27
40267,33117,7150,21883,64,55000,604,1000,0.604,551,0.551,155,0.155,27
40880,33588,7292,22412,65,56000,613,1000,0.613,529,0.529,142,0.142,27
41477,33998,7479,23002,66,57000,597,1000,0.597,590,0.59,187,0.187,27
42085,34442,7643,23558,67,58000,608,1000,0.608,556,0.556,164,0.164,27
42667,34835,7832,24165,68,59000,582,1000,0.582,607,0.607,189,0.189,27
43270,35275,7995,24725,69,60000,603,1000,0.603,560,0.56,163,0.163,27
43815,35638,8177,25362,70,61000,545,1000,0.545,637,0.637,182,0.182,27
44385,36028,8357,25972,71,62000,570,1000,0.57,610,0.61,180,0.18,27
44960,36434,8526,26566,72,63000,575,1000,0.575,594,0.594,169,0.169,27
45544,36868,8676,27132,73,64000,584,1000,0.584,566,0.566,150,0.15,27
46128,37278,8850,27722,74,65000,584,1000,0.584,590,0.59,174,0.174,27
46699,37702,8997,28298,75,66000,571,1000,0.571,576,0.576,147,0.147,27
47269,38113,9156,28887,76,67000,570,1000,0.57,589,0.589,159,0.159,27
47842,38526,9316,29474,77,68000,573,1000,0.573,587,0.587,160,0.16,27
48401,38943,9458,30057,78,69000,559,1000,0.559,583,0.583,142,0.142,27
48947,39314,9633,30686,79,70000,546,1000,0.546,629,0.629,175,0.175,27
49482,39687,9795,31313,80,71000,535,1000,0.535,627,0.627,162,0.162,27
50064,40107,9957,31893,81,72000,582,1000,0.582,580,0.58,162,0.162,27
50610,40487,10123,32513,82,73000,546,1000,0.546,620,0.62,166,0.166,27
51186,40906,10280,33094,83,74000,576,1000,0.576,581,0.581,157,0.157,27
51753,41299,10454,33701,84,75000,567,1000,0.567,607,0.607,174,0.174,27
52313,41696,10617,34304,85,76000,560,1000,0.56,603,0.603,163,0.163,27
52847,42041,10806,34959,86,77000,534,1000,0.534,655,0.655,189,0.189,27
53383,42411,10972,35589,87,78000,536,1000,0.536,630,0.63,166,0.166,27
53935,42793,11142,36207,88,79000,552,1000,0.552,618,0.618,170,0.17,27
54467,43146,11321,36854,89,80000,532,1000,0.532,647,0.647,179,0.179,27
55009,43523,11486,37477,90,81000,542,1000,0.542,623,0.623,165,0.165,27
55530,43878,11652,38122,91,82000,521,1000,0.521,645,0.645,166,0.166,27
56066,44246,11820,38754,92,83000,536,1000,0.536,632,0.632,168,0.168,27
56592,44586,12006,39414,93,84000,526,1000,0.526,660,0.66,186,0.186,27
57133,44970,12163,40030,94,85000,541,1000,0.541,616,0.616,157,0.157,27
57682,45349,12333,40651,95,86000,549,1000,0.549,621,0.621,170,0.17,27
58188,45662,12526,41338,96,87000,506,1000,0.506,687,0.687,193,0.193,27
58726,46012,12714,41988,97,88000,538,1000,0.538,650,0.65,188,0.188,27
59251,46370,12881,42630,98,89000,525,1000,0.525,642,0.642,167,0.167,27
59745,46701,13044,43299,99,90000,494,1000,0.494,669,0.669,163,0.163,27
60297,47101,13196,43899,100,91000,552,1000,0.552,600,0.6,152,0.152,27
60810,47474,13336,44526,101,92000,513,1000,0.513,627,0.627,140,0.14,27
61340,47815,13525,45185,102,93000,530,1000,0.53,659,0.659,189,0.189,27
61850,48156,13694,45844,103,94000,510,1000,0.51,659,0.659,169,0.169,27
62353,48496,13857,46504,104,95000,503,1000,0.503,660,0.66,163,0.163,27
62876,48840,14036,47160,105,96000,523,1000,0.523,656,0.656,179,0.179,27
63386,49195,14191,47805,106,97000,510,1000,0.51,645,0.645,155,0.155,27
63906,49535,14371,48465,107,98000,520,1000,0.52,660,0.66,180,0.18,27
64398,49854,14544,49146,108,99000,492,1000,0.492,681,0.681,173,0.173,27
64891,50165,14726,49835,109,100000,493,1000,0.493,689,0.689,182,0.182,27
65355,50438,14917,50562,110,101000,464,1000,0.464,727,0.727,191,0.191,27
65859,50768,15091,51232,111,102000,504,1000,0.504,670,0.67,174,0.174,27
66323,51043,15280,51957,112,103000,464,1000,0.464,725,0.725,189,0.189,27
66823,51373,15450,52627,113,104000,500,1000,0.5,670,0.67,170,0.17,27
67329,51718,15611,53282,114,105000,506,1000,0.506,655,0.655,161,0.161,27
67830,52045,15785,53955,115,106000,501,1000,0.501,673,0.673,174,0.174,27
68307,52352,15955,54648,116,107000,477,1000,0.477,693,0.693,170,0.17,27
68811,52674,16137,55326,117,108000,504,1000,0.504,678,0.678,182,0.182,27
69316,53000,16316,56000,118,109000,505,1000,0.505,674,0.674,179,0.179,27
69807,53324,16483,56676,119,110000,491,1000,0.491,676,0.676,167,0.167,27
70301,53634,16667,57366,120,111000,494,1000,0.494,690,0.69,184,0.184,27
70799,53960,16839,58040,121,112000,498,1000,0.498,674,0.674,172,0.172,27
71263,54250,17013,58750,122,113000,464,1000,0.464,710,0.71,174,0.174,27
71732,54548,17184,59452,123,114000,469,1000,0.469,702,0.702,171,0.171,27
71869,54638,17231,59660,124,114298,137,298,0.4597315436241611,208,0.697986577181208,47,0.15771812080536912,27
100,100,0,0,1,100,NA,NA,NA,NA,NA,NA,NA,28
200,200,0,0,2,200,100,100,1,0,0,0,0,28
300,300,0,0,3,300,100,100,1,0,0,0,0,28
398,396,2,4,4,400,98,100,0.98,4,0.04,2,0.02,28
495,490,5,10,5,500,97,100,0.97,6,0.06,3,0.03,28
593,586,7,14,6,600,98,100,0.98,4,0.04,2,0.02,28
690,681,9,19,7,700,97,100,0.97,5,0.05,2,0.02,28
790,781,9,19,8,800,100,100,1,0,0,0,0,28
885,871,14,29,9,900,95,100,0.95,10,0.1,5,0.05,28
980,962,18,38,10,1000,95,100,0.95,9,0.09,4,0.04,28
1944,1899,45,101,11,2000,964,1000,0.964,63,0.063,27,0.027,28
2874,2781,93,219,12,3000,930,1000,0.93,118,0.118,48,0.048,28
3791,3639,152,361,13,4000,917,1000,0.917,142,0.142,59,0.059,28
4697,4484,213,516,14,5000,906,1000,0.906,155,0.155,61,0.061,28
5592,5305,287,695,15,6000,895,1000,0.895,179,0.179,74,0.074,28
6452,6074,378,926,16,7000,860,1000,0.86,231,0.231,91,0.091,28
7316,6851,465,1149,17,8000,864,1000,0.864,223,0.223,87,0.087,28
8136,7559,577,1441,18,9000,820,1000,0.82,292,0.292,112,0.112,28
8973,8301,672,1699,19,10000,837,1000,0.837,258,0.258,95,0.095,28
9779,8987,792,2013,20,11000,806,1000,0.806,314,0.314,120,0.12,28
10602,9710,892,2290,21,12000,823,1000,0.823,277,0.277,100,0.1,28
11407,10405,1002,2595,22,13000,805,1000,0.805,305,0.305,110,0.11,28
12218,11117,1101,2883,23,14000,811,1000,0.811,288,0.288,99,0.099,28
12989,11747,1242,3253,24,15000,771,1000,0.771,370,0.37,141,0.141,28
13785,12434,1351,3566,25,16000,796,1000,0.796,313,0.313,109,0.109,28
14558,13079,1479,3921,26,17000,773,1000,0.773,355,0.355,128,0.128,28
15359,13771,1588,4229,27,18000,801,1000,0.801,308,0.308,109,0.109,28
16125,14412,1713,4588,28,19000,766,1000,0.766,359,0.359,125,0.125,28
16896,15060,1836,4940,29,20000,771,1000,0.771,352,0.352,123,0.123,28
17669,15718,1951,5282,30,21000,773,1000,0.773,342,0.342,115,0.115,28
18404,16311,2093,5689,31,22000,735,1000,0.735,407,0.407,142,0.142,28
19136,16907,2229,6093,32,23000,732,1000,0.732,404,0.404,136,0.136,28
19898,17546,2352,6454,33,24000,762,1000,0.762,361,0.361,123,0.123,28
20614,18105,2509,6895,34,25000,716,1000,0.716,441,0.441,157,0.157,28
21328,18671,2657,7329,35,26000,714,1000,0.714,434,0.434,148,0.148,28
22055,19261,2794,7739,36,27000,727,1000,0.727,410,0.41,137,0.137,28
22756,19807,2949,8193,37,28000,701,1000,0.701,454,0.454,155,0.155,28
23490,20416,3074,8584,38,29000,734,1000,0.734,391,0.391,125,0.125,28
24164,20938,3226,9062,39,30000,674,1000,0.674,478,0.478,152,0.152,28
24852,21479,3373,9521,40,31000,688,1000,0.688,459,0.459,147,0.147,28
25553,22035,3518,9965,41,32000,701,1000,0.701,444,0.444,145,0.145,28
26215,22524,3691,10476,42,33000,662,1000,0.662,511,0.511,173,0.173,28
26925,23099,3826,10901,43,34000,710,1000,0.71,425,0.425,135,0.135,28
27607,23637,3970,11363,44,35000,682,1000,0.682,462,0.462,144,0.144,28
28303,24188,4115,11812,45,36000,696,1000,0.696,449,0.449,145,0.145,28
28962,24681,4281,12319,46,37000,659,1000,0.659,507,0.507,166,0.166,28
29634,25193,4441,12807,47,38000,672,1000,0.672,488,0.488,160,0.16,28
30308,25725,4583,13275,48,39000,674,1000,0.674,468,0.468,142,0.142,28
30952,26204,4748,13796,49,40000,644,1000,0.644,521,0.521,165,0.165,28
31612,26719,4893,14281,50,41000,660,1000,0.66,485,0.485,145,0.145,28
32269,27222,5047,14778,51,42000,657,1000,0.657,497,0.497,154,0.154,28
32927,27730,5197,15270,52,43000,658,1000,0.658,492,0.492,150,0.15,28
33567,28219,5348,15781,53,44000,640,1000,0.64,511,0.511,151,0.151,28
34184,28681,5503,16319,54,45000,617,1000,0.617,538,0.538,155,0.155,28
34818,29155,5663,16845,55,46000,634,1000,0.634,526,0.526,160,0.16,28
35435,29610,5825,17390,56,47000,617,1000,0.617,545,0.545,162,0.162,28
36040,30054,5986,17946,57,48000,605,1000,0.605,556,0.556,161,0.161,28
36637,30484,6153,18516,58,49000,597,1000,0.597,570,0.57,167,0.167,28
37269,30961,6308,19039,59,50000,632,1000,0.632,523,0.523,155,0.155,28
37894,31439,6455,19561,60,51000,625,1000,0.625,522,0.522,147,0.147,28
38517,31901,6616,20099,61,52000,623,1000,0.623,538,0.538,161,0.161,28
39129,32336,6793,20664,62,53000,612,1000,0.612,565,0.565,177,0.177,28
39737,32785,6952,21215,63,54000,608,1000,0.608,551,0.551,159,0.159,28
40377,33264,7113,21736,64,55000,640,1000,0.64,521,0.521,161,0.161,28
41001,33736,7265,22264,65,56000,624,1000,0.624,528,0.528,152,0.152,28
41586,34139,7447,22861,66,57000,585,1000,0.585,597,0.597,182,0.182,28
42186,34579,7607,23421,67,58000,600,1000,0.6,560,0.56,160,0.16,28
42757,34973,7784,24027,68,59000,571,1000,0.571,606,0.606,177,0.177,28
43336,35385,7951,24615,69,60000,579,1000,0.579,588,0.588,167,0.167,28
43935,35816,8119,25184,70,61000,599,1000,0.599,569,0.569,168,0.168,28
44531,36258,8273,25742,71,62000,596,1000,0.596,558,0.558,154,0.154,28
45112,36676,8436,26324,72,63000,581,1000,0.581,582,0.582,163,0.163,28
45700,37098,8602,26902,73,64000,588,1000,0.588,578,0.578,166,0.166,28
46291,37526,8765,27474,74,65000,591,1000,0.591,572,0.572,163,0.163,28
46850,37906,8944,28094,75,66000,559,1000,0.559,620,0.62,179,0.179,28
47420,38311,9109,28689,76,67000,570,1000,0.57,595,0.595,165,0.165,28
48008,38731,9277,29269,77,68000,588,1000,0.588,580,0.58,168,0.168,28
48568,39131,9437,29869,78,69000,560,1000,0.56,600,0.6,160,0.16,28
49134,39550,9584,30450,79,70000,566,1000,0.566,581,0.581,147,0.147,28
49695,39944,9751,31056,80,71000,561,1000,0.561,606,0.606,167,0.167,28
50247,40331,9916,31669,81,72000,552,1000,0.552,613,0.613,165,0.165,28
50809,40720,10089,32280,82,73000,562,1000,0.562,611,0.611,173,0.173,28
51360,41090,10270,32910,83,74000,551,1000,0.551,630,0.63,181,0.181,28
51901,41453,10448,33547,84,75000,541,1000,0.541,637,0.637,178,0.178,28
52427,41803,10624,34197,85,76000,526,1000,0.526,650,0.65,176,0.176,28
52989,42163,10826,34837,86,77000,562,1000,0.562,640,0.64,202,0.202,28
53538,42539,10999,35461,87,78000,549,1000,0.549,624,0.624,173,0.173,28
54091,42917,11174,36083,88,79000,553,1000,0.553,622,0.622,175,0.175,28
54628,43297,11331,36703,89,80000,537,1000,0.537,620,0.62,157,0.157,28
55157,43619,11538,37381,90,81000,529,1000,0.529,678,0.678,207,0.207,28
55673,43967,11706,38033,91,82000,516,1000,0.516,652,0.652,168,0.168,28
56177,44305,11872,38695,92,83000,504,1000,0.504,662,0.662,166,0.166,28
56697,44650,12047,39350,93,84000,520,1000,0.52,655,0.655,175,0.175,28
57234,45030,12204,39970,94,85000,537,1000,0.537,620,0.62,157,0.157,28
57761,45387,12374,40613,95,86000,527,1000,0.527,643,0.643,170,0.17,28
58267,45723,12544,41277,96,87000,506,1000,0.506,664,0.664,170,0.17,28
58769,46041,12728,41959,97,88000,502,1000,0.502,682,0.682,184,0.184,28
59293,46394,12899,42606,98,89000,524,1000,0.524,647,0.647,171,0.171,28
59807,46736,13071,43264,99,90000,514,1000,0.514,658,0.658,172,0.172,28
60296,47045,13251,43955,100,91000,489,1000,0.489,691,0.691,180,0.18,28
60789,47352,13437,44648,101,92000,493,1000,0.493,693,0.693,186,0.186,28
61315,47711,13604,45289,102,93000,526,1000,0.526,641,0.641,167,0.167,28
61831,48051,13780,45949,103,94000,516,1000,0.516,660,0.66,176,0.176,28
62360,48422,13938,46578,104,95000,529,1000,0.529,629,0.629,158,0.158,28
62859,48747,14112,47253,105,96000,499,1000,0.499,675,0.675,174,0.174,28
63366,49093,14273,47907,106,97000,507,1000,0.507,654,0.654,161,0.161,28
63888,49449,14439,48551,107,98000,522,1000,0.522,644,0.644,166,0.166,28
64391,49783,14608,49217,108,99000,503,1000,0.503,666,0.666,169,0.169,28
64882,50095,14787,49905,109,100000,491,1000,0.491,688,0.688,179,0.179,28
65342,50377,14965,50623,110,101000,460,1000,0.46,718,0.718,178,0.178,28
65827,50668,15159,51332,111,102000,485,1000,0.485,709,0.709,194,0.194,28
66320,50972,15348,52028,112,103000,493,1000,0.493,696,0.696,189,0.189,28
66812,51301,15511,52699,113,104000,492,1000,0.492,671,0.671,163,0.163,28
67304,51616,15688,53384,114,105000,492,1000,0.492,685,0.685,177,0.177,28
67802,51962,15840,54038,115,106000,498,1000,0.498,654,0.654,152,0.152,28
68287,52269,16018,54731,116,107000,485,1000,0.485,693,0.693,178,0.178,28
68775,52596,16179,55404,117,108000,488,1000,0.488,673,0.673,161,0.161,28
69274,52937,16337,56063,118,109000,499,1000,0.499,659,0.659,158,0.158,28
69784,53287,16497,56713,119,110000,510,1000,0.51,650,0.65,160,0.16,28
70281,53600,16681,57400,120,111000,497,1000,0.497,687,0.687,184,0.184,28
70761,53915,16846,58085,121,112000,480,1000,0.48,685,0.685,165,0.165,28
71229,54207,17022,58793,122,113000,468,1000,0.468,708,0.708,176,0.176,28
71719,54533,17186,59467,123,114000,490,1000,0.49,674,0.674,164,0.164,28
71869,54638,17231,59660,124,114298,150,298,0.5033557046979866,193,0.6476510067114094,45,0.15100671140939598,28
99,98,1,2,1,100,NA,NA,NA,NA,NA,NA,NA,29
198,196,2,4,2,200,99,100,0.99,2,0.02,1,0.01,29
297,294,3,6,3,300,99,100,0.99,2,0.02,1,0.01,29
396,392,4,8,4,400,99,100,0.99,2,0.02,1,0.01,29
496,492,4,8,5,500,100,100,1,0,0,0,0,29
593,587,6,13,6,600,97,100,0.97,5,0.05,2,0.02,29
689,679,10,21,7,700,96,100,0.96,8,0.08,4,0.04,29
786,773,13,27,8,800,97,100,0.97,6,0.06,3,0.03,29
884,870,14,30,9,900,98,100,0.98,3,0.03,1,0.01,29
979,962,17,38,10,1000,95,100,0.95,8,0.08,3,0.03,29
1927,1874,53,126,11,2000,948,1000,0.948,88,0.088,36,0.036,29
2856,2756,100,244,12,3000,929,1000,0.929,118,0.118,47,0.047,29
3778,3625,153,375,13,4000,922,1000,0.922,131,0.131,53,0.053,29
4664,4443,221,557,14,5000,886,1000,0.886,182,0.182,68,0.068,29
5549,5242,307,758,15,6000,885,1000,0.885,201,0.201,86,0.086,29
6412,6022,390,978,16,7000,863,1000,0.863,220,0.22,83,0.083,29
7260,6773,487,1227,17,8000,848,1000,0.848,249,0.249,97,0.097,29
8114,7540,574,1460,18,9000,854,1000,0.854,233,0.233,87,0.087,29
8957,8279,678,1721,19,10000,843,1000,0.843,261,0.261,104,0.104,29
9785,9003,782,1997,20,11000,828,1000,0.828,276,0.276,104,0.104,29
10621,9741,880,2259,21,12000,836,1000,0.836,262,0.262,98,0.098,29
11441,10448,993,2552,22,13000,820,1000,0.82,293,0.293,113,0.113,29
12232,11121,1111,2879,23,14000,791,1000,0.791,327,0.327,118,0.118,29
13012,11777,1235,3223,24,15000,780,1000,0.78,344,0.344,124,0.124,29
13790,12437,1353,3563,25,16000,778,1000,0.778,340,0.34,118,0.118,29
14582,13122,1460,3878,26,17000,792,1000,0.792,315,0.315,107,0.107,29
15355,13777,1578,4223,27,18000,773,1000,0.773,345,0.345,118,0.118,29
16116,14402,1714,4598,28,19000,761,1000,0.761,375,0.375,136,0.136,29
16877,15035,1842,4965,29,20000,761,1000,0.761,367,0.367,128,0.128,29
17628,15659,1969,5341,30,21000,751,1000,0.751,376,0.376,127,0.127,29
18362,16242,2120,5758,31,22000,734,1000,0.734,417,0.417,151,0.151,29
19106,16845,2261,6155,32,23000,744,1000,0.744,397,0.397,141,0.141,29
19824,17414,2410,6586,33,24000,718,1000,0.718,431,0.431,149,0.149,29
20543,17997,2546,7003,34,25000,719,1000,0.719,417,0.417,136,0.136,29
21277,18599,2678,7401,35,26000,734,1000,0.734,398,0.398,132,0.132,29
22001,19174,2827,7826,36,27000,724,1000,0.724,425,0.425,149,0.149,29
22707,19733,2974,8267,37,28000,706,1000,0.706,441,0.441,147,0.147,29
23398,20276,3122,8724,38,29000,691,1000,0.691,457,0.457,148,0.148,29
24097,20824,3273,9176,39,30000,699,1000,0.699,452,0.452,151,0.151,29
24789,21356,3433,9644,40,31000,692,1000,0.692,468,0.468,160,0.16,29
25480,21900,3580,10100,41,32000,691,1000,0.691,456,0.456,147,0.147,29
26167,22445,3722,10555,42,33000,687,1000,0.687,455,0.455,142,0.142,29
26847,22965,3882,11035,43,34000,680,1000,0.68,480,0.48,160,0.16,29
27520,23492,4028,11508,44,35000,673,1000,0.673,473,0.473,146,0.146,29
28188,23994,4194,12006,45,36000,668,1000,0.668,498,0.498,166,0.166,29
28861,24519,4342,12481,46,37000,673,1000,0.673,475,0.475,148,0.148,29
29517,25000,4517,13000,47,38000,656,1000,0.656,519,0.519,175,0.175,29
30163,25489,4674,13511,48,39000,646,1000,0.646,511,0.511,157,0.157,29
30824,26007,4817,13993,49,40000,661,1000,0.661,482,0.482,143,0.143,29
31500,26550,4950,14450,50,41000,676,1000,0.676,457,0.457,133,0.133,29
32143,27038,5105,14962,51,42000,643,1000,0.643,512,0.512,155,0.155,29
32795,27534,5261,15466,52,43000,652,1000,0.652,504,0.504,156,0.156,29
33426,28004,5422,15996,53,44000,631,1000,0.631,530,0.53,161,0.161,29
34079,28505,5574,16495,54,45000,653,1000,0.653,499,0.499,152,0.152,29
34677,28942,5735,17058,55,46000,598,1000,0.598,563,0.563,161,0.161,29
35312,29423,5889,17577,56,47000,635,1000,0.635,519,0.519,154,0.154,29
35948,29906,6042,18094,57,48000,636,1000,0.636,517,0.517,153,0.153,29
36533,30302,6231,18698,58,49000,585,1000,0.585,604,0.604,189,0.189,29
37153,30741,6412,19259,59,50000,620,1000,0.62,561,0.561,181,0.181,29
37755,31184,6571,19816,60,51000,602,1000,0.602,557,0.557,159,0.159,29
38357,31636,6721,20364,61,52000,602,1000,0.602,548,0.548,150,0.15,29
38979,32102,6877,20898,62,53000,622,1000,0.622,534,0.534,156,0.156,29
39600,32557,7043,21443,63,54000,621,1000,0.621,545,0.545,166,0.166,29
40197,32990,7207,22010,64,55000,597,1000,0.597,567,0.567,164,0.164,29
40817,33466,7351,22534,65,56000,620,1000,0.62,524,0.524,144,0.144,29
41421,33904,7517,23096,66,57000,604,1000,0.604,562,0.562,166,0.166,29
41989,34299,7690,23701,67,58000,568,1000,0.568,605,0.605,173,0.173,29
42596,34757,7839,24243,68,59000,607,1000,0.607,542,0.542,149,0.149,29
43161,35164,7997,24836,69,60000,565,1000,0.565,593,0.593,158,0.158,29
43758,35601,8157,25399,70,61000,597,1000,0.597,563,0.563,160,0.16,29
44320,35992,8328,26008,71,62000,562,1000,0.562,609,0.609,171,0.171,29
44938,36464,8474,26536,72,63000,618,1000,0.618,528,0.528,146,0.146,29
45519,36889,8630,27111,73,64000,581,1000,0.581,575,0.575,156,0.156,29
46086,37275,8811,27725,74,65000,567,1000,0.567,614,0.614,181,0.181,29
46668,37690,8978,28310,75,66000,582,1000,0.582,585,0.585,167,0.167,29
47245,38111,9134,28889,76,67000,577,1000,0.577,579,0.579,156,0.156,29
47825,38520,9305,29480,77,68000,580,1000,0.58,591,0.591,171,0.171,29
48392,38917,9475,30083,78,69000,567,1000,0.567,603,0.603,170,0.17,29
48964,39332,9632,30668,79,70000,572,1000,0.572,585,0.585,157,0.157,29
49537,39730,9807,31270,80,71000,573,1000,0.573,602,0.602,175,0.175,29
50100,40119,9981,31881,81,72000,563,1000,0.563,611,0.611,174,0.174,29
50678,40556,10122,32444,82,73000,578,1000,0.578,563,0.563,141,0.141,29
51201,40877,10324,33123,83,74000,523,1000,0.523,679,0.679,202,0.202,29
51751,41248,10503,33752,84,75000,550,1000,0.55,629,0.629,179,0.179,29
52318,41659,10659,34341,85,76000,567,1000,0.567,589,0.589,156,0.156,29
52845,42017,10828,34983,86,77000,527,1000,0.527,642,0.642,169,0.169,29
53387,42377,11010,35623,87,78000,542,1000,0.542,640,0.64,182,0.182,29
53960,42764,11196,36236,88,79000,573,1000,0.573,613,0.613,186,0.186,29
54492,43122,11370,36878,89,80000,532,1000,0.532,642,0.642,174,0.174,29
55027,43500,11527,37500,90,81000,535,1000,0.535,622,0.622,157,0.157,29
55576,43896,11680,38104,91,82000,549,1000,0.549,604,0.604,153,0.153,29
56121,44281,11840,38719,92,83000,545,1000,0.545,615,0.615,160,0.16,29
56666,44647,12019,39353,93,84000,545,1000,0.545,634,0.634,179,0.179,29
57218,45048,12170,39952,94,85000,552,1000,0.552,599,0.599,151,0.151,29
57756,45432,12324,40568,95,86000,538,1000,0.538,616,0.616,154,0.154,29
58286,45810,12476,41190,96,87000,530,1000,0.53,622,0.622,152,0.152,29
58789,46117,12672,41883,97,88000,503,1000,0.503,693,0.693,196,0.196,29
59310,46473,12837,42527,98,89000,521,1000,0.521,644,0.644,165,0.165,29
59831,46839,12992,43161,99,90000,521,1000,0.521,634,0.634,155,0.155,29
60328,47151,13177,43849,100,91000,497,1000,0.497,688,0.688,185,0.185,29
60846,47506,13340,44494,101,92000,518,1000,0.518,645,0.645,163,0.163,29
61369,47870,13499,45130,102,93000,523,1000,0.523,636,0.636,159,0.159,29
61873,48191,13682,45809,103,94000,504,1000,0.504,679,0.679,183,0.183,29
62404,48554,13850,46446,104,95000,531,1000,0.531,637,0.637,168,0.168,29
62912,48888,14024,47112,105,96000,508,1000,0.508,666,0.666,174,0.174,29
63422,49219,14203,47781,106,97000,510,1000,0.51,669,0.669,179,0.179,29
63911,49536,14375,48464,107,98000,489,1000,0.489,683,0.683,172,0.172,29
64436,49887,14549,49113,108,99000,525,1000,0.525,649,0.649,174,0.174,29
64946,50220,14726,49780,109,100000,510,1000,0.51,667,0.667,177,0.177,29
65428,50512,14916,50488,110,101000,482,1000,0.482,708,0.708,190,0.19,29
65941,50842,15099,51158,111,102000,513,1000,0.513,670,0.67,183,0.183,29
66427,51159,15268,51841,112,103000,486,1000,0.486,683,0.683,169,0.169,29
66921,51483,15438,52517,113,104000,494,1000,0.494,676,0.676,170,0.17,29
67419,51797,15622,53203,114,105000,498,1000,0.498,686,0.686,184,0.184,29
67917,52125,15792,53875,115,106000,498,1000,0.498,672,0.672,170,0.17,29
68404,52442,15962,54558,116,107000,487,1000,0.487,683,0.683,170,0.17,29
68871,52726,16145,55274,117,108000,467,1000,0.467,716,0.716,183,0.183,29
69351,53046,16305,55954,118,109000,480,1000,0.48,680,0.68,160,0.16,29
69842,53375,16467,56625,119,110000,491,1000,0.491,671,0.671,162,0.162,29
70320,53679,16641,57321,120,111000,478,1000,0.478,696,0.696,174,0.174,29
70804,53980,16824,58020,121,112000,484,1000,0.484,699,0.699,183,0.183,29
71272,54267,17005,58733,122,113000,468,1000,0.468,713,0.713,181,0.181,29
71719,54533,17186,59467,123,114000,447,1000,0.447,734,0.734,181,0.181,29
71869,54638,17231,59660,124,114298,150,298,0.5033557046979866,193,0.6476510067114094,45,0.15100671140939598,29
100,100,0,0,1,100,NA,NA,NA,NA,NA,NA,NA,30
198,196,2,4,2,200,98,100,0.98,4,0.04,2,0.02,30
296,292,4,8,3,300,98,100,0.98,4,0.04,2,0.02,30
394,388,6,12,4,400,98,100,0.98,4,0.04,2,0.02,30
492,484,8,16,5,500,98,100,0.98,4,0.04,2,0.02,30
588,576,12,24,6,600,96,100,0.96,8,0.08,4,0.04,30
686,673,13,27,7,700,98,100,0.98,3,0.03,1,0.01,30
783,768,15,32,8,800,97,100,0.97,5,0.05,2,0.02,30
880,865,15,35,9,900,97,100,0.97,3,0.03,0,0,30
979,963,16,37,10,1000,99,100,0.99,2,0.02,1,0.01,30
1931,1870,61,130,11,2000,952,1000,0.952,93,0.093,45,0.045,30
2874,2771,103,229,12,3000,943,1000,0.943,99,0.099,42,0.042,30
3792,3638,154,362,13,4000,918,1000,0.918,133,0.133,51,0.051,30
4699,4485,214,515,14,5000,907,1000,0.907,153,0.153,60,0.06,30
5573,5271,302,729,15,6000,874,1000,0.874,214,0.214,88,0.088,30
6445,6058,387,942,16,7000,872,1000,0.872,213,0.213,85,0.085,30
7268,6764,504,1236,17,8000,823,1000,0.823,294,0.294,117,0.117,30
8113,7514,599,1486,18,9000,845,1000,0.845,250,0.25,95,0.095,30
8956,8266,690,1734,19,10000,843,1000,0.843,248,0.248,91,0.091,30
9804,9030,774,1970,20,11000,848,1000,0.848,236,0.236,84,0.084,30
10627,9745,882,2255,21,12000,823,1000,0.823,285,0.285,108,0.108,30
11429,10438,991,2562,22,13000,802,1000,0.802,307,0.307,109,0.109,30
12259,11168,1091,2832,23,14000,830,1000,0.83,270,0.27,100,0.1,30
13025,11787,1238,3213,24,15000,766,1000,0.766,381,0.381,147,0.147,30
13830,12495,1335,3505,25,16000,805,1000,0.805,292,0.292,97,0.097,30
14618,13156,1462,3844,26,17000,788,1000,0.788,339,0.339,127,0.127,30
15406,13834,1572,4166,27,18000,788,1000,0.788,322,0.322,110,0.11,30
16160,14452,1708,4548,28,19000,754,1000,0.754,382,0.382,136,0.136,30
16918,15074,1844,4926,29,20000,758,1000,0.758,378,0.378,136,0.136,30
17659,15679,1980,5321,30,21000,741,1000,0.741,395,0.395,136,0.136,30
18418,16315,2103,5685,31,22000,759,1000,0.759,364,0.364,123,0.123,30
19159,16921,2238,6079,32,23000,741,1000,0.741,394,0.394,135,0.135,30
19924,17572,2352,6428,33,24000,765,1000,0.765,349,0.349,114,0.114,30
20639,18141,2498,6859,34,25000,715,1000,0.715,431,0.431,146,0.146,30
21352,18705,2647,7295,35,26000,713,1000,0.713,436,0.436,149,0.149,30
22080,19308,2772,7692,36,27000,728,1000,0.728,397,0.397,125,0.125,30
22802,19896,2906,8104,37,28000,722,1000,0.722,412,0.412,134,0.134,30
23500,20458,3042,8542,38,29000,698,1000,0.698,438,0.438,136,0.136,30
24209,21028,3181,8972,39,30000,709,1000,0.709,430,0.43,139,0.139,30
24938,21626,3312,9374,40,31000,729,1000,0.729,402,0.402,131,0.131,30
25632,22172,3460,9828,41,32000,694,1000,0.694,454,0.454,148,0.148,30
26343,22756,3587,10244,42,33000,711,1000,0.711,416,0.416,127,0.127,30
27008,23260,3748,10740,43,34000,665,1000,0.665,496,0.496,161,0.161,30
27683,23782,3901,11218,44,35000,675,1000,0.675,478,0.478,153,0.153,30
28349,24282,4067,11718,45,36000,666,1000,0.666,500,0.5,166,0.166,30
28999,24751,4248,12249,46,37000,650,1000,0.65,531,0.531,181,0.181,30
29683,25290,4393,12710,47,38000,684,1000,0.684,461,0.461,145,0.145,30
30353,25816,4537,13184,48,39000,670,1000,0.67,474,0.474,144,0.144,30
31022,26335,4687,13665,49,40000,669,1000,0.669,481,0.481,150,0.15,30
31673,26833,4840,14167,50,41000,651,1000,0.651,502,0.502,153,0.153,30
32329,27336,4993,14664,51,42000,656,1000,0.656,497,0.497,153,0.153,30
32977,27836,5141,15164,52,43000,648,1000,0.648,500,0.5,148,0.148,30
33610,28303,5307,15697,53,44000,633,1000,0.633,533,0.533,166,0.166,30
34272,28818,5454,16182,54,45000,662,1000,0.662,485,0.485,147,0.147,30
34886,29264,5622,16736,55,46000,614,1000,0.614,554,0.554,168,0.168,30
35517,29740,5777,17260,56,47000,631,1000,0.631,524,0.524,155,0.155,30
36155,30239,5916,17761,57,48000,638,1000,0.638,501,0.501,139,0.139,30
36757,30662,6095,18338,58,49000,602,1000,0.602,577,0.577,179,0.179,30
37342,31072,6270,18928,59,50000,585,1000,0.585,590,0.59,175,0.175,30
37940,31505,6435,19495,60,51000,598,1000,0.598,567,0.567,165,0.165,30
38562,31976,6586,20024,61,52000,622,1000,0.622,529,0.529,151,0.151,30
39173,32420,6753,20580,62,53000,611,1000,0.611,556,0.556,167,0.167,30
39770,32851,6919,21149,63,54000,597,1000,0.597,569,0.569,166,0.166,30
40351,33257,7094,21743,64,55000,581,1000,0.581,594,0.594,175,0.175,30
40972,33710,7262,22290,65,56000,621,1000,0.621,547,0.547,168,0.168,30
41555,34128,7427,22872,66,57000,583,1000,0.583,582,0.582,165,0.165,30
42142,34562,7580,23438,67,58000,587,1000,0.587,566,0.566,153,0.153,30
42725,34962,7763,24038,68,59000,583,1000,0.583,600,0.6,183,0.183,30
43336,35412,7924,24588,69,60000,611,1000,0.611,550,0.55,161,0.161,30
43934,35841,8093,25159,70,61000,598,1000,0.598,571,0.571,169,0.169,30
44516,36244,8272,25756,71,62000,582,1000,0.582,597,0.597,179,0.179,30
45122,36678,8444,26322,72,63000,606,1000,0.606,566,0.566,172,0.172,30
45717,37122,8595,26878,73,64000,595,1000,0.595,556,0.556,151,0.151,30
46298,37532,8766,27468,74,65000,581,1000,0.581,590,0.59,171,0.171,30
46861,37927,8934,28073,75,66000,563,1000,0.563,605,0.605,168,0.168,30
47434,38339,9095,28661,76,67000,573,1000,0.573,588,0.588,161,0.161,30
48018,38759,9259,29241,77,68000,584,1000,0.584,580,0.58,164,0.164,30
48603,39178,9425,29822,78,69000,585,1000,0.585,581,0.581,166,0.166,30
49163,39567,9596,30433,79,70000,560,1000,0.56,611,0.611,171,0.171,30
49744,39991,9753,31009,80,71000,581,1000,0.581,576,0.576,157,0.157,30
50298,40371,9927,31629,81,72000,554,1000,0.554,620,0.62,174,0.174,30
50850,40747,10103,32253,82,73000,552,1000,0.552,624,0.624,176,0.176,30
51364,41081,10283,32919,83,74000,514,1000,0.514,666,0.666,180,0.18,30
51891,41417,10474,33583,84,75000,527,1000,0.527,664,0.664,191,0.191,30
52446,41797,10649,34203,85,76000,555,1000,0.555,620,0.62,175,0.175,30
52998,42189,10809,34811,86,77000,552,1000,0.552,608,0.608,160,0.16,30
53550,42596,10954,35404,87,78000,552,1000,0.552,593,0.593,145,0.145,30
54085,42963,11122,36037,88,79000,535,1000,0.535,633,0.633,168,0.168,30
54613,43324,11289,36676,89,80000,528,1000,0.528,639,0.639,167,0.167,30
55145,43666,11479,37334,90,81000,532,1000,0.532,658,0.658,190,0.19,30
55684,44032,11652,37968,91,82000,539,1000,0.539,634,0.634,173,0.173,30
56221,44397,11824,38603,92,83000,537,1000,0.537,635,0.635,172,0.172,30
56754,44759,11995,39241,93,84000,533,1000,0.533,638,0.638,171,0.171,30
57294,45131,12163,39869,94,85000,540,1000,0.54,628,0.628,168,0.168,30
57806,45459,12347,40541,95,86000,512,1000,0.512,672,0.672,184,0.184,30
58346,45827,12519,41173,96,87000,540,1000,0.54,632,0.632,172,0.172,30
58881,46204,12677,41796,97,88000,535,1000,0.535,623,0.623,158,0.158,30
59392,46541,12851,42459,98,89000,511,1000,0.511,663,0.663,174,0.174,30
59896,46858,13038,43142,99,90000,504,1000,0.504,683,0.683,187,0.187,30
60405,47199,13206,43801,100,91000,509,1000,0.509,659,0.659,168,0.168,30
60884,47508,13376,44492,101,92000,479,1000,0.479,691,0.691,170,0.17,30
61417,47885,13532,45115,102,93000,533,1000,0.533,623,0.623,156,0.156,30
61936,48241,13695,45759,103,94000,519,1000,0.519,644,0.644,163,0.163,30
62437,48549,13888,46451,104,95000,501,1000,0.501,692,0.692,193,0.193,30
62930,48852,14078,47148,105,96000,493,1000,0.493,697,0.697,190,0.19,30
63444,49176,14268,47824,106,97000,514,1000,0.514,676,0.676,190,0.19,30
63939,49501,14438,48499,107,98000,495,1000,0.495,675,0.675,170,0.17,30
64410,49789,14621,49211,108,99000,471,1000,0.471,712,0.712,183,0.183,30
64939,50147,14792,49853,109,100000,529,1000,0.529,642,0.642,171,0.171,30
65441,50475,14966,50525,110,101000,502,1000,0.502,672,0.672,174,0.174,30
65909,50768,15141,51232,111,102000,468,1000,0.468,707,0.707,175,0.175,30
66396,51084,15312,51916,112,103000,487,1000,0.487,684,0.684,171,0.171,30
66894,51428,15466,52572,113,104000,498,1000,0.498,656,0.656,154,0.154,30
67388,51764,15624,53236,114,105000,494,1000,0.494,664,0.664,158,0.158,30
67890,52098,15792,53902,115,106000,502,1000,0.502,666,0.666,168,0.168,30
68387,52450,15937,54550,116,107000,497,1000,0.497,648,0.648,145,0.145,30
68889,52766,16123,55234,117,108000,502,1000,0.502,684,0.684,186,0.186,30
69380,53081,16299,55919,118,109000,491,1000,0.491,685,0.685,176,0.176,30
69870,53407,16463,56593,119,110000,490,1000,0.49,674,0.674,164,0.164,30
70328,53686,16642,57314,120,111000,458,1000,0.458,721,0.721,179,0.179,30
70788,53975,16813,58025,121,112000,460,1000,0.46,711,0.711,171,0.171,30
71237,54231,17006,58769,122,113000,449,1000,0.449,744,0.744,193,0.193,30
71731,54551,17180,59449,123,114000,494,1000,0.494,680,0.68,174,0.174,30
71869,54638,17231,59660,124,114298,138,298,0.46308724832214765,211,0.7080536912751678,51,0.17114093959731544,30
100,100,0,0,1,100,NA,NA,NA,NA,NA,NA,NA,31
199,198,1,2,2,200,99,100,0.99,2,0.02,1,0.01,31
297,294,3,6,3,300,98,100,0.98,4,0.04,2,0.02,31
395,390,5,10,4,400,98,100,0.98,4,0.04,2,0.02,31
495,490,5,10,5,500,100,100,1,0,0,0,0,31
594,589,5,11,6,600,99,100,0.99,1,0.01,0,0,31
692,686,6,14,7,700,98,100,0.98,3,0.03,1,0.01,31
787,778,9,22,8,800,95,100,0.95,8,0.08,3,0.03,31
884,872,12,28,9,900,97,100,0.97,6,0.06,3,0.03,31
983,970,13,30,10,1000,99,100,0.99,2,0.02,1,0.01,31
1944,1903,41,97,11,2000,961,1000,0.961,67,0.067,28,0.028,31
2882,2797,85,203,12,3000,938,1000,0.938,106,0.106,44,0.044,31
3805,3667,138,333,13,4000,923,1000,0.923,130,0.13,53,0.053,31
4682,4463,219,537,14,5000,877,1000,0.877,204,0.204,81,0.081,31
5561,5264,297,736,15,6000,879,1000,0.879,199,0.199,78,0.078,31
6420,6027,393,973,16,7000,859,1000,0.859,237,0.237,96,0.096,31
7280,6794,486,1206,17,8000,860,1000,0.86,233,0.233,93,0.093,31
8128,7550,578,1450,18,9000,848,1000,0.848,244,0.244,92,0.092,31
8967,8285,682,1715,19,10000,839,1000,0.839,265,0.265,104,0.104,31
9820,9058,762,1942,20,11000,853,1000,0.853,227,0.227,80,0.08,31
10648,9784,864,2216,21,12000,828,1000,0.828,274,0.274,102,0.102,31
11459,10481,978,2519,22,13000,811,1000,0.811,303,0.303,114,0.114,31
12261,11184,1077,2816,23,14000,802,1000,0.802,297,0.297,99,0.099,31
13052,11846,1206,3154,24,15000,791,1000,0.791,338,0.338,129,0.129,31
13821,12484,1337,3516,25,16000,769,1000,0.769,362,0.362,131,0.131,31
14593,13135,1458,3865,26,17000,772,1000,0.772,349,0.349,121,0.121,31
15376,13796,1580,4204,27,18000,783,1000,0.783,339,0.339,122,0.122,31
16111,14390,1721,4610,28,19000,735,1000,0.735,406,0.406,141,0.141,31
16864,15005,1859,4995,29,20000,753,1000,0.753,385,0.385,138,0.138,31
17621,15646,1975,5354,30,21000,757,1000,0.757,359,0.359,116,0.116,31
18382,16296,2086,5704,31,22000,761,1000,0.761,350,0.35,111,0.111,31
19137,16923,2214,6077,32,23000,755,1000,0.755,373,0.373,128,0.128,31
19859,17490,2369,6510,33,24000,722,1000,0.722,433,0.433,155,0.155,31
20575,18068,2507,6932,34,25000,716,1000,0.716,422,0.422,138,0.138,31
21295,18639,2656,7361,35,26000,720,1000,0.72,429,0.429,149,0.149,31
21993,19183,2810,7817,36,27000,698,1000,0.698,456,0.456,154,0.154,31
22725,19769,2956,8231,37,28000,732,1000,0.732,414,0.414,146,0.146,31
23450,20366,3084,8634,38,29000,725,1000,0.725,403,0.403,128,0.128,31
24156,20923,3233,9077,39,30000,706,1000,0.706,443,0.443,149,0.149,31
24856,21467,3389,9533,40,31000,700,1000,0.7,456,0.456,156,0.156,31
25553,22021,3532,9979,41,32000,697,1000,0.697,446,0.446,143,0.143,31
26227,22535,3692,10465,42,33000,674,1000,0.674,486,0.486,160,0.16,31
26909,23056,3853,10944,43,34000,682,1000,0.682,479,0.479,161,0.161,31
27580,23572,4008,11428,44,35000,671,1000,0.671,484,0.484,155,0.155,31
28257,24101,4156,11899,45,36000,677,1000,0.677,471,0.471,148,0.148,31
28915,24599,4316,12401,46,37000,658,1000,0.658,502,0.502,160,0.16,31
29582,25123,4459,12877,47,38000,667,1000,0.667,476,0.476,143,0.143,31
30241,25628,4613,13372,48,39000,659,1000,0.659,495,0.495,154,0.154,31
30879,26110,4769,13890,49,40000,638,1000,0.638,518,0.518,156,0.156,31
31538,26623,4915,14377,50,41000,659,1000,0.659,487,0.487,146,0.146,31
32174,27096,5078,14904,51,42000,636,1000,0.636,527,0.527,163,0.163,31
32818,27596,5222,15404,52,43000,644,1000,0.644,500,0.5,144,0.144,31
33440,28060,5380,15940,53,44000,622,1000,0.622,536,0.536,158,0.158,31
34072,28547,5525,16453,54,45000,632,1000,0.632,513,0.513,145,0.145,31
34685,28994,5691,17006,55,46000,613,1000,0.613,553,0.553,166,0.166,31
35328,29478,5850,17522,56,47000,643,1000,0.643,516,0.516,159,0.159,31
35932,29909,6023,18091,57,48000,604,1000,0.604,569,0.569,173,0.173,31
36555,30370,6185,18630,58,49000,623,1000,0.623,539,0.539,162,0.162,31
37209,30888,6321,19112,59,50000,654,1000,0.654,482,0.482,136,0.136,31
37834,31334,6500,19666,60,51000,625,1000,0.625,554,0.554,179,0.179,31
38434,31762,6672,20238,61,52000,600,1000,0.6,572,0.572,172,0.172,31
39037,32202,6835,20798,62,53000,603,1000,0.603,560,0.56,163,0.163,31
39644,32661,6983,21339,63,54000,607,1000,0.607,541,0.541,148,0.148,31
40231,33086,7145,21914,64,55000,587,1000,0.587,575,0.575,162,0.162,31
40859,33562,7297,22438,65,56000,628,1000,0.628,524,0.524,152,0.152,31
41445,33974,7471,23026,66,57000,586,1000,0.586,588,0.588,174,0.174,31
42055,34404,7651,23596,67,58000,610,1000,0.61,570,0.57,180,0.18,31
42644,34827,7817,24173,68,59000,589,1000,0.589,577,0.577,166,0.166,31
43225,35244,7981,24756,69,60000,581,1000,0.581,583,0.583,164,0.164,31
43780,35629,8151,25371,70,61000,555,1000,0.555,615,0.615,170,0.17,31
44341,36002,8339,25998,71,62000,561,1000,0.561,627,0.627,188,0.188,31
44908,36397,8511,26603,72,63000,567,1000,0.567,605,0.605,172,0.172,31
45503,36832,8671,27168,73,64000,595,1000,0.595,565,0.565,160,0.16,31
46088,37255,8833,27745,74,65000,585,1000,0.585,577,0.577,162,0.162,31
46665,37653,9012,28347,75,66000,577,1000,0.577,602,0.602,179,0.179,31
47252,38095,9157,28905,76,67000,587,1000,0.587,558,0.558,145,0.145,31
47834,38554,9280,29446,77,68000,582,1000,0.582,541,0.541,123,0.123,31
48384,38923,9461,30077,78,69000,550,1000,0.55,631,0.631,181,0.181,31
48948,39318,9630,30682,79,70000,564,1000,0.564,605,0.605,169,0.169,31
49513,39707,9806,31293,80,71000,565,1000,0.565,611,0.611,176,0.176,31
50075,40111,9964,31889,81,72000,562,1000,0.562,596,0.596,158,0.158,31
50637,40498,10139,32502,82,73000,562,1000,0.562,613,0.613,175,0.175,31
51210,40909,10301,33091,83,74000,573,1000,0.573,589,0.589,162,0.162,31
51781,41309,10472,33691,84,75000,571,1000,0.571,600,0.6,171,0.171,31
52329,41684,10645,34316,85,76000,548,1000,0.548,625,0.625,173,0.173,31
52869,42039,10830,34961,86,77000,540,1000,0.54,645,0.645,185,0.185,31
53381,42373,11008,35627,87,78000,512,1000,0.512,666,0.666,178,0.178,31
53948,42789,11159,36211,88,79000,567,1000,0.567,584,0.584,151,0.151,31
54477,43134,11343,36866,89,80000,529,1000,0.529,655,0.655,184,0.184,31
55013,43506,11507,37494,90,81000,536,1000,0.536,628,0.628,164,0.164,31
55538,43857,11681,38143,91,82000,525,1000,0.525,649,0.649,174,0.174,31
56075,44219,11856,38781,92,83000,537,1000,0.537,638,0.638,175,0.175,31
56599,44554,12045,39446,93,84000,524,1000,0.524,665,0.665,189,0.189,31
57121,44916,12205,40084,94,85000,522,1000,0.522,638,0.638,160,0.16,31
57637,45230,12407,40770,95,86000,516,1000,0.516,686,0.686,202,0.202,31
58179,45628,12551,41372,96,87000,542,1000,0.542,602,0.602,144,0.144,31
58718,45982,12736,42018,97,88000,539,1000,0.539,646,0.646,185,0.185,31
59225,46303,12922,42697,98,89000,507,1000,0.507,679,0.679,186,0.186,31
59753,46669,13084,43331,99,90000,528,1000,0.528,634,0.634,162,0.162,31
60270,47019,13251,43981,100,91000,517,1000,0.517,650,0.65,167,0.167,31
60798,47375,13423,44625,101,92000,528,1000,0.528,644,0.644,172,0.172,31
61342,47750,13592,45250,102,93000,544,1000,0.544,625,0.625,169,0.169,31
61897,48154,13743,45846,103,94000,555,1000,0.555,596,0.596,151,0.151,31
62398,48492,13906,46508,104,95000,501,1000,0.501,662,0.662,163,0.163,31
62947,48868,14079,47132,105,96000,549,1000,0.549,624,0.624,173,0.173,31
63465,49216,14249,47784,106,97000,518,1000,0.518,652,0.652,170,0.17,31
63954,49523,14431,48477,107,98000,489,1000,0.489,693,0.693,182,0.182,31
64444,49839,14605,49161,108,99000,490,1000,0.49,684,0.684,174,0.174,31
64936,50171,14765,49829,109,100000,492,1000,0.492,668,0.668,160,0.16,31
65460,50555,14905,50445,110,101000,524,1000,0.524,616,0.616,140,0.14,31
65954,50884,15070,51116,111,102000,494,1000,0.494,671,0.671,165,0.165,31
66451,51196,15255,51804,112,103000,497,1000,0.497,688,0.688,185,0.185,31
66958,51536,15422,52464,113,104000,507,1000,0.507,660,0.66,167,0.167,31
67434,51841,15593,53159,114,105000,476,1000,0.476,695,0.695,171,0.171,31
67926,52168,15758,53832,115,106000,492,1000,0.492,673,0.673,165,0.165,31
68386,52446,15940,54554,116,107000,460,1000,0.46,722,0.722,182,0.182,31
68874,52755,16119,55245,117,108000,488,1000,0.488,691,0.691,179,0.179,31
69342,53050,16292,55950,118,109000,468,1000,0.468,705,0.705,173,0.173,31
69818,53355,16463,56645,119,110000,476,1000,0.476,695,0.695,171,0.171,31
70305,53675,16630,57325,120,111000,487,1000,0.487,680,0.68,167,0.167,31
70807,53993,16814,58007,121,112000,502,1000,0.502,682,0.682,184,0.184,31
71253,54271,16982,58729,122,113000,446,1000,0.446,722,0.722,168,0.168,31
71718,54538,17180,59462,123,114000,465,1000,0.465,733,0.733,198,0.198,31
71869,54638,17231,59660,124,114298,151,298,0.5067114093959731,198,0.6644295302013423,51,0.17114093959731544,31
99,98,1,2,1,100,NA,NA,NA,NA,NA,NA,NA,32
198,196,2,4,2,200,99,100,0.99,2,0.02,1,0.01,32
297,294,3,6,3,300,99,100,0.99,2,0.02,1,0.01,32
397,394,3,6,4,400,100,100,1,0,0,0,0,32
497,494,3,6,5,500,100,100,1,0,0,0,0,32
595,590,5,10,6,600,98,100,0.98,4,0.04,2,0.02,32
694,688,6,12,7,700,99,100,0.99,2,0.02,1,0.01,32
793,786,7,14,8,800,99,100,0.99,2,0.02,1,0.01,32
888,876,12,24,9,900,95,100,0.95,10,0.1,5,0.05,32
986,973,13,27,10,1000,98,100,0.98,3,0.03,1,0.01,32
1946,1898,48,102,11,2000,960,1000,0.96,75,0.075,35,0.035,32
2879,2774,105,226,12,3000,933,1000,0.933,124,0.124,57,0.057,32
3775,3599,176,401,13,4000,896,1000,0.896,175,0.175,71,0.071,32
4661,4408,253,592,14,5000,886,1000,0.886,191,0.191,77,0.077,32
5539,5200,339,800,15,6000,878,1000,0.878,208,0.208,86,0.086,32
6416,6003,413,997,16,7000,877,1000,0.877,197,0.197,74,0.074,32
7269,6771,498,1229,17,8000,853,1000,0.853,232,0.232,85,0.085,32
8128,7540,588,1460,18,9000,859,1000,0.859,231,0.231,90,0.09,32
8959,8262,697,1738,19,10000,831,1000,0.831,278,0.278,109,0.109,32
9795,9005,790,1995,20,11000,836,1000,0.836,257,0.257,93,0.093,32
10618,9720,898,2280,21,12000,823,1000,0.823,285,0.285,108,0.108,32
11429,10436,993,2564,22,13000,811,1000,0.811,284,0.284,95,0.095,32
12223,11120,1103,2880,23,14000,794,1000,0.794,316,0.316,110,0.11,32
12993,11760,1233,3240,24,15000,770,1000,0.77,360,0.36,130,0.13,32
13767,12411,1356,3589,25,16000,774,1000,0.774,349,0.349,123,0.123,32
14565,13100,1465,3900,26,17000,798,1000,0.798,311,0.311,109,0.109,32
15319,13718,1601,4282,27,18000,754,1000,0.754,382,0.382,136,0.136,32
16082,14360,1722,4640,28,19000,763,1000,0.763,358,0.358,121,0.121,32
16845,14986,1859,5014,29,20000,763,1000,0.763,374,0.374,137,0.137,32
17606,15623,1983,5377,30,21000,761,1000,0.761,363,0.363,124,0.124,32
18366,16262,2104,5738,31,22000,760,1000,0.76,361,0.361,121,0.121,32
19118,16893,2225,6107,32,23000,752,1000,0.752,369,0.369,121,0.121,32
19834,17458,2376,6542,33,24000,716,1000,0.716,435,0.435,151,0.151,32
20558,18039,2519,6961,34,25000,724,1000,0.724,419,0.419,143,0.143,32
21301,18655,2646,7345,35,26000,743,1000,0.743,384,0.384,127,0.127,32
22012,19212,2800,7788,36,27000,711,1000,0.711,443,0.443,154,0.154,32
22699,19731,2968,8269,37,28000,687,1000,0.687,481,0.481,168,0.168,32
23385,20267,3118,8733,38,29000,686,1000,0.686,464,0.464,150,0.15,32
24097,20857,3240,9143,39,30000,712,1000,0.712,410,0.41,122,0.122,32
24794,21419,3375,9581,40,31000,697,1000,0.697,438,0.438,135,0.135,32
25493,21992,3501,10008,41,32000,699,1000,0.699,427,0.427,126,0.126,32
26186,22543,3643,10457,42,33000,693,1000,0.693,449,0.449,142,0.142,32
26881,23091,3790,10909,43,34000,695,1000,0.695,452,0.452,147,0.147,32
27563,23624,3939,11376,44,35000,682,1000,0.682,467,0.467,149,0.149,32
28226,24136,4090,11864,45,36000,663,1000,0.663,488,0.488,151,0.151,32
28894,24644,4250,12356,46,37000,668,1000,0.668,492,0.492,160,0.16,32
29551,25140,4411,12860,47,38000,657,1000,0.657,504,0.504,161,0.161,32
30218,25649,4569,13351,48,39000,667,1000,0.667,491,0.491,158,0.158,32
30893,26178,4715,13822,49,40000,675,1000,0.675,471,0.471,146,0.146,32
31521,26641,4880,14359,50,41000,628,1000,0.628,537,0.537,165,0.165,32
32173,27128,5045,14872,51,42000,652,1000,0.652,513,0.513,165,0.165,32
32807,27583,5224,15417,52,43000,634,1000,0.634,545,0.545,179,0.179,32
33455,28067,5388,15933,53,44000,648,1000,0.648,516,0.516,164,0.164,32
34108,28564,5544,16436,54,45000,653,1000,0.653,503,0.503,156,0.156,32
34740,29034,5706,16966,55,46000,632,1000,0.632,530,0.53,162,0.162,32
35366,29477,5889,17523,56,47000,626,1000,0.626,557,0.557,183,0.183,32
36001,29948,6053,18052,57,48000,635,1000,0.635,529,0.529,164,0.164,32
36613,30379,6234,18621,58,49000,612,1000,0.612,569,0.569,181,0.181,32
37210,30800,6410,19200,59,50000,597,1000,0.597,579,0.579,176,0.176,32
37816,31255,6561,19745,60,51000,606,1000,0.606,545,0.545,151,0.151,32
38427,31696,6731,20304,61,52000,611,1000,0.611,559,0.559,170,0.17,32
39017,32099,6918,20901,62,53000,590,1000,0.59,597,0.597,187,0.187,32
39626,32556,7070,21444,63,54000,609,1000,0.609,543,0.543,152,0.152,32
40243,33024,7219,21976,64,55000,617,1000,0.617,532,0.532,149,0.149,32
40828,33425,7403,22575,65,56000,585,1000,0.585,599,0.599,184,0.184,32
41435,33875,7560,23125,66,57000,607,1000,0.607,550,0.55,157,0.157,32
42015,34283,7732,23717,67,58000,580,1000,0.58,592,0.592,172,0.172,32
42606,34709,7897,24291,68,59000,591,1000,0.591,574,0.574,165,0.165,32
43198,35113,8085,24887,69,60000,592,1000,0.592,596,0.596,188,0.188,32
43778,35513,8265,25487,70,61000,580,1000,0.58,600,0.6,180,0.18,32
44348,35924,8424,26076,71,62000,570,1000,0.57,589,0.589,159,0.159,32
44917,36340,8577,26660,72,63000,569,1000,0.569,584,0.584,153,0.153,32
45509,36766,8743,27234,73,64000,592,1000,0.592,574,0.574,166,0.166,32
46095,37198,8897,27802,74,65000,586,1000,0.586,568,0.568,154,0.154,32
46669,37616,9053,28384,75,66000,574,1000,0.574,582,0.582,156,0.156,32
47262,38049,9213,28951,76,67000,593,1000,0.593,567,0.567,160,0.16,32
47846,38463,9383,29537,77,68000,584,1000,0.584,586,0.586,170,0.17,32
48377,38807,9570,30193,78,69000,531,1000,0.531,656,0.656,187,0.187,32
48922,39174,9748,30826,79,70000,545,1000,0.545,633,0.633,178,0.178,32
49499,39596,9903,31404,80,71000,577,1000,0.577,578,0.578,155,0.155,32
50048,39961,10087,32039,81,72000,549,1000,0.549,635,0.635,184,0.184,32
50599,40350,10249,32650,82,73000,551,1000,0.551,611,0.611,162,0.162,32
51178,40778,10400,33222,83,74000,579,1000,0.579,572,0.572,151,0.151,32
51719,41154,10565,33846,84,75000,541,1000,0.541,624,0.624,165,0.165,32
52271,41537,10734,34463,85,76000,552,1000,0.552,617,0.617,169,0.169,32
52833,41938,10895,35062,86,77000,562,1000,0.562,599,0.599,161,0.161,32
53378,42304,11074,35696,87,78000,545,1000,0.545,634,0.634,179,0.179,32
53934,42709,11225,36291,88,79000,556,1000,0.556,595,0.595,151,0.151,32
54441,43037,11404,36963,89,80000,507,1000,0.507,672,0.672,179,0.179,32
54957,43382,11575,37618,90,81000,516,1000,0.516,655,0.655,171,0.171,32
55480,43750,11730,38250,91,82000,523,1000,0.523,632,0.632,155,0.155,32
56013,44106,11907,38894,92,83000,533,1000,0.533,644,0.644,177,0.177,32
56532,44440,12092,39560,93,84000,519,1000,0.519,666,0.666,185,0.185,32
57053,44792,12261,40208,94,85000,521,1000,0.521,648,0.648,169,0.169,32
57586,45153,12433,40847,95,86000,533,1000,0.533,639,0.639,172,0.172,32
58107,45508,12599,41492,96,87000,521,1000,0.521,645,0.645,166,0.166,32
58653,45898,12755,42102,97,88000,546,1000,0.546,610,0.61,156,0.156,32
59165,46231,12934,42769,98,89000,512,1000,0.512,667,0.667,179,0.179,32
59702,46593,13109,43407,99,90000,537,1000,0.537,638,0.638,175,0.175,32
60237,46965,13272,44035,100,91000,535,1000,0.535,628,0.628,163,0.163,32
60755,47324,13431,44676,101,92000,518,1000,0.518,641,0.641,159,0.159,32
61249,47639,13610,45361,102,93000,494,1000,0.494,685,0.685,179,0.179,32
61797,48014,13783,45986,103,94000,548,1000,0.548,625,0.625,173,0.173,32
62328,48388,13940,46612,104,95000,531,1000,0.531,626,0.626,157,0.157,32
62852,48742,14110,47258,105,96000,524,1000,0.524,646,0.646,170,0.17,32
63359,49079,14280,47921,106,97000,507,1000,0.507,663,0.663,170,0.17,32
63851,49400,14451,48600,107,98000,492,1000,0.492,679,0.679,171,0.171,32
64347,49711,14636,49289,108,99000,496,1000,0.496,689,0.689,185,0.185,32
64857,50061,14796,49939,109,100000,510,1000,0.51,650,0.65,160,0.16,32
65332,50359,14973,50641,110,101000,475,1000,0.475,702,0.702,177,0.177,32
65831,50688,15143,51312,111,102000,499,1000,0.499,671,0.671,170,0.17,32
66342,51019,15323,51981,112,103000,511,1000,0.511,669,0.669,180,0.18,32
66850,51363,15487,52637,113,104000,508,1000,0.508,656,0.656,164,0.164,32
67353,51688,15665,53312,114,105000,503,1000,0.503,675,0.675,178,0.178,32
67849,52024,15825,53976,115,106000,496,1000,0.496,664,0.664,160,0.16,32
68317,52317,16000,54683,116,107000,468,1000,0.468,707,0.707,175,0.175,32
68786,52598,16188,55402,117,108000,469,1000,0.469,719,0.719,188,0.188,32
69296,52946,16350,56054,118,109000,510,1000,0.51,652,0.652,162,0.162,32
69803,53301,16502,56699,119,110000,507,1000,0.507,645,0.645,152,0.152,32
70295,53632,16663,57368,120,111000,492,1000,0.492,669,0.669,161,0.161,32
70781,53945,16836,58055,121,112000,486,1000,0.486,687,0.687,173,0.173,32
71251,54230,17021,58770,122,113000,470,1000,0.47,715,0.715,185,0.185,32
71732,54558,17174,59442,123,114000,481,1000,0.481,672,0.672,153,0.153,32
71869,54638,17231,59660,124,114298,137,298,0.4597315436241611,218,0.7315436241610739,57,0.1912751677852349,32
100,100,0,0,1,100,NA,NA,NA,NA,NA,NA,NA,33
200,200,0,0,2,200,100,100,1,0,0,0,0,33
300,300,0,0,3,300,100,100,1,0,0,0,0,33
398,396,2,4,4,400,98,100,0.98,4,0.04,2,0.02,33
495,491,4,9,5,500,97,100,0.97,5,0.05,2,0.02,33
593,587,6,13,6,600,98,100,0.98,4,0.04,2,0.02,33
689,681,8,19,7,700,96,100,0.96,6,0.06,2,0.02,33
786,776,10,24,8,800,97,100,0.97,5,0.05,2,0.02,33
886,876,10,24,9,900,100,100,1,0,0,0,0,33
983,970,13,30,10,1000,97,100,0.97,6,0.06,3,0.03,33
1929,1876,53,124,11,2000,946,1000,0.946,94,0.094,40,0.04,33
2870,2769,101,231,12,3000,941,1000,0.941,107,0.107,48,0.048,33
3800,3653,147,347,13,4000,930,1000,0.93,116,0.116,46,0.046,33
4698,4476,222,524,14,5000,898,1000,0.898,177,0.177,75,0.075,33
5584,5286,298,714,15,6000,886,1000,0.886,190,0.19,76,0.076,33
6445,6066,379,934,16,7000,861,1000,0.861,220,0.22,81,0.081,33
7296,6824,472,1176,17,8000,851,1000,0.851,242,0.242,93,0.093,33
8145,7578,567,1422,18,9000,849,1000,0.849,246,0.246,95,0.095,33
8979,8311,668,1689,19,10000,834,1000,0.834,267,0.267,101,0.101,33
9802,9022,780,1978,20,11000,823,1000,0.823,289,0.289,112,0.112,33
10631,9765,866,2235,21,12000,829,1000,0.829,257,0.257,86,0.086,33
11453,10485,968,2515,22,13000,822,1000,0.822,280,0.28,102,0.102,33
12249,11167,1082,2833,23,14000,796,1000,0.796,318,0.318,114,0.114,33
13043,11841,1202,3159,24,15000,794,1000,0.794,326,0.326,120,0.12,33
13822,12483,1339,3517,25,16000,779,1000,0.779,358,0.358,137,0.137,33
14596,13130,1466,3870,26,17000,774,1000,0.774,353,0.353,127,0.127,33
15372,13785,1587,4215,27,18000,776,1000,0.776,345,0.345,121,0.121,33
16130,14411,1719,4589,28,19000,758,1000,0.758,374,0.374,132,0.132,33
16888,15039,1849,4961,29,20000,758,1000,0.758,372,0.372,130,0.13,33
17626,15648,1978,5352,30,21000,738,1000,0.738,391,0.391,129,0.129,33
18370,16262,2108,5738,31,22000,744,1000,0.744,386,0.386,130,0.13,33
19128,16890,2238,6110,32,23000,758,1000,0.758,372,0.372,130,0.13,33
19852,17468,2384,6532,33,24000,724,1000,0.724,422,0.422,146,0.146,33
20584,18058,2526,6942,34,25000,732,1000,0.732,410,0.41,142,0.142,33
21329,18684,2645,7316,35,26000,745,1000,0.745,374,0.374,119,0.119,33
22028,19228,2800,7772,36,27000,699,1000,0.699,456,0.456,155,0.155,33
22721,19746,2975,8254,37,28000,693,1000,0.693,482,0.482,175,0.175,33
23427,20300,3127,8700,38,29000,706,1000,0.706,446,0.446,152,0.152,33
24123,20842,3281,9158,39,30000,696,1000,0.696,458,0.458,154,0.154,33
24814,21374,3440,9626,40,31000,691,1000,0.691,468,0.468,159,0.159,33
25495,21898,3597,10102,41,32000,681,1000,0.681,476,0.476,157,0.157,33
26187,22443,3744,10557,42,33000,692,1000,0.692,455,0.455,147,0.147,33
26876,22992,3884,11008,43,34000,689,1000,0.689,451,0.451,140,0.14,33
27561,23512,4049,11488,44,35000,685,1000,0.685,480,0.48,165,0.165,33
28233,24033,4200,11967,45,36000,672,1000,0.672,479,0.479,151,0.151,33
28891,24531,4360,12469,46,37000,658,1000,0.658,502,0.502,160,0.16,33
29560,25040,4520,12960,47,38000,669,1000,0.669,491,0.491,160,0.16,33
30233,25556,4677,13444,48,39000,673,1000,0.673,484,0.484,157,0.157,33
30895,26064,4831,13936,49,40000,662,1000,0.662,492,0.492,154,0.154,33
31552,26573,4979,14427,50,41000,657,1000,0.657,491,0.491,148,0.148,33
32176,27016,5160,14984,51,42000,624,1000,0.624,557,0.557,181,0.181,33
32835,27520,5315,15480,52,43000,659,1000,0.659,496,0.496,155,0.155,33
33478,28004,5474,15996,53,44000,643,1000,0.643,516,0.516,159,0.159,33
34123,28493,5630,16507,54,45000,645,1000,0.645,511,0.511,156,0.156,33
34736,28938,5798,17062,55,46000,613,1000,0.613,555,0.555,168,0.168,33
35375,29416,5959,17584,56,47000,639,1000,0.639,522,0.522,161,0.161,33
35998,29886,6112,18114,57,48000,623,1000,0.623,530,0.53,153,0.153,33
36623,30351,6272,18649,58,49000,625,1000,0.625,535,0.535,160,0.16,33
37252,30813,6439,19187,59,50000,629,1000,0.629,538,0.538,167,0.167,33
37862,31268,6594,19732,60,51000,610,1000,0.61,545,0.545,155,0.155,33
38471,31716,6755,20284,61,52000,609,1000,0.609,552,0.552,161,0.161,33
39071,32138,6933,20862,62,53000,600,1000,0.6,578,0.578,178,0.178,33
39710,32627,7083,21373,63,54000,639,1000,0.639,511,0.511,150,0.15,33
40318,33081,7237,21919,64,55000,608,1000,0.608,546,0.546,154,0.154,33
40914,33526,7388,22474,65,56000,596,1000,0.596,555,0.555,151,0.151,33
41515,33964,7551,23036,66,57000,601,1000,0.601,562,0.562,163,0.163,33
42128,34404,7724,23596,67,58000,613,1000,0.613,560,0.56,173,0.173,33
42728,34853,7875,24147,68,59000,600,1000,0.6,551,0.551,151,0.151,33
43317,35290,8027,24710,69,60000,589,1000,0.589,563,0.563,152,0.152,33
43896,35698,8198,25302,70,61000,579,1000,0.579,592,0.592,171,0.171,33
44483,36111,8372,25889,71,62000,587,1000,0.587,587,0.587,174,0.174,33
45090,36548,8542,26452,72,63000,607,1000,0.607,563,0.563,170,0.17,33
45658,36965,8693,27035,73,64000,568,1000,0.568,583,0.583,151,0.151,33
46217,37332,8885,27668,74,65000,559,1000,0.559,633,0.633,192,0.192,33
46804,37754,9050,28246,75,66000,587,1000,0.587,578,0.578,165,0.165,33
47369,38156,9213,28844,76,67000,565,1000,0.565,598,0.598,163,0.163,33
47942,38551,9391,29449,77,68000,573,1000,0.573,605,0.605,178,0.178,33
48487,38921,9566,30079,78,69000,545,1000,0.545,630,0.63,175,0.175,33
49043,39293,9750,30707,79,70000,556,1000,0.556,628,0.628,184,0.184,33
49615,39699,9916,31301,80,71000,572,1000,0.572,594,0.594,166,0.166,33
50205,40138,10067,31862,81,72000,590,1000,0.59,561,0.561,151,0.151,33
50752,40531,10221,32469,82,73000,547,1000,0.547,607,0.607,154,0.154,33
51287,40898,10389,33102,83,74000,535,1000,0.535,633,0.633,168,0.168,33
51827,41272,10555,33728,84,75000,540,1000,0.54,626,0.626,166,0.166,33
52360,41625,10735,34375,85,76000,533,1000,0.533,647,0.647,180,0.18,33
52914,42009,10905,34991,86,77000,554,1000,0.554,616,0.616,170,0.17,33
53483,42416,11067,35584,87,78000,569,1000,0.569,593,0.593,162,0.162,33
53999,42765,11234,36235,88,79000,516,1000,0.516,651,0.651,167,0.167,33
54541,43147,11394,36853,89,80000,542,1000,0.542,618,0.618,160,0.16,33
55079,43519,11560,37481,90,81000,538,1000,0.538,628,0.628,166,0.166,33
55604,43870,11734,38130,91,82000,525,1000,0.525,649,0.649,174,0.174,33
56133,44229,11904,38771,92,83000,529,1000,0.529,641,0.641,170,0.17,33
56659,44580,12079,39420,93,84000,526,1000,0.526,649,0.649,175,0.175,33
57198,44958,12240,40042,94,85000,539,1000,0.539,622,0.622,161,0.161,33
57716,45297,12419,40703,95,86000,518,1000,0.518,661,0.661,179,0.179,33
58242,45663,12579,41337,96,87000,526,1000,0.526,634,0.634,160,0.16,33
58755,45999,12756,42001,97,88000,513,1000,0.513,664,0.664,177,0.177,33
59248,46305,12943,42695,98,89000,493,1000,0.493,694,0.694,187,0.187,33
59754,46639,13115,43361,99,90000,506,1000,0.506,666,0.666,172,0.172,33
60285,46997,13288,44003,100,91000,531,1000,0.531,642,0.642,173,0.173,33
60808,47363,13445,44637,101,92000,523,1000,0.523,634,0.634,157,0.157,33
61321,47717,13604,45283,102,93000,513,1000,0.513,646,0.646,159,0.159,33
61847,48075,13772,45925,103,94000,526,1000,0.526,642,0.642,168,0.168,33
62348,48398,13950,46602,104,95000,501,1000,0.501,677,0.677,178,0.178,33
62862,48762,14100,47238,105,96000,514,1000,0.514,636,0.636,150,0.15,33
63368,49108,14260,47892,106,97000,506,1000,0.506,654,0.654,160,0.16,33
63885,49459,14426,48541,107,98000,517,1000,0.517,649,0.649,166,0.166,33
64380,49772,14608,49228,108,99000,495,1000,0.495,687,0.687,182,0.182,33
64892,50112,14780,49888,109,100000,512,1000,0.512,660,0.66,172,0.172,33
65367,50410,14957,50590,110,101000,475,1000,0.475,702,0.702,177,0.177,33
65843,50718,15125,51282,111,102000,476,1000,0.476,692,0.692,168,0.168,33
66326,51029,15297,51971,112,103000,483,1000,0.483,689,0.689,172,0.172,33
66825,51339,15486,52661,113,104000,499,1000,0.499,690,0.69,189,0.189,33
67335,51676,15659,53324,114,105000,510,1000,0.51,663,0.663,173,0.173,33
67822,51997,15825,54003,115,106000,487,1000,0.487,679,0.679,166,0.166,33
68315,52326,15989,54674,116,107000,493,1000,0.493,671,0.671,164,0.164,33
68801,52647,16154,55353,117,108000,486,1000,0.486,679,0.679,165,0.165,33
69280,52965,16315,56035,118,109000,479,1000,0.479,682,0.682,161,0.161,33
69774,53274,16500,56726,119,110000,494,1000,0.494,691,0.691,185,0.185,33
70255,53590,16665,57410,120,111000,481,1000,0.481,684,0.684,165,0.165,33
70736,53899,16837,58101,121,112000,481,1000,0.481,691,0.691,172,0.172,33
71222,54207,17015,58793,122,113000,486,1000,0.486,692,0.692,178,0.178,33
71729,54552,17177,59448,123,114000,507,1000,0.507,655,0.655,162,0.162,33
71869,54638,17231,59660,124,114298,140,298,0.4697986577181208,212,0.7114093959731543,54,0.18120805369127516,33
100,100,0,0,1,100,NA,NA,NA,NA,NA,NA,NA,34
199,198,1,2,2,200,99,100,0.99,2,0.02,1,0.01,34
298,296,2,4,3,300,99,100,0.99,2,0.02,1,0.01,34
397,394,3,6,4,400,99,100,0.99,2,0.02,1,0.01,34
494,489,5,11,5,500,97,100,0.97,5,0.05,2,0.02,34
593,587,6,13,6,600,99,100,0.99,2,0.02,1,0.01,34
689,679,10,21,7,700,96,100,0.96,8,0.08,4,0.04,34
787,775,12,25,8,800,98,100,0.98,4,0.04,2,0.02,34
885,871,14,29,9,900,98,100,0.98,4,0.04,2,0.02,34
984,969,15,31,10,1000,99,100,0.99,2,0.02,1,0.01,34
1933,1876,57,124,11,2000,949,1000,0.949,93,0.093,42,0.042,34
2870,2775,95,225,12,3000,937,1000,0.937,101,0.101,38,0.038,34
3784,3625,159,375,13,4000,914,1000,0.914,150,0.15,64,0.064,34
4693,4476,217,524,14,5000,909,1000,0.909,149,0.149,58,0.058,34
5579,5287,292,713,15,6000,886,1000,0.886,189,0.189,75,0.075,34
6471,6110,361,890,16,7000,892,1000,0.892,177,0.177,69,0.069,34
7318,6856,462,1144,17,8000,847,1000,0.847,254,0.254,101,0.101,34
8156,7595,561,1405,18,9000,838,1000,0.838,261,0.261,99,0.099,34
8965,8288,677,1712,19,10000,809,1000,0.809,307,0.307,116,0.116,34
9785,9005,780,1995,20,11000,820,1000,0.82,283,0.283,103,0.103,34
10606,9712,894,2288,21,12000,821,1000,0.821,293,0.293,114,0.114,34
11419,10418,1001,2582,22,13000,813,1000,0.813,294,0.294,107,0.107,34
12225,11104,1121,2896,23,14000,806,1000,0.806,314,0.314,120,0.12,34
13005,11756,1249,3244,24,15000,780,1000,0.78,348,0.348,128,0.128,34
13793,12415,1378,3585,25,16000,788,1000,0.788,341,0.341,129,0.129,34
14586,13099,1487,3901,26,17000,793,1000,0.793,316,0.316,109,0.109,34
15361,13758,1603,4242,27,18000,775,1000,0.775,341,0.341,116,0.116,34
16158,14449,1709,4551,28,19000,797,1000,0.797,309,0.309,106,0.106,34
16904,15058,1846,4942,29,20000,746,1000,0.746,391,0.391,137,0.137,34
17663,15700,1963,5300,30,21000,759,1000,0.759,358,0.358,117,0.117,34
18391,16283,2108,5717,31,22000,728,1000,0.728,417,0.417,145,0.145,34
19123,16858,2265,6142,32,23000,732,1000,0.732,425,0.425,157,0.157,34
19867,17458,2409,6542,33,24000,744,1000,0.744,400,0.4,144,0.144,34
20586,18036,2550,6964,34,25000,719,1000,0.719,422,0.422,141,0.141,34
21269,18563,2706,7437,35,26000,683,1000,0.683,473,0.473,156,0.156,34
21978,19127,2851,7873,36,27000,709,1000,0.709,436,0.436,145,0.145,34
22674,19667,3007,8333,37,28000,696,1000,0.696,460,0.46,156,0.156,34
23381,20229,3152,8771,38,29000,707,1000,0.707,438,0.438,145,0.145,34
24094,20790,3304,9210,39,30000,713,1000,0.713,439,0.439,152,0.152,34
24793,21350,3443,9650,40,31000,699,1000,0.699,440,0.44,139,0.139,34
25457,21853,3604,10147,41,32000,664,1000,0.664,497,0.497,161,0.161,34
26130,22358,3772,10642,42,33000,673,1000,0.673,495,0.495,168,0.168,34
26821,22906,3915,11094,43,34000,691,1000,0.691,452,0.452,143,0.143,34
27489,23410,4079,11590,44,35000,668,1000,0.668,496,0.496,164,0.164,34
28161,23942,4219,12058,45,36000,672,1000,0.672,468,0.468,140,0.14,34
28828,24460,4368,12540,46,37000,667,1000,0.667,482,0.482,149,0.149,34
29498,24980,4518,13020,47,38000,670,1000,0.67,480,0.48,150,0.15,34
30162,25495,4667,13505,48,39000,664,1000,0.664,485,0.485,149,0.149,34
30809,25977,4832,14023,49,40000,647,1000,0.647,518,0.518,165,0.165,34
31480,26515,4965,14485,50,41000,671,1000,0.671,462,0.462,133,0.133,34
32121,27002,5119,14998,51,42000,641,1000,0.641,513,0.513,154,0.154,34
32765,27477,5288,15523,52,43000,644,1000,0.644,525,0.525,169,0.169,34
33400,27955,5445,16045,53,44000,635,1000,0.635,522,0.522,157,0.157,34
34041,28463,5578,16537,54,45000,641,1000,0.641,492,0.492,133,0.133,34
34651,28902,5749,17098,55,46000,610,1000,0.61,561,0.561,171,0.171,34
35283,29376,5907,17624,56,47000,632,1000,0.632,526,0.526,158,0.158,34
35888,29815,6073,18185,57,48000,605,1000,0.605,561,0.561,166,0.166,34
36499,30264,6235,18736,58,49000,611,1000,0.611,551,0.551,162,0.162,34
37126,30735,6391,19265,59,50000,627,1000,0.627,529,0.529,156,0.156,34
37743,31196,6547,19804,60,51000,617,1000,0.617,539,0.539,156,0.156,34
38338,31632,6706,20368,61,52000,595,1000,0.595,564,0.564,159,0.159,34
38952,32085,6867,20915,62,53000,614,1000,0.614,547,0.547,161,0.161,34
39568,32536,7032,21464,63,54000,616,1000,0.616,549,0.549,165,0.165,34
40179,32978,7201,22022,64,55000,611,1000,0.611,558,0.558,169,0.169,34
40811,33435,7376,22565,65,56000,632,1000,0.632,543,0.543,175,0.175,34
41422,33885,7537,23115,66,57000,611,1000,0.611,550,0.55,161,0.161,34
42010,34298,7712,23702,67,58000,588,1000,0.588,587,0.587,175,0.175,34
42595,34709,7886,24291,68,59000,585,1000,0.585,589,0.589,174,0.174,34
43200,35170,8030,24830,69,60000,605,1000,0.605,539,0.539,144,0.144,34
43797,35592,8205,25408,70,61000,597,1000,0.597,578,0.578,175,0.175,34
44390,36024,8366,25976,71,62000,593,1000,0.593,568,0.568,161,0.161,34
44968,36450,8518,26550,72,63000,578,1000,0.578,574,0.574,152,0.152,34
45551,36876,8675,27124,73,64000,583,1000,0.583,574,0.574,157,0.157,34
46130,37285,8845,27715,74,65000,579,1000,0.579,591,0.591,170,0.17,34
46721,37708,9013,28292,75,66000,591,1000,0.591,577,0.577,168,0.168,34
47278,38091,9187,28909,76,67000,557,1000,0.557,617,0.617,174,0.174,34
47847,38484,9363,29516,77,68000,569,1000,0.569,607,0.607,176,0.176,34
48398,38868,9530,30132,78,69000,551,1000,0.551,616,0.616,167,0.167,34
48958,39250,9708,30750,79,70000,560,1000,0.56,618,0.618,178,0.178,34
49518,39646,9872,31354,80,71000,560,1000,0.56,604,0.604,164,0.164,34
50080,40049,10031,31951,81,72000,562,1000,0.562,597,0.597,159,0.159,34
50642,40430,10212,32570,82,73000,562,1000,0.562,619,0.619,181,0.181,34
51202,40807,10395,33193,83,74000,560,1000,0.56,623,0.623,183,0.183,34
51747,41198,10549,33802,84,75000,545,1000,0.545,609,0.609,154,0.154,34
52302,41594,10708,34406,85,76000,555,1000,0.555,604,0.604,159,0.159,34
52802,41912,10890,35088,86,77000,500,1000,0.5,682,0.682,182,0.182,34
53337,42264,11073,35736,87,78000,535,1000,0.535,648,0.648,183,0.183,34
53899,42658,11241,36342,88,79000,562,1000,0.562,606,0.606,168,0.168,34
54447,43022,11425,36978,89,80000,548,1000,0.548,636,0.636,184,0.184,34
54974,43374,11600,37626,90,81000,527,1000,0.527,648,0.648,175,0.175,34
55492,43722,11770,38278,91,82000,518,1000,0.518,652,0.652,170,0.17,34
56043,44120,11923,38880,92,83000,551,1000,0.551,602,0.602,153,0.153,34
56563,44463,12100,39537,93,84000,520,1000,0.52,657,0.657,177,0.177,34
57116,44857,12259,40143,94,85000,553,1000,0.553,606,0.606,159,0.159,34
57663,45244,12419,40756,95,86000,547,1000,0.547,613,0.613,160,0.16,34
58178,45599,12579,41401,96,87000,515,1000,0.515,645,0.645,160,0.16,34
58712,45971,12741,42029,97,88000,534,1000,0.534,628,0.628,162,0.162,34
59226,46315,12911,42685,98,89000,514,1000,0.514,656,0.656,170,0.17,34
59760,46690,13070,43310,99,90000,534,1000,0.534,625,0.625,159,0.159,34
60253,47004,13249,43996,100,91000,493,1000,0.493,686,0.686,179,0.179,34
60773,47355,13418,44645,101,92000,520,1000,0.52,649,0.649,169,0.169,34
61248,47635,13613,45365,102,93000,475,1000,0.475,720,0.72,195,0.195,34
61746,47969,13777,46031,103,94000,498,1000,0.498,666,0.666,164,0.164,34
62271,48309,13962,46691,104,95000,525,1000,0.525,660,0.66,185,0.185,34
62793,48688,14105,47312,105,96000,522,1000,0.522,621,0.621,143,0.143,34
63301,49017,14284,47983,106,97000,508,1000,0.508,671,0.671,179,0.179,34
63798,49328,14470,48672,107,98000,497,1000,0.497,689,0.689,186,0.186,34
64291,49674,14617,49326,108,99000,493,1000,0.493,654,0.654,147,0.147,34
64789,49996,14793,50004,109,100000,498,1000,0.498,678,0.678,176,0.176,34
65311,50322,14989,50678,110,101000,522,1000,0.522,674,0.674,196,0.196,34
65821,50664,15157,51336,111,102000,510,1000,0.51,658,0.658,168,0.168,34
66318,50989,15329,52011,112,103000,497,1000,0.497,675,0.675,172,0.172,34
66814,51320,15494,52680,113,104000,496,1000,0.496,669,0.669,165,0.165,34
67294,51622,15672,53378,114,105000,480,1000,0.48,698,0.698,178,0.178,34
67772,51917,15855,54083,115,106000,478,1000,0.478,705,0.705,183,0.183,34
68271,52264,16007,54736,116,107000,499,1000,0.499,653,0.653,152,0.152,34
68752,52575,16177,55425,117,108000,481,1000,0.481,689,0.689,170,0.17,34
69245,52908,16337,56092,118,109000,493,1000,0.493,667,0.667,160,0.16,34
69738,53233,16505,56767,119,110000,493,1000,0.493,675,0.675,168,0.168,34
70246,53568,16678,57432,120,111000,508,1000,0.508,665,0.665,173,0.173,34
70720,53871,16849,58129,121,112000,474,1000,0.474,697,0.697,171,0.171,34
71223,54223,17000,58777,122,113000,503,1000,0.503,648,0.648,151,0.151,34
71710,54529,17181,59471,123,114000,487,1000,0.487,694,0.694,181,0.181,34
71869,54638,17231,59660,124,114298,159,298,0.5335570469798657,189,0.6342281879194631,50,0.16778523489932887,34
100,100,0,0,1,100,NA,NA,NA,NA,NA,NA,NA,35
200,200,0,0,2,200,100,100,1,0,0,0,0,35
300,300,0,0,3,300,100,100,1,0,0,0,0,35
398,396,2,4,4,400,98,100,0.98,4,0.04,2,0.02,35
498,496,2,4,5,500,100,100,1,0,0,0,0,35
592,584,8,16,6,600,94,100,0.94,12,0.12,6,0.06,35
689,678,11,22,7,700,97,100,0.97,6,0.06,3,0.03,35
787,775,12,25,8,800,98,100,0.98,3,0.03,1,0.01,35
883,868,15,32,9,900,96,100,0.96,7,0.07,3,0.03,35
977,957,20,43,10,1000,94,100,0.94,11,0.11,5,0.05,35
1934,1881,53,119,11,2000,957,1000,0.957,76,0.076,33,0.033,35
2879,2787,92,213,12,3000,945,1000,0.945,94,0.094,39,0.039,35
3792,3639,153,361,13,4000,913,1000,0.913,148,0.148,61,0.061,35
4694,4474,220,526,14,5000,902,1000,0.902,165,0.165,67,0.067,35
5566,5264,302,736,15,6000,872,1000,0.872,210,0.21,82,0.082,35
6440,6054,386,946,16,7000,874,1000,0.874,210,0.21,84,0.084,35
7311,6849,462,1151,17,8000,871,1000,0.871,205,0.205,76,0.076,35
8173,7629,544,1371,18,9000,862,1000,0.862,220,0.22,82,0.082,35
9023,8385,638,1615,19,10000,850,1000,0.85,244,0.244,94,0.094,35
9872,9144,728,1856,20,11000,849,1000,0.849,241,0.241,90,0.09,35
10678,9831,847,2169,21,12000,806,1000,0.806,313,0.313,119,0.119,35
11492,10543,949,2457,22,13000,814,1000,0.814,288,0.288,102,0.102,35
12307,11251,1056,2749,23,14000,815,1000,0.815,292,0.292,107,0.107,35
13110,11945,1165,3055,24,15000,803,1000,0.803,306,0.306,109,0.109,35
13891,12600,1291,3400,25,16000,781,1000,0.781,345,0.345,126,0.126,35
14668,13237,1431,3763,26,17000,777,1000,0.777,363,0.363,140,0.14,35
15439,13889,1550,4111,27,18000,771,1000,0.771,348,0.348,119,0.119,35
16204,14531,1673,4469,28,19000,765,1000,0.765,358,0.358,123,0.123,35
16970,15183,1787,4817,29,20000,766,1000,0.766,348,0.348,114,0.114,35
17719,15787,1932,5213,30,21000,749,1000,0.749,396,0.396,145,0.145,35
18454,16379,2075,5621,31,22000,735,1000,0.735,408,0.408,143,0.143,35
19195,16984,2211,6016,32,23000,741,1000,0.741,395,0.395,136,0.136,35
19925,17584,2341,6416,33,24000,730,1000,0.73,400,0.4,130,0.13,35
20631,18137,2494,6863,34,25000,706,1000,0.706,447,0.447,153,0.153,35
21326,18675,2651,7325,35,26000,695,1000,0.695,462,0.462,157,0.157,35
22030,19226,2804,7774,36,27000,704,1000,0.704,449,0.449,153,0.153,35
22733,19784,2949,8216,37,28000,703,1000,0.703,442,0.442,145,0.145,35
23445,20364,3081,8636,38,29000,712,1000,0.712,420,0.42,132,0.132,35
24145,20920,3225,9080,39,30000,700,1000,0.7,444,0.444,144,0.144,35
24843,21469,3374,9531,40,31000,698,1000,0.698,451,0.451,149,0.149,35
25529,22015,3514,9985,41,32000,686,1000,0.686,454,0.454,140,0.14,35
26216,22542,3674,10458,42,33000,687,1000,0.687,473,0.473,160,0.16,35
26890,23070,3820,10930,43,34000,674,1000,0.674,472,0.472,146,0.146,35
27552,23574,3978,11426,44,35000,662,1000,0.662,496,0.496,158,0.158,35
28247,24126,4121,11874,45,36000,695,1000,0.695,448,0.448,143,0.143,35
28928,24655,4273,12345,46,37000,681,1000,0.681,471,0.471,152,0.152,35
29595,25174,4421,12826,47,38000,667,1000,0.667,481,0.481,148,0.148,35
30263,25693,4570,13307,48,39000,668,1000,0.668,481,0.481,149,0.149,35
30891,26150,4741,13850,49,40000,628,1000,0.628,543,0.543,171,0.171,35
31581,26700,4881,14300,50,41000,690,1000,0.69,450,0.45,140,0.14,35
32225,27199,5026,14801,51,42000,644,1000,0.644,501,0.501,145,0.145,35
32880,27709,5171,15291,52,43000,655,1000,0.655,490,0.49,145,0.145,35
33517,28189,5328,15811,53,44000,637,1000,0.637,520,0.52,157,0.157,35
34158,28672,5486,16328,54,45000,641,1000,0.641,517,0.517,158,0.158,35
34806,29154,5652,16846,55,46000,648,1000,0.648,518,0.518,166,0.166,35
35429,29603,5826,17397,56,47000,623,1000,0.623,551,0.551,174,0.174,35
36061,30075,5986,17925,57,48000,632,1000,0.632,528,0.528,160,0.16,35
36664,30509,6155,18491,58,49000,603,1000,0.603,566,0.566,169,0.169,35
37258,30949,6309,19051,59,50000,594,1000,0.594,560,0.56,154,0.154,35
37847,31361,6486,19639,60,51000,589,1000,0.589,588,0.588,177,0.177,35
38434,31773,6661,20227,61,52000,587,1000,0.587,588,0.588,175,0.175,35
39056,32222,6834,20778,62,53000,622,1000,0.622,551,0.551,173,0.173,35
39653,32637,7016,21363,63,54000,597,1000,0.597,585,0.585,182,0.182,35
40236,33048,7188,21952,64,55000,583,1000,0.583,589,0.589,172,0.172,35
40823,33473,7350,22527,65,56000,587,1000,0.587,575,0.575,162,0.162,35
41414,33893,7521,23107,66,57000,591,1000,0.591,580,0.58,171,0.171,35
41997,34313,7684,23687,67,58000,583,1000,0.583,580,0.58,163,0.163,35
42590,34753,7837,24247,68,59000,593,1000,0.593,560,0.56,153,0.153,35
43161,35155,8006,24845,69,60000,571,1000,0.571,598,0.598,169,0.169,35
43714,35525,8189,25475,70,61000,553,1000,0.553,630,0.63,183,0.183,35
44304,35968,8336,26032,71,62000,590,1000,0.59,557,0.557,147,0.147,35
44893,36407,8486,26593,72,63000,589,1000,0.589,561,0.561,150,0.15,35
45477,36837,8640,27163,73,64000,584,1000,0.584,570,0.57,154,0.154,35
46082,37284,8798,27716,74,65000,605,1000,0.605,553,0.553,158,0.158,35
46662,37700,8962,28300,75,66000,580,1000,0.58,584,0.584,164,0.164,35
47238,38109,9129,28891,76,67000,576,1000,0.576,591,0.591,167,0.167,35
47813,38538,9275,29462,77,68000,575,1000,0.575,571,0.571,146,0.146,35
48373,38918,9455,30082,78,69000,560,1000,0.56,620,0.62,180,0.18,35
48934,39304,9630,30696,79,70000,561,1000,0.561,614,0.614,175,0.175,35
49504,39707,9797,31293,80,71000,570,1000,0.57,597,0.597,167,0.167,35
50048,40075,9973,31925,81,72000,544,1000,0.544,632,0.632,176,0.176,35
50629,40506,10123,32494,82,73000,581,1000,0.581,569,0.569,150,0.15,35
51178,40874,10304,33126,83,74000,549,1000,0.549,632,0.632,181,0.181,35
51737,41260,10477,33740,84,75000,559,1000,0.559,614,0.614,173,0.173,35
52315,41697,10618,34303,85,76000,578,1000,0.578,563,0.563,141,0.141,35
52870,42092,10778,34908,86,77000,555,1000,0.555,605,0.605,160,0.16,35
53414,42485,10929,35515,87,78000,544,1000,0.544,607,0.607,151,0.151,35
53948,42838,11110,36162,88,79000,534,1000,0.534,647,0.647,181,0.181,35
54481,43197,11284,36803,89,80000,533,1000,0.533,641,0.641,174,0.174,35
55030,43563,11467,37437,90,81000,549,1000,0.549,634,0.634,183,0.183,35
55585,43980,11605,38020,91,82000,555,1000,0.555,583,0.583,138,0.138,35
56115,44332,11783,38668,92,83000,530,1000,0.53,648,0.648,178,0.178,35
56636,44685,11951,39315,93,84000,521,1000,0.521,647,0.647,168,0.168,35
57143,45009,12134,39991,94,85000,507,1000,0.507,676,0.676,183,0.183,35
57675,45367,12308,40633,95,86000,532,1000,0.532,642,0.642,174,0.174,35
58197,45716,12481,41284,96,87000,522,1000,0.522,651,0.651,173,0.173,35
58722,46077,12645,41923,97,88000,525,1000,0.525,639,0.639,164,0.164,35
59254,46429,12825,42571,98,89000,532,1000,0.532,648,0.648,180,0.18,35
59773,46771,13002,43229,99,90000,519,1000,0.519,658,0.658,177,0.177,35
60294,47111,13183,43889,100,91000,521,1000,0.521,660,0.66,181,0.181,35
60799,47453,13346,44547,101,92000,505,1000,0.505,658,0.658,163,0.163,35
61326,47818,13508,45182,102,93000,527,1000,0.527,635,0.635,162,0.162,35
61825,48138,13687,45862,103,94000,499,1000,0.499,680,0.68,179,0.179,35
62337,48490,13847,46510,104,95000,512,1000,0.512,648,0.648,160,0.16,35
62853,48850,14003,47150,105,96000,516,1000,0.516,640,0.64,156,0.156,35
63358,49186,14172,47814,106,97000,505,1000,0.505,664,0.664,169,0.169,35
63855,49466,14389,48534,107,98000,497,1000,0.497,720,0.72,217,0.217,35
64337,49774,14563,49226,108,99000,482,1000,0.482,692,0.692,174,0.174,35
64846,50106,14740,49894,109,100000,509,1000,0.509,668,0.668,177,0.177,35
65344,50428,14916,50572,110,101000,498,1000,0.498,678,0.678,176,0.176,35
65836,50746,15090,51254,111,102000,492,1000,0.492,682,0.682,174,0.174,35
66328,51056,15272,51944,112,103000,492,1000,0.492,690,0.69,182,0.182,35
66813,51360,15453,52640,113,104000,485,1000,0.485,696,0.696,181,0.181,35
67348,51746,15602,53254,114,105000,535,1000,0.535,614,0.614,149,0.149,35
67839,52053,15786,53947,115,106000,491,1000,0.491,693,0.693,184,0.184,35
68336,52366,15970,54634,116,107000,497,1000,0.497,687,0.687,184,0.184,35
68818,52678,16140,55322,117,108000,482,1000,0.482,688,0.688,170,0.17,35
69299,52974,16325,56026,118,109000,481,1000,0.481,704,0.704,185,0.185,35
69794,53296,16498,56704,119,110000,495,1000,0.495,678,0.678,173,0.173,35
70273,53612,16661,57388,120,111000,479,1000,0.479,684,0.684,163,0.163,35
70757,53914,16843,58086,121,112000,484,1000,0.484,698,0.698,182,0.182,35
71248,54239,17009,58761,122,113000,491,1000,0.491,675,0.675,166,0.166,35
71716,54543,17173,59457,123,114000,468,1000,0.468,696,0.696,164,0.164,35
71869,54638,17231,59660,124,114298,153,298,0.5134228187919463,203,0.6812080536912751,58,0.19463087248322147,35
99,98,1,2,1,100,NA,NA,NA,NA,NA,NA,NA,36
199,198,1,2,2,200,100,100,1,0,0,0,0,36
298,296,2,4,3,300,99,100,0.99,2,0.02,1,0.01,36
397,394,3,6,4,400,99,100,0.99,2,0.02,1,0.01,36
496,492,4,8,5,500,99,100,0.99,2,0.02,1,0.01,36
596,592,4,8,6,600,100,100,1,0,0,0,0,36
693,687,6,13,7,700,97,100,0.97,5,0.05,2,0.02,36
790,782,8,18,8,800,97,100,0.97,5,0.05,2,0.02,36
887,876,11,24,9,900,97,100,0.97,6,0.06,3,0.03,36
985,972,13,28,10,1000,98,100,0.98,4,0.04,2,0.02,36
1937,1890,47,110,11,2000,952,1000,0.952,82,0.082,34,0.034,36
2880,2790,90,210,12,3000,943,1000,0.943,100,0.1,43,0.043,36
3806,3668,138,332,13,4000,926,1000,0.926,122,0.122,48,0.048,36
4715,4513,202,487,14,5000,909,1000,0.909,155,0.155,64,0.064,36
5599,5322,277,678,15,6000,884,1000,0.884,191,0.191,75,0.075,36
6470,6118,352,882,16,7000,871,1000,0.871,204,0.204,75,0.075,36
7325,6877,448,1123,17,8000,855,1000,0.855,241,0.241,96,0.096,36
8167,7616,551,1384,18,9000,842,1000,0.842,261,0.261,103,0.103,36
9025,8378,647,1622,19,10000,858,1000,0.858,238,0.238,96,0.096,36
9854,9096,758,1904,20,11000,829,1000,0.829,282,0.282,111,0.111,36
10665,9793,872,2207,21,12000,811,1000,0.811,303,0.303,114,0.114,36
11497,10536,961,2464,22,13000,832,1000,0.832,257,0.257,89,0.089,36
12292,11208,1084,2792,23,14000,795,1000,0.795,328,0.328,123,0.123,36
13092,11895,1197,3105,24,15000,800,1000,0.8,313,0.313,113,0.113,36
13854,12519,1335,3481,25,16000,762,1000,0.762,376,0.376,138,0.138,36
14626,13162,1464,3838,26,17000,772,1000,0.772,357,0.357,129,0.129,36
15397,13806,1591,4194,27,18000,771,1000,0.771,356,0.356,127,0.127,36
16165,14456,1709,4544,28,19000,768,1000,0.768,350,0.35,118,0.118,36
16924,15084,1840,4916,29,20000,759,1000,0.759,372,0.372,131,0.131,36
17655,15672,1983,5328,30,21000,731,1000,0.731,412,0.412,143,0.143,36
18398,16278,2120,5722,31,22000,743,1000,0.743,394,0.394,137,0.137,36
19139,16888,2251,6112,32,23000,741,1000,0.741,390,0.39,131,0.131,36
19894,17526,2368,6474,33,24000,755,1000,0.755,362,0.362,117,0.117,36
20628,18115,2513,6885,34,25000,734,1000,0.734,411,0.411,145,0.145,36
21333,18665,2668,7335,35,26000,705,1000,0.705,450,0.45,155,0.155,36
22062,19267,2795,7733,36,27000,729,1000,0.729,398,0.398,127,0.127,36
22759,19807,2952,8193,37,28000,697,1000,0.697,460,0.46,157,0.157,36
23457,20350,3107,8650,38,29000,698,1000,0.698,457,0.457,155,0.155,36
24147,20891,3256,9109,39,30000,690,1000,0.69,459,0.459,149,0.149,36
24866,21475,3391,9525,40,31000,719,1000,0.719,416,0.416,135,0.135,36
25586,22059,3527,9941,41,32000,720,1000,0.72,416,0.416,136,0.136,36
26253,22568,3685,10432,42,33000,667,1000,0.667,491,0.491,158,0.158,36
26915,23063,3852,10937,43,34000,662,1000,0.662,505,0.505,167,0.167,36
27599,23593,4006,11407,44,35000,684,1000,0.684,470,0.47,154,0.154,36
28269,24100,4169,11900,45,36000,670,1000,0.67,493,0.493,163,0.163,36
28945,24614,4331,12386,46,37000,676,1000,0.676,486,0.486,162,0.162,36
29608,25127,4481,12873,47,38000,663,1000,0.663,487,0.487,150,0.15,36
30281,25661,4620,13339,48,39000,673,1000,0.673,466,0.466,139,0.139,36
30929,26137,4792,13863,49,40000,648,1000,0.648,524,0.524,172,0.172,36
31573,26618,4955,14382,50,41000,644,1000,0.644,519,0.519,163,0.163,36
32205,27082,5123,14918,51,42000,632,1000,0.632,536,0.536,168,0.168,36
32836,27539,5297,15461,52,43000,631,1000,0.631,543,0.543,174,0.174,36
33478,28034,5444,15966,53,44000,642,1000,0.642,505,0.505,147,0.147,36
34088,28481,5607,16519,54,45000,610,1000,0.61,553,0.553,163,0.163,36
34712,28949,5763,17051,55,46000,624,1000,0.624,532,0.532,156,0.156,36
35323,29379,5944,17621,56,47000,611,1000,0.611,570,0.57,181,0.181,36
35949,29830,6119,18170,57,48000,626,1000,0.626,549,0.549,175,0.175,36
36580,30292,6288,18708,58,49000,631,1000,0.631,538,0.538,169,0.169,36
37201,30764,6437,19236,59,50000,621,1000,0.621,528,0.528,149,0.149,36
37803,31210,6593,19790,60,51000,602,1000,0.602,554,0.554,156,0.156,36
38405,31661,6744,20339,61,52000,602,1000,0.602,549,0.549,151,0.151,36
38994,32078,6916,20922,62,53000,589,1000,0.589,583,0.583,172,0.172,36
39586,32495,7091,21505,63,54000,592,1000,0.592,583,0.583,175,0.175,36
40182,32923,7259,22077,64,55000,596,1000,0.596,572,0.572,168,0.168,36
40760,33341,7419,22659,65,56000,578,1000,0.578,582,0.582,160,0.16,36
41345,33764,7581,23236,66,57000,585,1000,0.585,577,0.577,162,0.162,36
41924,34169,7755,23831,67,58000,579,1000,0.579,595,0.595,174,0.174,36
42523,34616,7907,24384,68,59000,599,1000,0.599,553,0.553,152,0.152,36
43098,35036,8062,24964,69,60000,575,1000,0.575,580,0.58,155,0.155,36
43647,35422,8225,25578,70,61000,549,1000,0.549,614,0.614,163,0.163,36
44259,35890,8369,26110,71,62000,612,1000,0.612,532,0.532,144,0.144,36
44854,36310,8544,26690,72,63000,595,1000,0.595,580,0.58,175,0.175,36
45433,36709,8724,27291,73,64000,579,1000,0.579,601,0.601,180,0.18,36
46006,37127,8879,27873,74,65000,573,1000,0.573,582,0.582,155,0.155,36
46576,37518,9058,28482,75,66000,570,1000,0.57,609,0.609,179,0.179,36
47161,37945,9216,29055,76,67000,585,1000,0.585,573,0.573,158,0.158,36
47710,38300,9410,29700,77,68000,549,1000,0.549,645,0.645,194,0.194,36
48283,38708,9575,30292,78,69000,573,1000,0.573,592,0.592,165,0.165,36
48856,39110,9746,30890,79,70000,573,1000,0.573,598,0.598,171,0.171,36
49403,39478,9925,31522,80,71000,547,1000,0.547,632,0.632,179,0.179,36
49947,39846,10101,32154,81,72000,544,1000,0.544,632,0.632,176,0.176,36
50520,40256,10264,32744,82,73000,573,1000,0.573,590,0.59,163,0.163,36
51071,40657,10414,33343,83,74000,551,1000,0.551,599,0.599,150,0.15,36
51645,41066,10579,33934,84,75000,574,1000,0.574,591,0.591,165,0.165,36
52219,41460,10759,34540,85,76000,574,1000,0.574,606,0.606,180,0.18,36
52758,41831,10927,35169,86,77000,539,1000,0.539,629,0.629,168,0.168,36
53304,42222,11082,35778,87,78000,546,1000,0.546,609,0.609,155,0.155,36
53841,42586,11255,36414,88,79000,537,1000,0.537,636,0.636,173,0.173,36
54401,42993,11408,37007,89,80000,560,1000,0.56,593,0.593,153,0.153,36
54936,43350,11586,37650,90,81000,535,1000,0.535,643,0.643,178,0.178,36
55475,43736,11739,38264,91,82000,539,1000,0.539,614,0.614,153,0.153,36
56006,44106,11900,38894,92,83000,531,1000,0.531,630,0.63,161,0.161,36
56548,44477,12071,39523,93,84000,542,1000,0.542,629,0.629,171,0.171,36
57094,44850,12244,40150,94,85000,546,1000,0.546,627,0.627,173,0.173,36
57635,45217,12418,40783,95,86000,541,1000,0.541,633,0.633,174,0.174,36
58152,45572,12580,41428,96,87000,517,1000,0.517,645,0.645,162,0.162,36
58685,45916,12769,42084,97,88000,533,1000,0.533,656,0.656,189,0.189,36
59206,46256,12950,42744,98,89000,521,1000,0.521,660,0.66,181,0.181,36
59730,46607,13123,43393,99,90000,524,1000,0.524,649,0.649,173,0.173,36
60249,46968,13281,44032,100,91000,519,1000,0.519,639,0.639,158,0.158,36
60756,47327,13429,44673,101,92000,507,1000,0.507,641,0.641,148,0.148,36
61258,47658,13600,45342,102,93000,502,1000,0.502,669,0.669,171,0.171,36
61727,47941,13786,46059,103,94000,469,1000,0.469,717,0.717,186,0.186,36
62238,48285,13953,46715,104,95000,511,1000,0.511,656,0.656,167,0.167,36
62761,48622,14139,47378,105,96000,523,1000,0.523,663,0.663,186,0.186,36
63281,48988,14293,48012,106,97000,520,1000,0.52,634,0.634,154,0.154,36
63765,49296,14469,48704,107,98000,484,1000,0.484,692,0.692,176,0.176,36
64261,49611,14650,49389,108,99000,496,1000,0.496,685,0.685,181,0.181,36
64798,50012,14786,49988,109,100000,537,1000,0.537,599,0.599,136,0.136,36
65320,50377,14943,50623,110,101000,522,1000,0.522,635,0.635,157,0.157,36
65819,50709,15110,51291,111,102000,499,1000,0.499,668,0.668,167,0.167,36
66306,51027,15279,51973,112,103000,487,1000,0.487,682,0.682,169,0.169,36
66800,51359,15441,52641,113,104000,494,1000,0.494,668,0.668,162,0.162,36
67293,51668,15625,53332,114,105000,493,1000,0.493,691,0.691,184,0.184,36
67808,52025,15783,53975,115,106000,515,1000,0.515,643,0.643,158,0.158,36
68295,52327,15968,54673,116,107000,487,1000,0.487,698,0.698,185,0.185,36
68802,52678,16124,55322,117,108000,507,1000,0.507,649,0.649,156,0.156,36
69289,52989,16300,56011,118,109000,487,1000,0.487,689,0.689,176,0.176,36
69790,53311,16479,56689,119,110000,501,1000,0.501,678,0.678,179,0.179,36
70297,53645,16652,57355,120,111000,507,1000,0.507,666,0.666,173,0.173,36
70772,53939,16833,58061,121,112000,475,1000,0.475,706,0.706,181,0.181,36
71233,54233,17000,58767,122,113000,461,1000,0.461,706,0.706,167,0.167,36
71710,54530,17180,59470,123,114000,477,1000,0.477,703,0.703,180,0.18,36
71869,54638,17231,59660,124,114298,159,298,0.5335570469798657,190,0.6375838926174496,51,0.17114093959731544,36
100,100,0,0,1,100,NA,NA,NA,NA,NA,NA,NA,37
199,198,1,2,2,200,99,100,0.99,2,0.02,1,0.01,37
297,294,3,6,3,300,98,100,0.98,4,0.04,2,0.02,37
396,392,4,8,4,400,99,100,0.99,2,0.02,1,0.01,37
496,492,4,8,5,500,100,100,1,0,0,0,0,37
594,589,5,11,6,600,98,100,0.98,3,0.03,1,0.01,37
693,687,6,13,7,700,99,100,0.99,2,0.02,1,0.01,37
791,784,7,16,8,800,98,100,0.98,3,0.03,1,0.01,37
887,877,10,23,9,900,96,100,0.96,7,0.07,3,0.03,37
981,967,14,33,10,1000,94,100,0.94,10,0.1,4,0.04,37
1951,1917,34,83,11,2000,970,1000,0.97,50,0.05,20,0.02,37
2885,2810,75,190,12,3000,934,1000,0.934,107,0.107,41,0.041,37
3788,3646,142,354,13,4000,903,1000,0.903,164,0.164,67,0.067,37
4679,4458,221,542,14,5000,891,1000,0.891,188,0.188,79,0.079,37
5567,5273,294,727,15,6000,888,1000,0.888,185,0.185,73,0.073,37
6435,6048,387,952,16,7000,868,1000,0.868,225,0.225,93,0.093,37
7289,6815,474,1185,17,8000,854,1000,0.854,233,0.233,87,0.087,37
8135,7569,566,1431,18,9000,846,1000,0.846,246,0.246,92,0.092,37
8978,8318,660,1682,19,10000,843,1000,0.843,251,0.251,94,0.094,37
9812,9050,762,1950,20,11000,834,1000,0.834,268,0.268,102,0.102,37
10635,9780,855,2220,21,12000,823,1000,0.823,270,0.27,93,0.093,37
11453,10493,960,2507,22,13000,818,1000,0.818,287,0.287,105,0.105,37
12237,11145,1092,2855,23,14000,784,1000,0.784,348,0.348,132,0.132,37
13028,11817,1211,3183,24,15000,791,1000,0.791,328,0.328,119,0.119,37
13836,12525,1311,3475,25,16000,808,1000,0.808,292,0.292,100,0.1,37
14619,13188,1431,3812,26,17000,783,1000,0.783,337,0.337,120,0.12,37
15379,13821,1558,4179,27,18000,760,1000,0.76,367,0.367,127,0.127,37
16149,14456,1693,4544,28,19000,770,1000,0.77,365,0.365,135,0.135,37
16913,15101,1812,4899,29,20000,764,1000,0.764,355,0.355,119,0.119,37
17650,15708,1942,5292,30,21000,737,1000,0.737,393,0.393,130,0.13,37
18399,16321,2078,5679,31,22000,749,1000,0.749,387,0.387,136,0.136,37
19129,16900,2229,6100,32,23000,730,1000,0.73,421,0.421,151,0.151,37
19822,17437,2385,6563,33,24000,693,1000,0.693,463,0.463,156,0.156,37
20551,18024,2527,6976,34,25000,729,1000,0.729,413,0.413,142,0.142,37
21287,18634,2653,7366,35,26000,736,1000,0.736,390,0.39,126,0.126,37
22013,19218,2795,7782,36,27000,726,1000,0.726,416,0.416,142,0.142,37
22726,19804,2922,8196,37,28000,713,1000,0.713,414,0.414,127,0.127,37
23422,20338,3084,8662,38,29000,696,1000,0.696,466,0.466,162,0.162,37
24111,20875,3236,9125,39,30000,689,1000,0.689,463,0.463,152,0.152,37
24799,21427,3372,9573,40,31000,688,1000,0.688,448,0.448,136,0.136,37
25502,22001,3501,9999,41,32000,703,1000,0.703,426,0.426,129,0.129,37
26192,22549,3643,10451,42,33000,690,1000,0.69,452,0.452,142,0.142,37
26898,23121,3777,10879,43,34000,706,1000,0.706,428,0.428,134,0.134,37
27555,23611,3944,11389,44,35000,657,1000,0.657,510,0.51,167,0.167,37
28231,24119,4112,11881,45,36000,676,1000,0.676,492,0.492,168,0.168,37
28898,24625,4273,12375,46,37000,667,1000,0.667,494,0.494,161,0.161,37
29557,25132,4425,12868,47,38000,659,1000,0.659,493,0.493,152,0.152,37
30221,25635,4586,13365,48,39000,664,1000,0.664,497,0.497,161,0.161,37
30883,26147,4736,13853,49,40000,662,1000,0.662,488,0.488,150,0.15,37
31525,26634,4891,14366,50,41000,642,1000,0.642,513,0.513,155,0.155,37
32183,27130,5053,14870,51,42000,658,1000,0.658,504,0.504,162,0.162,37
32860,27669,5191,15331,52,43000,677,1000,0.677,461,0.461,138,0.138,37
33492,28139,5353,15861,53,44000,632,1000,0.632,530,0.53,162,0.162,37
34112,28593,5519,16407,54,45000,620,1000,0.62,546,0.546,166,0.166,37
34728,29061,5667,16939,55,46000,616,1000,0.616,532,0.532,148,0.148,37
35363,29545,5818,17455,56,47000,635,1000,0.635,516,0.516,151,0.151,37
36002,30033,5969,17967,57,48000,639,1000,0.639,512,0.512,151,0.151,37
36623,30495,6128,18505,58,49000,621,1000,0.621,538,0.538,159,0.159,37
37243,30947,6296,19053,59,50000,620,1000,0.62,548,0.548,168,0.168,37
37853,31393,6460,19607,60,51000,610,1000,0.61,554,0.554,164,0.164,37
38483,31861,6622,20139,61,52000,630,1000,0.63,532,0.532,162,0.162,37
39076,32281,6795,20719,62,53000,593,1000,0.593,580,0.58,173,0.173,37
39690,32717,6973,21283,63,54000,614,1000,0.614,564,0.564,178,0.178,37
40267,33113,7154,21887,64,55000,577,1000,0.577,604,0.604,181,0.181,37
40868,33548,7320,22452,65,56000,601,1000,0.601,565,0.565,166,0.166,37
41479,33993,7486,23007,66,57000,611,1000,0.611,555,0.555,166,0.166,37
42073,34413,7660,23587,67,58000,594,1000,0.594,580,0.58,174,0.174,37
42673,34849,7824,24151,68,59000,600,1000,0.6,564,0.564,164,0.164,37
43265,35283,7982,24717,69,60000,592,1000,0.592,566,0.566,158,0.158,37
43845,35680,8165,25320,70,61000,580,1000,0.58,603,0.603,183,0.183,37
44431,36111,8320,25889,71,62000,586,1000,0.586,569,0.569,155,0.155,37
44995,36493,8502,26507,72,63000,564,1000,0.564,618,0.618,182,0.182,37
45568,36903,8665,27097,73,64000,573,1000,0.573,590,0.59,163,0.163,37
46123,37269,8854,27731,74,65000,555,1000,0.555,634,0.634,189,0.189,37
46736,37732,9004,28268,75,66000,613,1000,0.613,537,0.537,150,0.15,37
47295,38125,9170,28875,76,67000,559,1000,0.559,607,0.607,166,0.166,37
47846,38499,9347,29501,77,68000,551,1000,0.551,626,0.626,177,0.177,37
48407,38909,9498,30091,78,69000,561,1000,0.561,590,0.59,151,0.151,37
48956,39281,9675,30719,79,70000,549,1000,0.549,628,0.628,177,0.177,37
49502,39665,9837,31335,80,71000,546,1000,0.546,616,0.616,162,0.162,37
50063,40055,10008,31945,81,72000,561,1000,0.561,610,0.61,171,0.171,37
50653,40495,10158,32505,82,73000,590,1000,0.59,560,0.56,150,0.15,37
51196,40864,10332,33136,83,74000,543,1000,0.543,631,0.631,174,0.174,37
51732,41216,10516,33784,84,75000,536,1000,0.536,648,0.648,184,0.184,37
52278,41599,10679,34401,85,76000,546,1000,0.546,617,0.617,163,0.163,37
52827,41988,10839,35012,86,77000,549,1000,0.549,611,0.611,160,0.16,37
53383,42379,11004,35621,87,78000,556,1000,0.556,609,0.609,165,0.165,37
53891,42691,11200,36309,88,79000,508,1000,0.508,688,0.688,196,0.196,37
54446,43086,11360,36914,89,80000,555,1000,0.555,605,0.605,160,0.16,37
54967,43423,11544,37577,90,81000,521,1000,0.521,663,0.663,184,0.184,37
55496,43789,11707,38211,91,82000,529,1000,0.529,634,0.634,163,0.163,37
56045,44180,11865,38820,92,83000,549,1000,0.549,609,0.609,158,0.158,37
56564,44542,12022,39458,93,84000,519,1000,0.519,638,0.638,157,0.157,37
57098,44895,12203,40105,94,85000,534,1000,0.534,647,0.647,181,0.181,37
57638,45271,12367,40729,95,86000,540,1000,0.54,624,0.624,164,0.164,37
58162,45625,12537,41375,96,87000,524,1000,0.524,646,0.646,170,0.17,37
58699,45990,12709,42010,97,88000,537,1000,0.537,635,0.635,172,0.172,37
59210,46320,12890,42680,98,89000,511,1000,0.511,670,0.67,181,0.181,37
59730,46668,13062,43332,99,90000,520,1000,0.52,652,0.652,172,0.172,37
60254,47017,13237,43983,100,91000,524,1000,0.524,651,0.651,175,0.175,37
60748,47353,13395,44647,101,92000,494,1000,0.494,664,0.664,158,0.158,37
61273,47715,13558,45285,102,93000,525,1000,0.525,638,0.638,163,0.163,37
61771,48026,13745,45974,103,94000,498,1000,0.498,689,0.689,187,0.187,37
62292,48356,13936,46644,104,95000,521,1000,0.521,670,0.67,191,0.191,37
62817,48717,14100,47283,105,96000,525,1000,0.525,639,0.639,164,0.164,37
63335,49076,14259,47924,106,97000,518,1000,0.518,641,0.641,159,0.159,37
63836,49389,14447,48611,107,98000,501,1000,0.501,687,0.687,188,0.188,37
64362,49764,14598,49236,108,99000,526,1000,0.526,625,0.625,151,0.151,37
64861,50111,14750,49889,109,100000,499,1000,0.499,653,0.653,152,0.152,37
65375,50453,14922,50547,110,101000,514,1000,0.514,658,0.658,172,0.172,37
65867,50776,15091,51224,111,102000,492,1000,0.492,677,0.677,169,0.169,37
66391,51149,15242,51851,112,103000,524,1000,0.524,627,0.627,151,0.151,37
66872,51455,15417,52545,113,104000,481,1000,0.481,694,0.694,175,0.175,37
67360,51779,15581,53221,114,105000,488,1000,0.488,676,0.676,164,0.164,37
67854,52080,15774,53920,115,106000,494,1000,0.494,699,0.699,193,0.193,37
68348,52402,15946,54598,116,107000,494,1000,0.494,678,0.678,172,0.172,37
68826,52704,16122,55296,117,108000,478,1000,0.478,698,0.698,176,0.176,37
69325,53033,16292,55967,118,109000,499,1000,0.499,671,0.671,170,0.17,37
69808,53339,16469,56661,119,110000,483,1000,0.483,694,0.694,177,0.177,37
70297,53668,16629,57332,120,111000,489,1000,0.489,671,0.671,160,0.16,37
70796,53993,16803,58007,121,112000,499,1000,0.499,675,0.675,174,0.174,37
71276,54287,16989,58713,122,113000,480,1000,0.48,706,0.706,186,0.186,37
71737,54563,17174,59437,123,114000,461,1000,0.461,724,0.724,185,0.185,37
71869,54638,17231,59660,124,114298,132,298,0.4429530201342282,223,0.7483221476510067,57,0.1912751677852349,37
100,100,0,0,1,100,NA,NA,NA,NA,NA,NA,NA,38
200,200,0,0,2,200,100,100,1,0,0,0,0,38
299,298,1,2,3,300,99,100,0.99,2,0.02,1,0.01,38
398,396,2,4,4,400,99,100,0.99,2,0.02,1,0.01,38
495,490,5,10,5,500,97,100,0.97,6,0.06,3,0.03,38
594,588,6,12,6,600,99,100,0.99,2,0.02,1,0.01,38
693,686,7,14,7,700,99,100,0.99,2,0.02,1,0.01,38
786,774,12,26,8,800,93,100,0.93,12,0.12,5,0.05,38
884,872,12,28,9,900,98,100,0.98,2,0.02,0,0,38
977,959,18,41,10,1000,93,100,0.93,13,0.13,6,0.06,38
1939,1892,47,108,11,2000,962,1000,0.962,67,0.067,29,0.029,38
2888,2799,89,201,12,3000,949,1000,0.949,93,0.093,42,0.042,38
3803,3645,158,355,13,4000,915,1000,0.915,154,0.154,69,0.069,38
4709,4486,223,514,14,5000,906,1000,0.906,159,0.159,65,0.065,38
5606,5324,282,676,15,6000,897,1000,0.897,162,0.162,59,0.059,38
6483,6124,359,876,16,7000,877,1000,0.877,200,0.2,77,0.077,38
7342,6897,445,1103,17,8000,859,1000,0.859,227,0.227,86,0.086,38
8210,7685,525,1315,18,9000,868,1000,0.868,212,0.212,80,0.08,38
9043,8408,635,1592,19,10000,833,1000,0.833,277,0.277,110,0.11,38
9891,9157,734,1843,20,11000,848,1000,0.848,251,0.251,99,0.099,38
10703,9864,839,2136,21,12000,812,1000,0.812,293,0.293,105,0.105,38
11524,10586,938,2414,22,13000,821,1000,0.821,278,0.278,99,0.099,38
12328,11277,1051,2723,23,14000,804,1000,0.804,309,0.309,113,0.113,38
13125,11954,1171,3046,24,15000,797,1000,0.797,323,0.323,120,0.12,38
13919,12633,1286,3367,25,16000,794,1000,0.794,321,0.321,115,0.115,38
14687,13268,1419,3732,26,17000,768,1000,0.768,365,0.365,133,0.133,38
15457,13920,1537,4080,27,18000,770,1000,0.77,348,0.348,118,0.118,38
16249,14607,1642,4393,28,19000,792,1000,0.792,313,0.313,105,0.105,38
16992,15210,1782,4790,29,20000,743,1000,0.743,397,0.397,140,0.14,38
17726,15804,1922,5196,30,21000,734,1000,0.734,406,0.406,140,0.14,38
18470,16417,2053,5583,31,22000,744,1000,0.744,387,0.387,131,0.131,38
19214,17028,2186,5972,32,23000,744,1000,0.744,389,0.389,133,0.133,38
19952,17640,2312,6360,33,24000,738,1000,0.738,388,0.388,126,0.126,38
20680,18237,2443,6763,34,25000,728,1000,0.728,403,0.403,131,0.131,38
21399,18824,2575,7176,35,26000,719,1000,0.719,413,0.413,132,0.132,38
22106,19390,2716,7610,36,27000,707,1000,0.707,434,0.434,141,0.141,38
22797,19925,2872,8075,37,28000,691,1000,0.691,465,0.465,156,0.156,38
23485,20460,3025,8540,38,29000,688,1000,0.688,465,0.465,153,0.153,38
24175,21000,3175,9000,39,30000,690,1000,0.69,460,0.46,150,0.15,38
24879,21555,3324,9445,40,31000,704,1000,0.704,445,0.445,149,0.149,38
25562,22093,3469,9907,41,32000,683,1000,0.683,462,0.462,145,0.145,38
26236,22615,3621,10385,42,33000,674,1000,0.674,478,0.478,152,0.152,38
26906,23123,3783,10877,43,34000,670,1000,0.67,492,0.492,162,0.162,38
27586,23653,3933,11347,44,35000,680,1000,0.68,470,0.47,150,0.15,38
28248,24160,4088,11840,45,36000,662,1000,0.662,493,0.493,155,0.155,38
28906,24663,4243,12337,46,37000,658,1000,0.658,497,0.497,155,0.155,38
29587,25199,4388,12801,47,38000,681,1000,0.681,464,0.464,145,0.145,38
30267,25743,4524,13257,48,39000,680,1000,0.68,456,0.456,136,0.136,38
30911,26222,4689,13778,49,40000,644,1000,0.644,521,0.521,165,0.165,38
31576,26721,4855,14279,50,41000,665,1000,0.665,501,0.501,166,0.166,38
32238,27225,5013,14775,51,42000,662,1000,0.662,496,0.496,158,0.158,38
32874,27686,5188,15314,52,43000,636,1000,0.636,539,0.539,175,0.175,38
33468,28121,5347,15879,53,44000,594,1000,0.594,565,0.565,159,0.159,38
34085,28567,5518,16433,54,45000,617,1000,0.617,554,0.554,171,0.171,38
34699,29013,5686,16987,55,46000,614,1000,0.614,554,0.554,168,0.168,38
35328,29495,5833,17505,56,47000,629,1000,0.629,518,0.518,147,0.147,38
35939,29947,5992,18053,57,48000,611,1000,0.611,548,0.548,159,0.159,38
36544,30375,6169,18625,58,49000,605,1000,0.605,572,0.572,177,0.177,38
37142,30793,6349,19207,59,50000,598,1000,0.598,582,0.582,180,0.18,38
37758,31234,6524,19766,60,51000,616,1000,0.616,559,0.559,175,0.175,38
38373,31693,6680,20307,61,52000,615,1000,0.615,541,0.541,156,0.156,38
38989,32143,6846,20857,62,53000,616,1000,0.616,550,0.55,166,0.166,38
39618,32612,7006,21388,63,54000,629,1000,0.629,531,0.531,160,0.16,38
40209,33023,7186,21977,64,55000,591,1000,0.591,589,0.589,180,0.18,38
40838,33494,7344,22506,65,56000,629,1000,0.629,529,0.529,158,0.158,38
41431,33913,7518,23087,66,57000,593,1000,0.593,581,0.581,174,0.174,38
42043,34363,7680,23637,67,58000,612,1000,0.612,550,0.55,162,0.162,38
42637,34778,7859,24222,68,59000,594,1000,0.594,585,0.585,179,0.179,38
43245,35220,8025,24780,69,60000,608,1000,0.608,558,0.558,166,0.166,38
43834,35660,8174,25340,70,61000,589,1000,0.589,560,0.56,149,0.149,38
44429,36089,8340,25911,71,62000,595,1000,0.595,571,0.571,166,0.166,38
45018,36511,8507,26489,72,63000,589,1000,0.589,578,0.578,167,0.167,38
45569,36881,8688,27119,73,64000,551,1000,0.551,630,0.63,181,0.181,38
46136,37270,8866,27730,74,65000,567,1000,0.567,611,0.611,178,0.178,38
46700,37676,9024,28324,75,66000,564,1000,0.564,594,0.594,158,0.158,38
47295,38122,9173,28878,76,67000,595,1000,0.595,554,0.554,149,0.149,38
47885,38560,9325,29440,77,68000,590,1000,0.59,562,0.562,152,0.152,38
48444,38941,9503,30059,78,69000,559,1000,0.559,619,0.619,178,0.178,38
49018,39337,9681,30663,79,70000,574,1000,0.574,604,0.604,178,0.178,38
49576,39714,9862,31286,80,71000,558,1000,0.558,623,0.623,181,0.181,38
50129,40109,10020,31891,81,72000,553,1000,0.553,605,0.605,158,0.158,38
50694,40508,10186,32492,82,73000,565,1000,0.565,601,0.601,166,0.166,38
51228,40863,10365,33137,83,74000,534,1000,0.534,645,0.645,179,0.179,38
51791,41266,10525,33734,84,75000,563,1000,0.563,597,0.597,160,0.16,38
52352,41674,10678,34326,85,76000,561,1000,0.561,592,0.592,153,0.153,38
52912,42076,10836,34924,86,77000,560,1000,0.56,598,0.598,158,0.158,38
53433,42400,11033,35600,87,78000,521,1000,0.521,676,0.676,197,0.197,38
53989,42794,11195,36206,88,79000,556,1000,0.556,606,0.606,162,0.162,38
54539,43174,11365,36826,89,80000,550,1000,0.55,620,0.62,170,0.17,38
55118,43587,11531,37413,90,81000,579,1000,0.579,587,0.587,166,0.166,38
55657,43951,11706,38049,91,82000,539,1000,0.539,636,0.636,175,0.175,38
56158,44273,11885,38727,92,83000,501,1000,0.501,678,0.678,179,0.179,38
56707,44660,12047,39340,93,84000,549,1000,0.549,613,0.613,162,0.162,38
57248,45032,12216,39968,94,85000,541,1000,0.541,628,0.628,169,0.169,38
57771,45382,12389,40618,95,86000,523,1000,0.523,650,0.65,173,0.173,38
58296,45737,12559,41263,96,87000,525,1000,0.525,645,0.645,170,0.17,38
58814,46074,12740,41926,97,88000,518,1000,0.518,663,0.663,181,0.181,38
59302,46370,12932,42630,98,89000,488,1000,0.488,704,0.704,192,0.192,38
59815,46704,13111,43296,99,90000,513,1000,0.513,666,0.666,179,0.179,38
60328,47058,13270,43942,100,91000,513,1000,0.513,646,0.646,159,0.159,38
60843,47421,13422,44579,101,92000,515,1000,0.515,637,0.637,152,0.152,38
61375,47792,13583,45208,102,93000,532,1000,0.532,629,0.629,161,0.161,38
61901,48148,13753,45852,103,94000,526,1000,0.526,644,0.644,170,0.17,38
62372,48442,13930,46558,104,95000,471,1000,0.471,706,0.706,177,0.177,38
62880,48764,14116,47236,105,96000,508,1000,0.508,678,0.678,186,0.186,38
63388,49094,14294,47906,106,97000,508,1000,0.508,670,0.67,178,0.178,38
63889,49421,14468,48579,107,98000,501,1000,0.501,673,0.673,174,0.174,38
64388,49751,14637,49249,108,99000,499,1000,0.499,670,0.67,169,0.169,38
64884,50093,14791,49907,109,100000,496,1000,0.496,658,0.658,154,0.154,38
65389,50435,14954,50565,110,101000,505,1000,0.505,658,0.658,163,0.163,38
65872,50737,15135,51263,111,102000,483,1000,0.483,698,0.698,181,0.181,38
66368,51063,15305,51937,112,103000,496,1000,0.496,674,0.674,170,0.17,38
66896,51443,15453,52557,113,104000,528,1000,0.528,620,0.62,148,0.148,38
67413,51797,15616,53203,114,105000,517,1000,0.517,646,0.646,163,0.163,38
67888,52078,15810,53922,115,106000,475,1000,0.475,719,0.719,194,0.194,38
68380,52401,15979,54599,116,107000,492,1000,0.492,677,0.677,169,0.169,38
68865,52709,16156,55291,117,108000,485,1000,0.485,692,0.692,177,0.177,38
69338,52990,16348,56010,118,109000,473,1000,0.473,719,0.719,192,0.192,38
69795,53279,16516,56721,119,110000,457,1000,0.457,711,0.711,168,0.168,38
70292,53626,16666,57374,120,111000,497,1000,0.497,653,0.653,150,0.15,38
70763,53923,16840,58077,121,112000,471,1000,0.471,703,0.703,174,0.174,38
71236,54218,17018,58782,122,113000,473,1000,0.473,705,0.705,178,0.178,38
71718,54538,17180,59462,123,114000,482,1000,0.482,680,0.68,162,0.162,38
71869,54638,17231,59660,124,114298,151,298,0.5067114093959731,198,0.6644295302013423,51,0.17114093959731544,38
100,100,0,0,1,100,NA,NA,NA,NA,NA,NA,NA,39
199,198,1,2,2,200,99,100,0.99,2,0.02,1,0.01,39
299,298,1,2,3,300,100,100,1,0,0,0,0,39
397,394,3,6,4,400,98,100,0.98,4,0.04,2,0.02,39
497,494,3,6,5,500,100,100,1,0,0,0,0,39
594,588,6,12,6,600,97,100,0.97,6,0.06,3,0.03,39
692,685,7,15,7,700,98,100,0.98,3,0.03,1,0.01,39
788,777,11,23,8,800,96,100,0.96,8,0.08,4,0.04,39
886,873,13,27,9,900,98,100,0.98,4,0.04,2,0.02,39
986,973,13,27,10,1000,100,100,1,0,0,0,0,39
1943,1897,46,103,11,2000,957,1000,0.957,76,0.076,33,0.033,39
2864,2761,103,239,12,3000,921,1000,0.921,136,0.136,57,0.057,39
3765,3594,171,406,13,4000,901,1000,0.901,167,0.167,68,0.068,39
4661,4422,239,578,14,5000,896,1000,0.896,172,0.172,68,0.068,39
5557,5252,305,748,15,6000,896,1000,0.896,170,0.17,66,0.066,39
6421,6033,388,967,16,7000,864,1000,0.864,219,0.219,83,0.083,39
7279,6798,481,1202,17,8000,858,1000,0.858,235,0.235,93,0.093,39
8120,7526,594,1474,18,9000,841,1000,0.841,272,0.272,113,0.113,39
8977,8295,682,1705,19,10000,857,1000,0.857,231,0.231,88,0.088,39
9785,8980,805,2020,20,11000,808,1000,0.808,315,0.315,123,0.123,39
10593,9677,916,2323,21,12000,808,1000,0.808,303,0.303,111,0.111,39
11406,10385,1021,2615,22,13000,813,1000,0.813,292,0.292,105,0.105,39
12207,11077,1130,2923,23,14000,801,1000,0.801,308,0.308,109,0.109,39
12995,11733,1262,3267,24,15000,788,1000,0.788,344,0.344,132,0.132,39
13778,12396,1382,3604,25,16000,783,1000,0.783,337,0.337,120,0.12,39
14564,13074,1490,3926,26,17000,786,1000,0.786,322,0.322,108,0.108,39
15328,13723,1605,4277,27,18000,764,1000,0.764,351,0.351,115,0.115,39
16112,14393,1719,4607,28,19000,784,1000,0.784,330,0.33,114,0.114,39
16866,15008,1858,4992,29,20000,754,1000,0.754,385,0.385,139,0.139,39
17614,15619,1995,5381,30,21000,748,1000,0.748,389,0.389,137,0.137,39
18376,16258,2118,5742,31,22000,762,1000,0.762,361,0.361,123,0.123,39
19111,16858,2253,6142,32,23000,735,1000,0.735,400,0.4,135,0.135,39
19817,17414,2403,6586,33,24000,706,1000,0.706,444,0.444,150,0.15,39
20541,17988,2553,7012,34,25000,724,1000,0.724,426,0.426,150,0.15,39
21251,18562,2689,7438,35,26000,710,1000,0.71,426,0.426,136,0.136,39
21964,19132,2832,7868,36,27000,713,1000,0.713,430,0.43,143,0.143,39
22693,19719,2974,8281,37,28000,729,1000,0.729,413,0.413,142,0.142,39
23394,20273,3121,8727,38,29000,701,1000,0.701,446,0.446,147,0.147,39
24095,20816,3279,9184,39,30000,701,1000,0.701,457,0.457,158,0.158,39
24792,21376,3416,9624,40,31000,697,1000,0.697,440,0.44,137,0.137,39
25470,21901,3569,10099,41,32000,678,1000,0.678,475,0.475,153,0.153,39
26156,22427,3729,10573,42,33000,686,1000,0.686,474,0.474,160,0.16,39
26856,22981,3875,11019,43,34000,700,1000,0.7,446,0.446,146,0.146,39
27542,23524,4018,11476,44,35000,686,1000,0.686,457,0.457,143,0.143,39
28223,24064,4159,11936,45,36000,681,1000,0.681,460,0.46,141,0.141,39
28866,24520,4346,12480,46,37000,643,1000,0.643,544,0.544,187,0.187,39
29549,25053,4496,12947,47,38000,683,1000,0.683,467,0.467,150,0.15,39
30192,25523,4669,13477,48,39000,643,1000,0.643,530,0.53,173,0.173,39
30847,26026,4821,13974,49,40000,655,1000,0.655,497,0.497,152,0.152,39
31488,26507,4981,14493,50,41000,641,1000,0.641,519,0.519,160,0.16,39
32147,27023,5124,14977,51,42000,659,1000,0.659,484,0.484,143,0.143,39
32806,27534,5272,15466,52,43000,659,1000,0.659,489,0.489,148,0.148,39
33433,27994,5439,16006,53,44000,627,1000,0.627,540,0.54,167,0.167,39
34046,28430,5616,16570,54,45000,613,1000,0.613,564,0.564,177,0.177,39
34703,28931,5772,17069,55,46000,657,1000,0.657,499,0.499,156,0.156,39
35372,29459,5913,17541,56,47000,669,1000,0.669,472,0.472,141,0.141,39
35978,29898,6080,18102,57,48000,606,1000,0.606,561,0.561,167,0.167,39
36590,30345,6245,18655,58,49000,612,1000,0.612,553,0.553,165,0.165,39
37211,30813,6398,19187,59,50000,621,1000,0.621,532,0.532,153,0.153,39
37817,31239,6578,19761,60,51000,606,1000,0.606,574,0.574,180,0.18,39
38425,31701,6724,20299,61,52000,608,1000,0.608,538,0.538,146,0.146,39
39022,32131,6891,20869,62,53000,597,1000,0.597,570,0.57,167,0.167,39
39616,32572,7044,21428,63,54000,594,1000,0.594,559,0.559,153,0.153,39
40197,32971,7226,22029,64,55000,581,1000,0.581,601,0.601,182,0.182,39
40785,33399,7386,22601,65,56000,588,1000,0.588,572,0.572,160,0.16,39
41371,33810,7561,23190,66,57000,586,1000,0.586,589,0.589,175,0.175,39
41958,34235,7723,23765,67,58000,587,1000,0.587,575,0.575,162,0.162,39
42547,34671,7876,24329,68,59000,589,1000,0.589,564,0.564,153,0.153,39
43121,35080,8041,24920,69,60000,574,1000,0.574,591,0.591,165,0.165,39
43699,35492,8207,25508,70,61000,578,1000,0.578,588,0.588,166,0.166,39
44258,35886,8372,26114,71,62000,559,1000,0.559,606,0.606,165,0.165,39
44857,36321,8536,26679,72,63000,599,1000,0.599,565,0.565,164,0.164,39
45428,36721,8707,27279,73,64000,571,1000,0.571,600,0.6,171,0.171,39
45998,37125,8873,27875,74,65000,570,1000,0.57,596,0.596,166,0.166,39
46594,37567,9027,28433,75,66000,596,1000,0.596,558,0.558,154,0.154,39
47174,38002,9172,28998,76,67000,580,1000,0.58,565,0.565,145,0.145,39
47720,38379,9341,29621,77,68000,546,1000,0.546,623,0.623,169,0.169,39
48301,38793,9508,30207,78,69000,581,1000,0.581,586,0.586,167,0.167,39
48856,39173,9683,30827,79,70000,555,1000,0.555,620,0.62,175,0.175,39
49388,39528,9860,31472,80,71000,532,1000,0.532,645,0.645,177,0.177,39
49942,39907,10035,32093,81,72000,554,1000,0.554,621,0.621,175,0.175,39
50513,40297,10216,32703,82,73000,571,1000,0.571,610,0.61,181,0.181,39
51075,40684,10391,33316,83,74000,562,1000,0.562,613,0.613,175,0.175,39
51646,41082,10564,33918,84,75000,571,1000,0.571,602,0.602,173,0.173,39
52213,41491,10722,34509,85,76000,567,1000,0.567,591,0.591,158,0.158,39
52752,41865,10887,35135,86,77000,539,1000,0.539,626,0.626,165,0.165,39
53290,42226,11064,35774,87,78000,538,1000,0.538,639,0.639,177,0.177,39
53840,42601,11239,36399,88,79000,550,1000,0.55,625,0.625,175,0.175,39
54383,42999,11384,37001,89,80000,543,1000,0.543,602,0.602,145,0.145,39
54909,43352,11557,37648,90,81000,526,1000,0.526,647,0.647,173,0.173,39
55468,43744,11724,38256,91,82000,559,1000,0.559,608,0.608,167,0.167,39
55996,44095,11901,38905,92,83000,528,1000,0.528,649,0.649,177,0.177,39
56532,44470,12062,39530,93,84000,536,1000,0.536,625,0.625,161,0.161,39
57073,44850,12223,40150,94,85000,541,1000,0.541,620,0.62,161,0.161,39
57584,45181,12403,40819,95,86000,511,1000,0.511,669,0.669,180,0.18,39
58096,45528,12568,41472,96,87000,512,1000,0.512,653,0.653,165,0.165,39
58656,45938,12718,42062,97,88000,560,1000,0.56,590,0.59,150,0.15,39
59183,46285,12898,42715,98,89000,527,1000,0.527,653,0.653,180,0.18,39
59705,46628,13077,43372,99,90000,522,1000,0.522,657,0.657,179,0.179,39
60223,46977,13246,44023,100,91000,518,1000,0.518,651,0.651,169,0.169,39
60743,47339,13404,44661,101,92000,520,1000,0.52,638,0.638,158,0.158,39
61268,47708,13560,45292,102,93000,525,1000,0.525,631,0.631,156,0.156,39
61782,48055,13727,45945,103,94000,514,1000,0.514,653,0.653,167,0.167,39
62318,48403,13915,46597,104,95000,536,1000,0.536,652,0.652,188,0.188,39
62817,48751,14066,47249,105,96000,499,1000,0.499,652,0.652,151,0.151,39
63313,49071,14242,47929,106,97000,496,1000,0.496,680,0.68,176,0.176,39
63826,49395,14431,48605,107,98000,513,1000,0.513,676,0.676,189,0.189,39
64347,49748,14599,49252,108,99000,521,1000,0.521,647,0.647,168,0.168,39
64849,50069,14780,49931,109,100000,502,1000,0.502,679,0.679,181,0.181,39
65336,50380,14956,50620,110,101000,487,1000,0.487,689,0.689,176,0.176,39
65837,50710,15127,51290,111,102000,501,1000,0.501,670,0.67,171,0.171,39
66336,51020,15316,51980,112,103000,499,1000,0.499,690,0.69,189,0.189,39
66853,51375,15478,52625,113,104000,517,1000,0.517,645,0.645,162,0.162,39
67353,51715,15638,53285,114,105000,500,1000,0.5,660,0.66,160,0.16,39
67842,52013,15829,53987,115,106000,489,1000,0.489,702,0.702,191,0.191,39
68342,52349,15993,54651,116,107000,500,1000,0.5,664,0.664,164,0.164,39
68841,52678,16163,55322,117,108000,499,1000,0.499,671,0.671,170,0.17,39
69332,52984,16348,56016,118,109000,491,1000,0.491,694,0.694,185,0.185,39
69793,53267,16526,56733,119,110000,461,1000,0.461,717,0.717,178,0.178,39
70290,53592,16698,57408,120,111000,497,1000,0.497,675,0.675,172,0.172,39
70778,53935,16843,58065,121,112000,488,1000,0.488,657,0.657,145,0.145,39
71274,54251,17023,58749,122,113000,496,1000,0.496,684,0.684,180,0.18,39
71738,54553,17185,59447,123,114000,464,1000,0.464,698,0.698,162,0.162,39
71869,54638,17231,59660,124,114298,131,298,0.4395973154362416,213,0.714765100671141,46,0.15436241610738255,39
100,100,0,0,1,100,NA,NA,NA,NA,NA,NA,NA,40
200,200,0,0,2,200,100,100,1,0,0,0,0,40
299,298,1,2,3,300,99,100,0.99,2,0.02,1,0.01,40
399,398,1,2,4,400,100,100,1,0,0,0,0,40
498,497,1,3,5,500,99,100,0.99,1,0.01,0,0,40
594,589,5,11,6,600,96,100,0.96,8,0.08,4,0.04,40
692,685,7,15,7,700,98,100,0.98,4,0.04,2,0.02,40
789,779,10,21,8,800,97,100,0.97,6,0.06,3,0.03,40
886,873,13,27,9,900,97,100,0.97,6,0.06,3,0.03,40
986,973,13,27,10,1000,100,100,1,0,0,0,0,40
1931,1875,56,125,11,2000,945,1000,0.945,98,0.098,43,0.043,40
2867,2768,99,232,12,3000,936,1000,0.936,107,0.107,43,0.043,40
3774,3614,160,386,13,4000,907,1000,0.907,154,0.154,61,0.061,40
4667,4429,238,571,14,5000,893,1000,0.893,185,0.185,78,0.078,40
5573,5268,305,732,15,6000,906,1000,0.906,161,0.161,67,0.067,40
6440,6057,383,943,16,7000,867,1000,0.867,211,0.211,78,0.078,40
7315,6854,461,1146,17,8000,875,1000,0.875,203,0.203,78,0.078,40
8160,7604,556,1396,18,9000,845,1000,0.845,250,0.25,95,0.095,40
8990,8335,655,1665,19,10000,830,1000,0.83,269,0.269,99,0.099,40
9804,9045,759,1955,20,11000,814,1000,0.814,290,0.29,104,0.104,40
10625,9759,866,2241,21,12000,821,1000,0.821,286,0.286,107,0.107,40
11450,10479,971,2521,22,13000,825,1000,0.825,280,0.28,105,0.105,40
12256,11179,1077,2821,23,14000,806,1000,0.806,300,0.3,106,0.106,40
13047,11856,1191,3144,24,15000,791,1000,0.791,323,0.323,114,0.114,40
13837,12523,1314,3477,25,16000,790,1000,0.79,333,0.333,123,0.123,40
14616,13191,1425,3809,26,17000,779,1000,0.779,332,0.332,111,0.111,40
15400,13854,1546,4146,27,18000,784,1000,0.784,337,0.337,121,0.121,40
16149,14463,1686,4537,28,19000,749,1000,0.749,391,0.391,140,0.14,40
16907,15089,1818,4911,29,20000,758,1000,0.758,374,0.374,132,0.132,40
17653,15701,1952,5299,30,21000,746,1000,0.746,388,0.388,134,0.134,40
18396,16292,2104,5708,31,22000,743,1000,0.743,409,0.409,152,0.152,40
19134,16897,2237,6103,32,23000,738,1000,0.738,395,0.395,133,0.133,40
19871,17492,2379,6508,33,24000,737,1000,0.737,405,0.405,142,0.142,40
20607,18108,2499,6892,34,25000,736,1000,0.736,384,0.384,120,0.12,40
21351,18719,2632,7281,35,26000,744,1000,0.744,389,0.389,133,0.133,40
22071,19306,2765,7694,36,27000,720,1000,0.72,413,0.413,133,0.133,40
22808,19913,2895,8087,37,28000,737,1000,0.737,393,0.393,130,0.13,40
23514,20477,3037,8523,38,29000,706,1000,0.706,436,0.436,142,0.142,40
24198,21013,3185,8987,39,30000,684,1000,0.684,464,0.464,148,0.148,40
24894,21560,3334,9440,40,31000,696,1000,0.696,453,0.453,149,0.149,40
25591,22111,3480,9889,41,32000,697,1000,0.697,449,0.449,146,0.146,40
26303,22682,3621,10318,42,33000,712,1000,0.712,429,0.429,141,0.141,40
26970,23187,3783,10813,43,34000,667,1000,0.667,495,0.495,162,0.162,40
27625,23688,3937,11312,44,35000,655,1000,0.655,499,0.499,154,0.154,40
28298,24224,4074,11776,45,36000,673,1000,0.673,464,0.464,137,0.137,40
28971,24746,4225,12254,46,37000,673,1000,0.673,478,0.478,151,0.151,40
29632,25250,4382,12750,47,38000,661,1000,0.661,496,0.496,157,0.157,40
30294,25758,4536,13242,48,39000,662,1000,0.662,492,0.492,154,0.154,40
30949,26244,4705,13756,49,40000,655,1000,0.655,514,0.514,169,0.169,40
31589,26726,4863,14274,50,41000,640,1000,0.64,518,0.518,158,0.158,40
32232,27207,5025,14793,51,42000,643,1000,0.643,519,0.519,162,0.162,40
32893,27732,5161,15268,52,43000,661,1000,0.661,475,0.475,136,0.136,40
33541,28232,5309,15768,53,44000,648,1000,0.648,500,0.5,148,0.148,40
34192,28729,5463,16271,54,45000,651,1000,0.651,503,0.503,154,0.154,40
34856,29246,5610,16754,55,46000,664,1000,0.664,483,0.483,147,0.147,40
35509,29748,5761,17252,56,47000,653,1000,0.653,498,0.498,151,0.151,40
36142,30217,5925,17783,57,48000,633,1000,0.633,531,0.531,164,0.164,40
36767,30689,6078,18311,58,49000,625,1000,0.625,528,0.528,153,0.153,40
37391,31166,6225,18834,59,50000,624,1000,0.624,523,0.523,147,0.147,40
37993,31576,6417,19424,60,51000,602,1000,0.602,590,0.59,192,0.192,40
38601,32030,6571,19970,61,52000,608,1000,0.608,546,0.546,154,0.154,40
39214,32488,6726,20512,62,53000,613,1000,0.613,542,0.542,155,0.155,40
39817,32928,6889,21072,63,54000,603,1000,0.603,560,0.56,163,0.163,40
40415,33346,7069,21654,64,55000,598,1000,0.598,582,0.582,180,0.18,40
41019,33802,7217,22198,65,56000,604,1000,0.604,544,0.544,148,0.148,40
41612,34224,7388,22776,66,57000,593,1000,0.593,578,0.578,171,0.171,40
42232,34693,7539,23307,67,58000,620,1000,0.62,531,0.531,151,0.151,40
42810,35107,7703,23893,68,59000,578,1000,0.578,586,0.586,164,0.164,40
43369,35494,7875,24506,69,60000,559,1000,0.559,613,0.613,172,0.172,40
43986,35970,8016,25030,70,61000,617,1000,0.617,524,0.524,141,0.141,40
44598,36422,8176,25578,71,62000,612,1000,0.612,548,0.548,160,0.16,40
45201,36873,8328,26127,72,63000,603,1000,0.603,549,0.549,152,0.152,40
45762,37268,8494,26732,73,64000,561,1000,0.561,605,0.605,166,0.166,40
46345,37676,8669,27324,74,65000,583,1000,0.583,592,0.592,175,0.175,40
46898,38061,8837,27939,75,66000,553,1000,0.553,615,0.615,168,0.168,40
47482,38470,9012,28530,76,67000,584,1000,0.584,591,0.591,175,0.175,40
48059,38888,9171,29112,77,68000,577,1000,0.577,582,0.582,159,0.159,40
48610,39252,9358,29748,78,69000,551,1000,0.551,636,0.636,187,0.187,40
49185,39672,9513,30328,79,70000,575,1000,0.575,580,0.58,155,0.155,40
49714,40003,9711,30997,80,71000,529,1000,0.529,669,0.669,198,0.198,40
50273,40390,9883,31610,81,72000,559,1000,0.559,613,0.613,172,0.172,40
50845,40784,10061,32216,82,73000,572,1000,0.572,606,0.606,178,0.178,40
51383,41143,10240,32857,83,74000,538,1000,0.538,641,0.641,179,0.179,40
51927,41510,10417,33490,84,75000,544,1000,0.544,633,0.633,177,0.177,40
52478,41890,10588,34110,85,76000,551,1000,0.551,620,0.62,171,0.171,40
53009,42252,10757,34748,86,77000,531,1000,0.531,638,0.638,169,0.169,40
53558,42643,10915,35357,87,78000,549,1000,0.549,609,0.609,158,0.158,40
54068,42969,11099,36031,88,79000,510,1000,0.51,674,0.674,184,0.184,40
54580,43286,11294,36714,89,80000,512,1000,0.512,683,0.683,195,0.195,40
55098,43623,11475,37377,90,81000,518,1000,0.518,663,0.663,181,0.181,40
55627,43982,11645,38018,91,82000,529,1000,0.529,641,0.641,170,0.17,40
56161,44350,11811,38650,92,83000,534,1000,0.534,632,0.632,166,0.166,40
56682,44691,11991,39309,93,84000,521,1000,0.521,659,0.659,180,0.18,40
57178,45000,12178,40000,94,85000,496,1000,0.496,691,0.691,187,0.187,40
57702,45359,12343,40641,95,86000,524,1000,0.524,641,0.641,165,0.165,40
58239,45729,12510,41271,96,87000,537,1000,0.537,630,0.63,167,0.167,40
58763,46090,12673,41910,97,88000,524,1000,0.524,639,0.639,163,0.163,40
59290,46440,12850,42560,98,89000,527,1000,0.527,650,0.65,177,0.177,40
59817,46780,13037,43220,99,90000,527,1000,0.527,660,0.66,187,0.187,40
60353,47155,13198,43845,100,91000,536,1000,0.536,625,0.625,161,0.161,40
60882,47501,13381,44499,101,92000,529,1000,0.529,654,0.654,183,0.183,40
61402,47848,13554,45152,102,93000,520,1000,0.52,653,0.653,173,0.173,40
61926,48211,13715,45789,103,94000,524,1000,0.524,637,0.637,161,0.161,40
62427,48534,13893,46466,104,95000,501,1000,0.501,677,0.677,178,0.178,40
62905,48817,14088,47183,105,96000,478,1000,0.478,717,0.717,195,0.195,40
63428,49167,14261,47833,106,97000,523,1000,0.523,650,0.65,173,0.173,40
63935,49514,14421,48486,107,98000,507,1000,0.507,653,0.653,160,0.16,40
64434,49832,14602,49168,108,99000,499,1000,0.499,682,0.682,181,0.181,40
64931,50158,14773,49842,109,100000,497,1000,0.497,674,0.674,171,0.171,40
65422,50479,14943,50521,110,101000,491,1000,0.491,679,0.679,170,0.17,40
65931,50809,15122,51191,111,102000,509,1000,0.509,670,0.67,179,0.179,40
66426,51125,15301,51875,112,103000,495,1000,0.495,684,0.684,179,0.179,40
66907,51424,15483,52576,113,104000,481,1000,0.481,701,0.701,182,0.182,40
67374,51724,15650,53276,114,105000,467,1000,0.467,700,0.7,167,0.167,40
67867,52035,15832,53965,115,106000,493,1000,0.493,689,0.689,182,0.182,40
68376,52390,15986,54610,116,107000,509,1000,0.509,645,0.645,154,0.154,40
68850,52690,16160,55310,117,108000,474,1000,0.474,700,0.7,174,0.174,40
69331,53003,16328,55997,118,109000,481,1000,0.481,687,0.687,168,0.168,40
69816,53315,16501,56685,119,110000,485,1000,0.485,688,0.688,173,0.173,40
70290,53618,16672,57382,120,111000,474,1000,0.474,697,0.697,171,0.171,40
70769,53939,16830,58061,121,112000,479,1000,0.479,679,0.679,158,0.158,40
71254,54242,17012,58758,122,113000,485,1000,0.485,697,0.697,182,0.182,40
71718,54534,17184,59466,123,114000,464,1000,0.464,708,0.708,172,0.172,40
71869,54638,17231,59660,124,114298,151,298,0.5067114093959731,194,0.6510067114093959,47,0.15771812080536912,40
100,100,0,0,1,100,NA,NA,NA,NA,NA,NA,NA,41
200,200,0,0,2,200,100,100,1,0,0,0,0,41
300,300,0,0,3,300,100,100,1,0,0,0,0,41
397,394,3,6,4,400,97,100,0.97,6,0.06,3,0.03,41
496,492,4,8,5,500,99,100,0.99,2,0.02,1,0.01,41
593,586,7,14,6,600,97,100,0.97,6,0.06,3,0.03,41
690,681,9,19,7,700,97,100,0.97,5,0.05,2,0.02,41
790,781,9,19,8,800,100,100,1,0,0,0,0,41
889,879,10,21,9,900,99,100,0.99,2,0.02,1,0.01,41
986,974,12,26,10,1000,97,100,0.97,5,0.05,2,0.02,41
1941,1895,46,105,11,2000,955,1000,0.955,79,0.079,34,0.034,41
2875,2785,90,215,12,3000,934,1000,0.934,110,0.11,44,0.044,41
3789,3631,158,369,13,4000,914,1000,0.914,154,0.154,68,0.068,41
4693,4470,223,530,14,5000,904,1000,0.904,161,0.161,65,0.065,41
5579,5282,297,718,15,6000,886,1000,0.886,188,0.188,74,0.074,41
6430,6046,384,954,16,7000,851,1000,0.851,236,0.236,87,0.087,41
7286,6815,471,1185,17,8000,856,1000,0.856,231,0.231,87,0.087,41
8135,7581,554,1419,18,9000,849,1000,0.849,234,0.234,83,0.083,41
8967,8326,641,1674,19,10000,832,1000,0.832,255,0.255,87,0.087,41
9774,9022,752,1978,20,11000,807,1000,0.807,304,0.304,111,0.111,41
10620,9781,839,2219,21,12000,846,1000,0.846,241,0.241,87,0.087,41
11432,10463,969,2537,22,13000,812,1000,0.812,318,0.318,130,0.13,41
12270,11202,1068,2798,23,14000,838,1000,0.838,261,0.261,99,0.099,41
13066,11871,1195,3129,24,15000,796,1000,0.796,331,0.331,127,0.127,41
13857,12544,1313,3456,25,16000,791,1000,0.791,327,0.327,118,0.118,41
14634,13202,1432,3798,26,17000,777,1000,0.777,342,0.342,119,0.119,41
15404,13835,1569,4165,27,18000,770,1000,0.77,367,0.367,137,0.137,41
16182,14484,1698,4516,28,19000,778,1000,0.778,351,0.351,129,0.129,41
16935,15111,1824,4889,29,20000,753,1000,0.753,373,0.373,126,0.126,41
17695,15740,1955,5260,30,21000,760,1000,0.76,371,0.371,131,0.131,41
18419,16329,2090,5671,31,22000,724,1000,0.724,411,0.411,135,0.135,41
19147,16901,2246,6099,32,23000,728,1000,0.728,428,0.428,156,0.156,41
19874,17486,2388,6514,33,24000,727,1000,0.727,415,0.415,142,0.142,41
20599,18067,2532,6933,34,25000,725,1000,0.725,419,0.419,144,0.144,41
21334,18659,2675,7341,35,26000,735,1000,0.735,408,0.408,143,0.143,41
22039,19223,2816,7777,36,27000,705,1000,0.705,436,0.436,141,0.141,41
22750,19789,2961,8211,37,28000,711,1000,0.711,434,0.434,145,0.145,41
23431,20301,3130,8699,38,29000,681,1000,0.681,488,0.488,169,0.169,41
24130,20856,3274,9144,39,30000,699,1000,0.699,445,0.445,144,0.144,41
24843,21417,3426,9583,40,31000,713,1000,0.713,439,0.439,152,0.152,41
25553,21988,3565,10012,41,32000,710,1000,0.71,429,0.429,139,0.139,41
26256,22546,3710,10454,42,33000,703,1000,0.703,442,0.442,145,0.145,41
26903,23036,3867,10964,43,34000,647,1000,0.647,510,0.51,157,0.157,41
27577,23559,4018,11441,44,35000,674,1000,0.674,477,0.477,151,0.151,41
28237,24061,4176,11939,45,36000,660,1000,0.66,498,0.498,158,0.158,41
28920,24608,4312,12392,46,37000,683,1000,0.683,453,0.453,136,0.136,41
29582,25103,4479,12897,47,38000,662,1000,0.662,505,0.505,167,0.167,41
30227,25590,4637,13410,48,39000,645,1000,0.645,513,0.513,158,0.158,41
30910,26113,4797,13887,49,40000,683,1000,0.683,477,0.477,160,0.16,41
31583,26644,4939,14356,50,41000,673,1000,0.673,469,0.469,142,0.142,41
32221,27110,5111,14890,51,42000,638,1000,0.638,534,0.534,172,0.172,41
32852,27583,5269,15417,52,43000,631,1000,0.631,527,0.527,158,0.158,41
33495,28058,5437,15942,53,44000,643,1000,0.643,525,0.525,168,0.168,41
34148,28561,5587,16439,54,45000,653,1000,0.653,497,0.497,150,0.15,41
34797,29064,5733,16936,55,46000,649,1000,0.649,497,0.497,146,0.146,41
35463,29595,5868,17405,56,47000,666,1000,0.666,469,0.469,135,0.135,41
36087,30030,6057,17970,57,48000,624,1000,0.624,565,0.565,189,0.189,41
36712,30505,6207,18495,58,49000,625,1000,0.625,525,0.525,150,0.15,41
37329,30962,6367,19038,59,50000,617,1000,0.617,543,0.543,160,0.16,41
37918,31377,6541,19623,60,51000,589,1000,0.589,585,0.585,174,0.174,41
38538,31853,6685,20147,61,52000,620,1000,0.62,524,0.524,144,0.144,41
39163,32327,6836,20673,62,53000,625,1000,0.625,526,0.526,151,0.151,41
39773,32768,7005,21232,63,54000,610,1000,0.61,559,0.559,169,0.169,41
40381,33213,7168,21787,64,55000,608,1000,0.608,555,0.555,163,0.163,41
40978,33666,7312,22334,65,56000,597,1000,0.597,547,0.547,144,0.144,41
41572,34076,7496,22924,66,57000,594,1000,0.594,590,0.59,184,0.184,41
42174,34503,7671,23497,67,58000,602,1000,0.602,573,0.573,175,0.175,41
42765,34921,7844,24079,68,59000,591,1000,0.591,582,0.582,173,0.173,41
43345,35329,8016,24671,69,60000,580,1000,0.58,592,0.592,172,0.172,41
43938,35766,8172,25234,70,61000,593,1000,0.593,563,0.563,156,0.156,41
44527,36178,8349,25822,71,62000,589,1000,0.589,588,0.588,177,0.177,41
45066,36518,8548,26482,72,63000,539,1000,0.539,660,0.66,199,0.199,41
45654,36943,8711,27057,73,64000,588,1000,0.588,575,0.575,163,0.163,41
46211,37320,8891,27680,74,65000,557,1000,0.557,623,0.623,180,0.18,41
46793,37737,9056,28263,75,66000,582,1000,0.582,583,0.583,165,0.165,41
47362,38122,9240,28878,76,67000,569,1000,0.569,615,0.615,184,0.184,41
47913,38496,9417,29504,77,68000,551,1000,0.551,626,0.626,177,0.177,41
48495,38923,9572,30077,78,69000,582,1000,0.582,573,0.573,155,0.155,41
49057,39342,9715,30658,79,70000,562,1000,0.562,581,0.581,143,0.143,41
49607,39726,9881,31274,80,71000,550,1000,0.55,616,0.616,166,0.166,41
50176,40136,10040,31864,81,72000,569,1000,0.569,590,0.59,159,0.159,41
50734,40528,10206,32472,82,73000,558,1000,0.558,608,0.608,166,0.166,41
51307,40940,10367,33060,83,74000,573,1000,0.573,588,0.588,161,0.161,41
51859,41323,10536,33677,84,75000,552,1000,0.552,617,0.617,169,0.169,41
52397,41673,10724,34327,85,76000,538,1000,0.538,650,0.65,188,0.188,41
52945,42053,10892,34947,86,77000,548,1000,0.548,620,0.62,168,0.168,41
53466,42394,11072,35606,87,78000,521,1000,0.521,659,0.659,180,0.18,41
54041,42813,11228,36187,88,79000,575,1000,0.575,581,0.581,156,0.156,41
54598,43208,11390,36792,89,80000,557,1000,0.557,605,0.605,162,0.162,41
55117,43543,11574,37457,90,81000,519,1000,0.519,665,0.665,184,0.184,41
55686,43961,11725,38039,91,82000,569,1000,0.569,582,0.582,151,0.151,41
56221,44329,11892,38671,92,83000,535,1000,0.535,632,0.632,167,0.167,41
56769,44707,12062,39293,93,84000,548,1000,0.548,622,0.622,170,0.17,41
57287,45078,12209,39922,94,85000,518,1000,0.518,629,0.629,147,0.147,41
57807,45418,12389,40582,95,86000,520,1000,0.52,660,0.66,180,0.18,41
58315,45756,12559,41244,96,87000,508,1000,0.508,662,0.662,170,0.17,41
58838,46131,12707,41869,97,88000,523,1000,0.523,625,0.625,148,0.148,41
59307,46421,12886,42579,98,89000,469,1000,0.469,710,0.71,179,0.179,41
59824,46770,13054,43230,99,90000,517,1000,0.517,651,0.651,168,0.168,41
60340,47124,13216,43876,100,91000,516,1000,0.516,646,0.646,162,0.162,41
60860,47477,13383,44523,101,92000,520,1000,0.52,647,0.647,167,0.167,41
61368,47795,13573,45205,102,93000,508,1000,0.508,682,0.682,190,0.19,41
61862,48102,13760,45898,103,94000,494,1000,0.494,693,0.693,187,0.187,41
62358,48433,13925,46567,104,95000,496,1000,0.496,669,0.669,165,0.165,41
62828,48712,14116,47288,105,96000,470,1000,0.47,721,0.721,191,0.191,41
63330,49050,14280,47950,106,97000,502,1000,0.502,662,0.662,164,0.164,41
63842,49390,14452,48610,107,98000,512,1000,0.512,660,0.66,172,0.172,41
64357,49736,14621,49264,108,99000,515,1000,0.515,654,0.654,169,0.169,41
64874,50081,14793,49919,109,100000,517,1000,0.517,655,0.655,172,0.172,41
65347,50372,14975,50628,110,101000,473,1000,0.473,709,0.709,182,0.182,41
65839,50698,15141,51302,111,102000,492,1000,0.492,674,0.674,166,0.166,41
66340,51041,15299,51959,112,103000,501,1000,0.501,657,0.657,158,0.158,41
66844,51374,15470,52626,113,104000,504,1000,0.504,667,0.667,171,0.171,41
67330,51660,15670,53340,114,105000,486,1000,0.486,714,0.714,200,0.2,41
67813,51996,15817,54004,115,106000,483,1000,0.483,664,0.664,147,0.147,41
68295,52305,15990,54695,116,107000,482,1000,0.482,691,0.691,173,0.173,41
68772,52593,16179,55407,117,108000,477,1000,0.477,712,0.712,189,0.189,41
69237,52896,16341,56104,118,109000,465,1000,0.465,697,0.697,162,0.162,41
69763,53266,16497,56734,119,110000,526,1000,0.526,630,0.63,156,0.156,41
70240,53552,16688,57448,120,111000,477,1000,0.477,714,0.714,191,0.191,41
70741,53870,16871,58130,121,112000,501,1000,0.501,682,0.682,183,0.183,41
71241,54208,17033,58792,122,113000,500,1000,0.5,662,0.662,162,0.162,41
71726,54541,17185,59459,123,114000,485,1000,0.485,667,0.667,152,0.152,41
71869,54638,17231,59660,124,114298,143,298,0.4798657718120805,201,0.674496644295302,46,0.15436241610738255,41
100,100,0,0,1,100,NA,NA,NA,NA,NA,NA,NA,42
198,196,2,4,2,200,98,100,0.98,4,0.04,2,0.02,42
298,296,2,4,3,300,100,100,1,0,0,0,0,42
395,390,5,10,4,400,97,100,0.97,6,0.06,3,0.03,42
493,486,7,14,5,500,98,100,0.98,4,0.04,2,0.02,42
591,583,8,17,6,600,98,100,0.98,3,0.03,1,0.01,42
684,671,13,29,7,700,93,100,0.93,12,0.12,5,0.05,42
780,764,16,36,8,800,96,100,0.96,7,0.07,3,0.03,42
878,861,17,39,9,900,98,100,0.98,3,0.03,1,0.01,42
978,961,17,39,10,1000,100,100,1,0,0,0,0,42
1947,1902,45,98,11,2000,969,1000,0.969,59,0.059,28,0.028,42
2883,2794,89,206,12,3000,936,1000,0.936,108,0.108,44,0.044,42
3786,3624,162,376,13,4000,903,1000,0.903,170,0.17,73,0.073,42
4695,4471,224,529,14,5000,909,1000,0.909,153,0.153,62,0.062,42
5574,5283,291,717,15,6000,879,1000,0.879,188,0.188,67,0.067,42
6435,6051,384,949,16,7000,861,1000,0.861,232,0.232,93,0.093,42
7304,6837,467,1163,17,8000,869,1000,0.869,214,0.214,83,0.083,42
8157,7601,556,1399,18,9000,853,1000,0.853,236,0.236,89,0.089,42
9013,8375,638,1625,19,10000,856,1000,0.856,226,0.226,82,0.082,42
9836,9092,744,1908,20,11000,823,1000,0.823,283,0.283,106,0.106,42
10651,9797,854,2203,21,12000,815,1000,0.815,295,0.295,110,0.11,42
11430,10449,981,2551,22,13000,779,1000,0.779,348,0.348,127,0.127,42
12209,11101,1108,2899,23,14000,779,1000,0.779,348,0.348,127,0.127,42
12991,11751,1240,3249,24,15000,782,1000,0.782,350,0.35,132,0.132,42
13761,12396,1365,3604,25,16000,770,1000,0.77,355,0.355,125,0.125,42
14545,13069,1476,3931,26,17000,784,1000,0.784,327,0.327,111,0.111,42
15294,13668,1626,4332,27,18000,749,1000,0.749,401,0.401,150,0.15,42
16060,14306,1754,4694,28,19000,766,1000,0.766,362,0.362,128,0.128,42
16822,14952,1870,5048,29,20000,762,1000,0.762,354,0.354,116,0.116,42
17562,15575,1987,5425,30,21000,740,1000,0.74,377,0.377,117,0.117,42
18316,16198,2118,5802,31,22000,754,1000,0.754,377,0.377,131,0.131,42
19045,16792,2253,6208,32,23000,729,1000,0.729,406,0.406,135,0.135,42
19790,17408,2382,6592,33,24000,745,1000,0.745,384,0.384,129,0.129,42
20518,18014,2504,6986,34,25000,728,1000,0.728,394,0.394,122,0.122,42
21234,18574,2660,7426,35,26000,716,1000,0.716,440,0.44,156,0.156,42
21945,19153,2792,7847,36,27000,711,1000,0.711,421,0.421,132,0.132,42
22631,19676,2955,8324,37,28000,686,1000,0.686,477,0.477,163,0.163,42
23340,20250,3090,8750,38,29000,709,1000,0.709,426,0.426,135,0.135,42
24041,20807,3234,9193,39,30000,701,1000,0.701,443,0.443,144,0.144,42
24733,21362,3371,9638,40,31000,692,1000,0.692,445,0.445,137,0.137,42
25423,21904,3519,10096,41,32000,690,1000,0.69,458,0.458,148,0.148,42
26058,22366,3692,10634,42,33000,635,1000,0.635,538,0.538,173,0.173,42
26766,22942,3824,11058,43,34000,708,1000,0.708,424,0.424,132,0.132,42
27452,23470,3982,11530,44,35000,686,1000,0.686,472,0.472,158,0.158,42
28130,23998,4132,12002,45,36000,678,1000,0.678,472,0.472,150,0.15,42
28777,24474,4303,12526,46,37000,647,1000,0.647,524,0.524,171,0.171,42
29449,25005,4444,12995,47,38000,672,1000,0.672,469,0.469,141,0.141,42
30099,25507,4592,13493,48,39000,650,1000,0.65,498,0.498,148,0.148,42
30755,26012,4743,13988,49,40000,656,1000,0.656,495,0.495,151,0.151,42
31416,26513,4903,14487,50,41000,661,1000,0.661,499,0.499,160,0.16,42
32047,26976,5071,15024,51,42000,631,1000,0.631,537,0.537,168,0.168,42
32697,27471,5226,15529,52,43000,650,1000,0.65,505,0.505,155,0.155,42
33386,28013,5373,15987,53,44000,689,1000,0.689,458,0.458,147,0.147,42
34004,28453,5551,16547,54,45000,618,1000,0.618,560,0.56,178,0.178,42
34638,28925,5713,17075,55,46000,634,1000,0.634,528,0.528,162,0.162,42
35300,29435,5865,17565,56,47000,662,1000,0.662,490,0.49,152,0.152,42
35909,29881,6028,18119,57,48000,609,1000,0.609,554,0.554,163,0.163,42
36557,30374,6183,18626,58,49000,648,1000,0.648,507,0.507,155,0.155,42
37208,30893,6315,19107,59,50000,651,1000,0.651,481,0.481,132,0.132,42
37840,31359,6481,19641,60,51000,632,1000,0.632,534,0.534,166,0.166,42
38445,31772,6673,20228,61,52000,605,1000,0.605,587,0.587,192,0.192,42
39082,32261,6821,20739,62,53000,637,1000,0.637,511,0.511,148,0.148,42
39707,32747,6960,21253,63,54000,625,1000,0.625,514,0.514,139,0.139,42
40320,33190,7130,21810,64,55000,613,1000,0.613,557,0.557,170,0.17,42
40894,33587,7307,22413,65,56000,574,1000,0.574,603,0.603,177,0.177,42
41485,34023,7462,22977,66,57000,591,1000,0.591,564,0.564,155,0.155,42
42067,34421,7646,23579,67,58000,582,1000,0.582,602,0.602,184,0.184,42
42676,34876,7800,24124,68,59000,609,1000,0.609,545,0.545,154,0.154,42
43265,35300,7965,24700,69,60000,589,1000,0.589,576,0.576,165,0.165,42
43869,35750,8119,25250,70,61000,604,1000,0.604,550,0.55,154,0.154,42
44440,36152,8288,25848,71,62000,571,1000,0.571,598,0.598,169,0.169,42
45028,36567,8461,26433,72,63000,588,1000,0.588,585,0.585,173,0.173,42
45627,37014,8613,26986,73,64000,599,1000,0.599,553,0.553,152,0.152,42
46214,37434,8780,27566,74,65000,587,1000,0.587,580,0.58,167,0.167,42
46745,37783,8962,28217,75,66000,531,1000,0.531,651,0.651,182,0.182,42
47293,38152,9141,28848,76,67000,548,1000,0.548,631,0.631,179,0.179,42
47833,38527,9306,29473,77,68000,540,1000,0.54,625,0.625,165,0.165,42
48405,38923,9482,30077,78,69000,572,1000,0.572,604,0.604,176,0.176,42
48944,39284,9660,30716,79,70000,539,1000,0.539,639,0.639,178,0.178,42
49526,39707,9819,31293,80,71000,582,1000,0.582,577,0.577,159,0.159,42
50078,40097,9981,31903,81,72000,552,1000,0.552,610,0.61,162,0.162,42
50647,40478,10169,32522,82,73000,569,1000,0.569,619,0.619,188,0.188,42
51207,40871,10336,33129,83,74000,560,1000,0.56,607,0.607,167,0.167,42
51780,41284,10496,33716,84,75000,573,1000,0.573,587,0.587,160,0.16,42
52329,41662,10667,34338,85,76000,549,1000,0.549,622,0.622,171,0.171,42
52866,42024,10842,34976,86,77000,537,1000,0.537,638,0.638,175,0.175,42
53403,42379,11024,35621,87,78000,537,1000,0.537,645,0.645,182,0.182,42
53944,42755,11189,36245,88,79000,541,1000,0.541,624,0.624,165,0.165,42
54472,43094,11378,36906,89,80000,528,1000,0.528,661,0.661,189,0.189,42
55014,43461,11553,37539,90,81000,542,1000,0.542,633,0.633,175,0.175,42
55562,43828,11734,38172,91,82000,548,1000,0.548,633,0.633,181,0.181,42
56120,44225,11895,38775,92,83000,558,1000,0.558,603,0.603,161,0.161,42
56670,44603,12067,39397,93,84000,550,1000,0.55,622,0.622,172,0.172,42
57202,44934,12268,40066,94,85000,532,1000,0.532,669,0.669,201,0.201,42
57733,45290,12443,40710,95,86000,531,1000,0.531,644,0.644,175,0.175,42
58216,45587,12629,41413,96,87000,483,1000,0.483,703,0.703,186,0.186,42
58735,45943,12792,42057,97,88000,519,1000,0.519,644,0.644,163,0.163,42
59254,46275,12979,42725,98,89000,519,1000,0.519,668,0.668,187,0.187,42
59772,46609,13163,43391,99,90000,518,1000,0.518,666,0.666,184,0.184,42
60286,46949,13337,44051,100,91000,514,1000,0.514,660,0.66,174,0.174,42
60790,47275,13515,44725,101,92000,504,1000,0.504,674,0.674,178,0.178,42
61305,47626,13679,45374,102,93000,515,1000,0.515,649,0.649,164,0.164,42
61826,47978,13848,46022,103,94000,521,1000,0.521,648,0.648,169,0.169,42
62330,48309,14021,46691,104,95000,504,1000,0.504,669,0.669,173,0.173,42
62820,48637,14183,47363,105,96000,490,1000,0.49,672,0.672,162,0.162,42
63322,48964,14358,48036,106,97000,502,1000,0.502,673,0.673,175,0.175,42
63800,49279,14521,48721,107,98000,478,1000,0.478,685,0.685,163,0.163,42
64310,49637,14673,49363,108,99000,510,1000,0.51,642,0.642,152,0.152,42
64814,49965,14849,50035,109,100000,504,1000,0.504,672,0.672,176,0.176,42
65310,50312,14998,50688,110,101000,496,1000,0.496,653,0.653,149,0.149,42
65844,50679,15165,51321,111,102000,534,1000,0.534,633,0.633,167,0.167,42
66345,50992,15353,52008,112,103000,501,1000,0.501,687,0.687,188,0.188,42
66833,51321,15512,52679,113,104000,488,1000,0.488,671,0.671,159,0.159,42
67352,51676,15676,53324,114,105000,519,1000,0.519,645,0.645,164,0.164,42
67831,51977,15854,54023,115,106000,479,1000,0.479,699,0.699,178,0.178,42
68313,52276,16037,54724,116,107000,482,1000,0.482,701,0.701,183,0.183,42
68801,52613,16188,55387,117,108000,488,1000,0.488,663,0.663,151,0.151,42
69280,52934,16346,56066,118,109000,479,1000,0.479,679,0.679,158,0.158,42
69777,53258,16519,56742,119,110000,497,1000,0.497,676,0.676,173,0.173,42
70260,53574,16686,57426,120,111000,483,1000,0.483,684,0.684,167,0.167,42
70755,53898,16857,58102,121,112000,495,1000,0.495,676,0.676,171,0.171,42
71263,54253,17010,58747,122,113000,508,1000,0.508,645,0.645,153,0.153,42
71736,54555,17181,59445,123,114000,473,1000,0.473,698,0.698,171,0.171,42
71869,54638,17231,59660,124,114298,133,298,0.4463087248322148,215,0.7214765100671141,50,0.16778523489932887,42
100,100,0,0,1,100,NA,NA,NA,NA,NA,NA,NA,43
199,198,1,2,2,200,99,100,0.99,2,0.02,1,0.01,43
298,296,2,4,3,300,99,100,0.99,2,0.02,1,0.01,43
396,392,4,8,4,400,98,100,0.98,4,0.04,2,0.02,43
496,492,4,8,5,500,100,100,1,0,0,0,0,43
592,584,8,16,6,600,96,100,0.96,8,0.08,4,0.04,43
688,676,12,24,7,700,96,100,0.96,8,0.08,4,0.04,43
787,774,13,26,8,800,99,100,0.99,2,0.02,1,0.01,43
885,870,15,30,9,900,98,100,0.98,4,0.04,2,0.02,43
983,968,15,32,10,1000,98,100,0.98,2,0.02,0,0,43
1942,1900,42,100,11,2000,959,1000,0.959,68,0.068,27,0.027,43
2880,2795,85,205,12,3000,938,1000,0.938,105,0.105,43,0.043,43
3813,3680,133,320,13,4000,933,1000,0.933,115,0.115,48,0.048,43
4728,4540,188,460,14,5000,915,1000,0.915,140,0.14,55,0.055,43
5630,5377,253,623,15,6000,902,1000,0.902,163,0.163,65,0.065,43
6500,6157,343,843,16,7000,870,1000,0.87,220,0.22,90,0.09,43
7361,6933,428,1067,17,8000,861,1000,0.861,224,0.224,85,0.085,43
8222,7708,514,1292,18,9000,861,1000,0.861,225,0.225,86,0.086,43
9072,8469,603,1531,19,10000,850,1000,0.85,239,0.239,89,0.089,43
9887,9172,715,1828,20,11000,815,1000,0.815,297,0.297,112,0.112,43
10719,9895,824,2105,21,12000,832,1000,0.832,277,0.277,109,0.109,43
11508,10552,956,2448,22,13000,789,1000,0.789,343,0.343,132,0.132,43
12302,11229,1073,2771,23,14000,794,1000,0.794,323,0.323,117,0.117,43
13109,11919,1190,3081,24,15000,807,1000,0.807,310,0.31,117,0.117,43
13903,12599,1304,3401,25,16000,794,1000,0.794,320,0.32,114,0.114,43
14712,13306,1406,3694,26,17000,809,1000,0.809,293,0.293,102,0.102,43
15481,13933,1548,4067,27,18000,769,1000,0.769,373,0.373,142,0.142,43
16262,14600,1662,4400,28,19000,781,1000,0.781,333,0.333,114,0.114,43
16980,15161,1819,4839,29,20000,718,1000,0.718,439,0.439,157,0.157,43
17722,15758,1964,5242,30,21000,742,1000,0.742,403,0.403,145,0.145,43
18480,16386,2094,5614,31,22000,758,1000,0.758,372,0.372,130,0.13,43
19203,16960,2243,6040,32,23000,723,1000,0.723,426,0.426,149,0.149,43
19926,17538,2388,6462,33,24000,723,1000,0.723,422,0.422,145,0.145,43
20674,18165,2509,6835,34,25000,748,1000,0.748,373,0.373,121,0.121,43
21387,18724,2663,7276,35,26000,713,1000,0.713,441,0.441,154,0.154,43
22092,19306,2786,7694,36,27000,705,1000,0.705,418,0.418,123,0.123,43
22797,19855,2942,8145,37,28000,705,1000,0.705,451,0.451,156,0.156,43
23506,20416,3090,8584,38,29000,709,1000,0.709,439,0.439,148,0.148,43
24222,20995,3227,9005,39,30000,716,1000,0.716,421,0.421,137,0.137,43
24908,21538,3370,9462,40,31000,686,1000,0.686,457,0.457,143,0.143,43
25588,22076,3512,9924,41,32000,680,1000,0.68,462,0.462,142,0.142,43
26248,22552,3696,10448,42,33000,660,1000,0.66,524,0.524,184,0.184,43
26922,23065,3857,10935,43,34000,674,1000,0.674,487,0.487,161,0.161,43
27578,23569,4009,11431,44,35000,656,1000,0.656,496,0.496,152,0.152,43
28281,24126,4155,11874,45,36000,703,1000,0.703,443,0.443,146,0.146,43
28951,24632,4319,12368,46,37000,670,1000,0.67,494,0.494,164,0.164,43
29586,25100,4486,12900,47,38000,635,1000,0.635,532,0.532,167,0.167,43
30244,25597,4647,13403,48,39000,658,1000,0.658,503,0.503,161,0.161,43
30904,26105,4799,13895,49,40000,660,1000,0.66,492,0.492,152,0.152,43
31558,26599,4959,14401,50,41000,654,1000,0.654,506,0.506,160,0.16,43
32193,27072,5121,14928,51,42000,635,1000,0.635,527,0.527,162,0.162,43
32843,27586,5257,15414,52,43000,650,1000,0.65,486,0.486,136,0.136,43
33487,28080,5407,15920,53,44000,644,1000,0.644,506,0.506,150,0.15,43
34129,28564,5565,16436,54,45000,642,1000,0.642,516,0.516,158,0.158,43
34751,28996,5755,17004,55,46000,622,1000,0.622,568,0.568,190,0.19,43
35379,29460,5919,17540,56,47000,628,1000,0.628,536,0.536,164,0.164,43
36028,29957,6071,18043,57,48000,649,1000,0.649,503,0.503,152,0.152,43
36649,30411,6238,18589,58,49000,621,1000,0.621,546,0.546,167,0.167,43
37280,30885,6395,19115,59,50000,631,1000,0.631,526,0.526,157,0.157,43
37905,31368,6537,19632,60,51000,625,1000,0.625,517,0.517,142,0.142,43
38517,31811,6706,20189,61,52000,612,1000,0.612,557,0.557,169,0.169,43
39148,32298,6850,20702,62,53000,631,1000,0.631,513,0.513,144,0.144,43
39756,32742,7014,21258,63,54000,608,1000,0.608,556,0.556,164,0.164,43
40357,33180,7177,21820,64,55000,601,1000,0.601,562,0.562,163,0.163,43
40965,33641,7324,22359,65,56000,608,1000,0.608,539,0.539,147,0.147,43
41586,34100,7486,22900,66,57000,621,1000,0.621,541,0.541,162,0.162,43
42164,34490,7674,23510,67,58000,578,1000,0.578,610,0.61,188,0.188,43
42744,34902,7842,24098,68,59000,580,1000,0.58,588,0.588,168,0.168,43
43335,35337,7998,24663,69,60000,591,1000,0.591,565,0.565,156,0.156,43
43919,35758,8161,25242,70,61000,584,1000,0.584,579,0.579,163,0.163,43
44492,36183,8309,25817,71,62000,573,1000,0.573,575,0.575,148,0.148,43
45064,36576,8488,26424,72,63000,572,1000,0.572,607,0.607,179,0.179,43
45650,36987,8663,27013,73,64000,586,1000,0.586,589,0.589,175,0.175,43
46216,37387,8829,27613,74,65000,566,1000,0.566,600,0.6,166,0.166,43
46771,37756,9015,28244,75,66000,555,1000,0.555,631,0.631,186,0.186,43
47356,38200,9156,28800,76,67000,585,1000,0.585,556,0.556,141,0.141,43
47913,38584,9329,29416,77,68000,557,1000,0.557,616,0.616,173,0.173,43
48470,38967,9503,30033,78,69000,557,1000,0.557,617,0.617,174,0.174,43
49017,39340,9677,30660,79,70000,547,1000,0.547,627,0.627,174,0.174,43
49570,39715,9855,31285,80,71000,553,1000,0.553,625,0.625,178,0.178,43
50135,40108,10027,31892,81,72000,565,1000,0.565,607,0.607,172,0.172,43
50724,40532,10192,32468,82,73000,589,1000,0.589,576,0.576,165,0.165,43
51265,40901,10364,33099,83,74000,541,1000,0.541,631,0.631,172,0.172,43
51810,41269,10541,33731,84,75000,545,1000,0.545,632,0.632,177,0.177,43
52377,41672,10705,34328,85,76000,567,1000,0.567,597,0.597,164,0.164,43
52952,42068,10884,34932,86,77000,575,1000,0.575,604,0.604,179,0.179,43
53498,42441,11057,35559,87,78000,546,1000,0.546,627,0.627,173,0.173,43
54013,42780,11233,36220,88,79000,515,1000,0.515,661,0.661,176,0.176,43
54554,43157,11397,36843,89,80000,541,1000,0.541,623,0.623,164,0.164,43
55092,43533,11559,37467,90,81000,538,1000,0.538,624,0.624,162,0.162,43
55636,43910,11726,38090,91,82000,544,1000,0.544,623,0.623,167,0.167,43
56148,44248,11900,38752,92,83000,512,1000,0.512,662,0.662,174,0.174,43
56681,44620,12061,39380,93,84000,533,1000,0.533,628,0.628,161,0.161,43
57217,44982,12235,40018,94,85000,536,1000,0.536,638,0.638,174,0.174,43
57745,45345,12400,40655,95,86000,528,1000,0.528,637,0.637,165,0.165,43
58285,45710,12575,41290,96,87000,540,1000,0.54,635,0.635,175,0.175,43
58807,46065,12742,41935,97,88000,522,1000,0.522,645,0.645,167,0.167,43
59314,46388,12926,42612,98,89000,507,1000,0.507,677,0.677,184,0.184,43
59818,46708,13110,43292,99,90000,504,1000,0.504,680,0.68,184,0.184,43
60340,47060,13280,43940,100,91000,522,1000,0.522,648,0.648,170,0.17,43
60837,47377,13460,44623,101,92000,497,1000,0.497,683,0.683,180,0.18,43
61375,47747,13628,45253,102,93000,538,1000,0.538,630,0.63,168,0.168,43
61889,48107,13782,45893,103,94000,514,1000,0.514,640,0.64,154,0.154,43
62378,48412,13966,46588,104,95000,489,1000,0.489,695,0.695,184,0.184,43
62881,48731,14150,47269,105,96000,503,1000,0.503,681,0.681,184,0.184,43
63364,49034,14330,47966,106,97000,483,1000,0.483,697,0.697,180,0.18,43
63887,49397,14490,48603,107,98000,523,1000,0.523,637,0.637,160,0.16,43
64379,49707,14672,49293,108,99000,492,1000,0.492,690,0.69,182,0.182,43
64864,50010,14854,49990,109,100000,485,1000,0.485,697,0.697,182,0.182,43
65380,50389,14991,50611,110,101000,516,1000,0.516,621,0.621,137,0.137,43
65897,50740,15157,51260,111,102000,517,1000,0.517,649,0.649,166,0.166,43
66399,51074,15325,51926,112,103000,502,1000,0.502,666,0.666,168,0.168,43
66903,51419,15484,52581,113,104000,504,1000,0.504,655,0.655,159,0.159,43
67387,51716,15671,53284,114,105000,484,1000,0.484,703,0.703,187,0.187,43
67872,52019,15853,53981,115,106000,485,1000,0.485,697,0.697,182,0.182,43
68378,52370,16008,54630,116,107000,506,1000,0.506,649,0.649,155,0.155,43
68854,52681,16173,55319,117,108000,476,1000,0.476,689,0.689,165,0.165,43
69336,52985,16351,56015,118,109000,482,1000,0.482,696,0.696,178,0.178,43
69803,53287,16516,56713,119,110000,467,1000,0.467,698,0.698,165,0.165,43
70298,53614,16684,57386,120,111000,495,1000,0.495,673,0.673,168,0.168,43
70782,53937,16845,58063,121,112000,484,1000,0.484,677,0.677,161,0.161,43
71296,54295,17001,58705,122,113000,514,1000,0.514,642,0.642,156,0.156,43
71741,54562,17179,59438,123,114000,445,1000,0.445,733,0.733,178,0.178,43
71869,54638,17231,59660,124,114298,128,298,0.42953020134228187,222,0.7449664429530202,52,0.174496644295302,43
100,100,0,0,1,100,NA,NA,NA,NA,NA,NA,NA,44
200,200,0,0,2,200,100,100,1,0,0,0,0,44
296,293,3,7,3,300,96,100,0.96,7,0.07,3,0.03,44
395,391,4,9,4,400,99,100,0.99,2,0.02,1,0.01,44
491,483,8,17,5,500,96,100,0.96,8,0.08,4,0.04,44
589,579,10,21,6,600,98,100,0.98,4,0.04,2,0.02,44
687,675,12,25,7,700,98,100,0.98,4,0.04,2,0.02,44
784,770,14,30,8,800,97,100,0.97,5,0.05,2,0.02,44
878,861,17,39,9,900,94,100,0.94,9,0.09,3,0.03,44
977,959,18,41,10,1000,99,100,0.99,2,0.02,1,0.01,44
1919,1859,60,141,11,2000,942,1000,0.942,100,0.1,42,0.042,44
2858,2752,106,248,12,3000,939,1000,0.939,107,0.107,46,0.046,44
3756,3577,179,423,13,4000,898,1000,0.898,175,0.175,73,0.073,44
4664,4423,241,577,14,5000,908,1000,0.908,154,0.154,62,0.062,44
5542,5221,321,779,15,6000,878,1000,0.878,202,0.202,80,0.08,44
6425,6033,392,967,16,7000,883,1000,0.883,188,0.188,71,0.071,44
7296,6819,477,1181,17,8000,871,1000,0.871,214,0.214,85,0.085,44
8145,7576,569,1424,18,9000,849,1000,0.849,243,0.243,92,0.092,44
9000,8336,664,1664,19,10000,855,1000,0.855,240,0.24,95,0.095,44
9808,9039,769,1961,20,11000,808,1000,0.808,297,0.297,105,0.105,44
10629,9750,879,2250,21,12000,821,1000,0.821,289,0.289,110,0.11,44
11450,10464,986,2536,22,13000,821,1000,0.821,286,0.286,107,0.107,44
12238,11120,1118,2880,23,14000,788,1000,0.788,344,0.344,132,0.132,44
13022,11788,1234,3212,24,15000,784,1000,0.784,332,0.332,116,0.116,44
13804,12456,1348,3544,25,16000,782,1000,0.782,332,0.332,114,0.114,44
14580,13114,1466,3886,26,17000,776,1000,0.776,342,0.342,118,0.118,44
15349,13748,1601,4252,27,18000,769,1000,0.769,366,0.366,135,0.135,44
16084,14344,1740,4656,28,19000,735,1000,0.735,404,0.404,139,0.139,44
16843,14985,1858,5015,29,20000,759,1000,0.759,359,0.359,118,0.118,44
17608,15632,1976,5368,30,21000,765,1000,0.765,353,0.353,118,0.118,44
18349,16232,2117,5768,31,22000,741,1000,0.741,400,0.4,141,0.141,44
19060,16796,2264,6204,32,23000,711,1000,0.711,436,0.436,147,0.147,44
19756,17343,2413,6657,33,24000,696,1000,0.696,453,0.453,149,0.149,44
20488,17937,2551,7063,34,25000,732,1000,0.732,406,0.406,138,0.138,44
21221,18538,2683,7462,35,26000,733,1000,0.733,399,0.399,132,0.132,44
21953,19144,2809,7856,36,27000,732,1000,0.732,394,0.394,126,0.126,44
22658,19706,2952,8294,37,28000,705,1000,0.705,438,0.438,143,0.143,44
23345,20229,3116,8771,38,29000,687,1000,0.687,477,0.477,164,0.164,44
24047,20785,3262,9215,39,30000,702,1000,0.702,444,0.444,146,0.146,44
24763,21369,3394,9631,40,31000,716,1000,0.716,416,0.416,132,0.132,44
25440,21886,3554,10114,41,32000,677,1000,0.677,483,0.483,160,0.16,44
26142,22437,3705,10563,42,33000,702,1000,0.702,449,0.449,151,0.151,44
26788,22927,3861,11073,43,34000,646,1000,0.646,510,0.51,156,0.156,44
27465,23439,4026,11561,44,35000,677,1000,0.677,488,0.488,165,0.165,44
28158,23993,4165,12007,45,36000,693,1000,0.693,446,0.446,139,0.139,44
28855,24557,4298,12443,46,37000,697,1000,0.697,436,0.436,133,0.133,44
29506,25052,4454,12948,47,38000,651,1000,0.651,505,0.505,156,0.156,44
30147,25537,4610,13463,48,39000,641,1000,0.641,515,0.515,156,0.156,44
30809,26042,4767,13958,49,40000,662,1000,0.662,495,0.495,157,0.157,44
31463,26555,4908,14445,50,41000,654,1000,0.654,487,0.487,141,0.141,44
32091,27012,5079,14988,51,42000,628,1000,0.628,543,0.543,171,0.171,44
32738,27503,5235,15497,52,43000,647,1000,0.647,509,0.509,156,0.156,44
33388,27990,5398,16010,53,44000,650,1000,0.65,513,0.513,163,0.163,44
34039,28478,5561,16522,54,45000,651,1000,0.651,512,0.512,163,0.163,44
34689,28972,5717,17028,55,46000,650,1000,0.65,506,0.506,156,0.156,44
35289,29416,5873,17584,56,47000,600,1000,0.6,556,0.556,156,0.156,44
35922,29891,6031,18109,57,48000,633,1000,0.633,525,0.525,158,0.158,44
36544,30352,6192,18648,58,49000,622,1000,0.622,539,0.539,161,0.161,44
37190,30850,6340,19150,59,50000,646,1000,0.646,502,0.502,148,0.148,44
37820,31329,6491,19671,60,51000,630,1000,0.63,521,0.521,151,0.151,44
38439,31808,6631,20192,61,52000,619,1000,0.619,521,0.521,140,0.14,44
39034,32237,6797,20763,62,53000,595,1000,0.595,571,0.571,166,0.166,44
39645,32679,6966,21321,63,54000,611,1000,0.611,558,0.558,169,0.169,44
40247,33108,7139,21892,64,55000,602,1000,0.602,571,0.571,173,0.173,44
40854,33552,7302,22448,65,56000,607,1000,0.607,556,0.556,163,0.163,44
41423,33927,7496,23073,66,57000,569,1000,0.569,625,0.625,194,0.194,44
41997,34321,7676,23679,67,58000,574,1000,0.574,606,0.606,180,0.18,44
42576,34737,7839,24263,68,59000,579,1000,0.579,584,0.584,163,0.163,44
43160,35152,8008,24848,69,60000,584,1000,0.584,585,0.585,169,0.169,44
43747,35588,8159,25412,70,61000,587,1000,0.587,564,0.564,151,0.151,44
44333,36002,8331,25998,71,62000,586,1000,0.586,586,0.586,172,0.172,44
44953,36458,8495,26542,72,63000,620,1000,0.62,544,0.544,164,0.164,44
45529,36860,8669,27140,73,64000,576,1000,0.576,598,0.598,174,0.174,44
46086,37240,8846,27760,74,65000,557,1000,0.557,620,0.62,177,0.177,44
46670,37651,9019,28349,75,66000,584,1000,0.584,589,0.589,173,0.173,44
47247,38047,9200,28953,76,67000,577,1000,0.577,604,0.604,181,0.181,44
47842,38475,9367,29525,77,68000,595,1000,0.595,572,0.572,167,0.167,44
48387,38852,9535,30148,78,69000,545,1000,0.545,623,0.623,168,0.168,44
48963,39254,9709,30746,79,70000,576,1000,0.576,598,0.598,174,0.174,44
49531,39655,9876,31345,80,71000,568,1000,0.568,599,0.599,167,0.167,44
50092,40053,10039,31947,81,72000,561,1000,0.561,602,0.602,163,0.163,44
50645,40444,10201,32556,82,73000,553,1000,0.553,609,0.609,162,0.162,44
51189,40807,10382,33193,83,74000,544,1000,0.544,637,0.637,181,0.181,44
51750,41197,10553,33803,84,75000,561,1000,0.561,610,0.61,171,0.171,44
52283,41550,10733,34450,85,76000,533,1000,0.533,647,0.647,180,0.18,44
52825,41921,10904,35079,86,77000,542,1000,0.542,629,0.629,171,0.171,44
53373,42326,11047,35674,87,78000,548,1000,0.548,595,0.595,143,0.143,44
53898,42696,11202,36304,88,79000,525,1000,0.525,630,0.63,155,0.155,44
54433,43064,11369,36936,89,80000,535,1000,0.535,632,0.632,167,0.167,44
54958,43414,11544,37586,90,81000,525,1000,0.525,650,0.65,175,0.175,44
55513,43795,11718,38205,91,82000,555,1000,0.555,619,0.619,174,0.174,44
56045,44176,11869,38824,92,83000,532,1000,0.532,619,0.619,151,0.151,44
56562,44503,12059,39497,93,84000,517,1000,0.517,673,0.673,190,0.19,44
57087,44857,12230,40143,94,85000,525,1000,0.525,646,0.646,171,0.171,44
57622,45203,12419,40797,95,86000,535,1000,0.535,654,0.654,189,0.189,44
58143,45532,12611,41468,96,87000,521,1000,0.521,671,0.671,192,0.192,44
58677,45888,12789,42112,97,88000,534,1000,0.534,644,0.644,178,0.178,44
59233,46283,12950,42717,98,89000,556,1000,0.556,605,0.605,161,0.161,44
59794,46691,13103,43309,99,90000,561,1000,0.561,592,0.592,153,0.153,44
60301,47023,13278,43977,100,91000,507,1000,0.507,668,0.668,175,0.175,44
60816,47359,13457,44641,101,92000,515,1000,0.515,664,0.664,179,0.179,44
61330,47687,13643,45313,102,93000,514,1000,0.514,672,0.672,186,0.186,44
61860,48044,13816,45956,103,94000,530,1000,0.53,643,0.643,173,0.173,44
62380,48399,13981,46601,104,95000,520,1000,0.52,645,0.645,165,0.165,44
62913,48782,14131,47218,105,96000,533,1000,0.533,617,0.617,150,0.15,44
63406,49084,14322,47916,106,97000,493,1000,0.493,698,0.698,191,0.191,44
63908,49410,14498,48590,107,98000,502,1000,0.502,674,0.674,176,0.176,44
64419,49771,14648,49229,108,99000,511,1000,0.511,639,0.639,150,0.15,44
64876,50043,14833,49957,109,100000,457,1000,0.457,728,0.728,185,0.185,44
65380,50373,15007,50627,110,101000,504,1000,0.504,670,0.67,174,0.174,44
65861,50691,15170,51309,111,102000,481,1000,0.481,682,0.682,163,0.163,44
66367,51052,15315,51948,112,103000,506,1000,0.506,639,0.639,145,0.145,44
66869,51388,15481,52612,113,104000,502,1000,0.502,664,0.664,166,0.166,44
67344,51692,15652,53308,114,105000,475,1000,0.475,696,0.696,171,0.171,44
67851,52031,15820,53969,115,106000,507,1000,0.507,661,0.661,168,0.168,44
68344,52347,15997,54653,116,107000,493,1000,0.493,684,0.684,177,0.177,44
68822,52647,16175,55353,117,108000,478,1000,0.478,700,0.7,178,0.178,44
69308,52971,16337,56029,118,109000,486,1000,0.486,676,0.676,162,0.162,44
69798,53294,16504,56706,119,110000,490,1000,0.49,677,0.677,167,0.167,44
70277,53604,16673,57396,120,111000,479,1000,0.479,690,0.69,169,0.169,44
70762,53917,16845,58083,121,112000,485,1000,0.485,687,0.687,172,0.172,44
71251,54223,17028,58777,122,113000,489,1000,0.489,694,0.694,183,0.183,44
71731,54559,17172,59441,123,114000,480,1000,0.48,664,0.664,144,0.144,44
71869,54638,17231,59660,124,114298,138,298,0.46308724832214765,219,0.7348993288590604,59,0.19798657718120805,44
100,100,0,0,1,100,NA,NA,NA,NA,NA,NA,NA,45
200,200,0,0,2,200,100,100,1,0,0,0,0,45
298,296,2,4,3,300,98,100,0.98,4,0.04,2,0.02,45
397,394,3,6,4,400,99,100,0.99,2,0.02,1,0.01,45
496,492,4,8,5,500,99,100,0.99,2,0.02,1,0.01,45
596,592,4,8,6,600,100,100,1,0,0,0,0,45
693,687,6,13,7,700,97,100,0.97,5,0.05,2,0.02,45
792,785,7,15,8,800,99,100,0.99,2,0.02,1,0.01,45
891,883,8,17,9,900,99,100,0.99,2,0.02,1,0.01,45
989,979,10,21,10,1000,98,100,0.98,4,0.04,2,0.02,45
1939,1890,49,110,11,2000,950,1000,0.95,89,0.089,39,0.039,45
2886,2796,90,204,12,3000,947,1000,0.947,94,0.094,41,0.041,45
3820,3684,136,316,13,4000,934,1000,0.934,112,0.112,46,0.046,45
4722,4524,198,476,14,5000,902,1000,0.902,160,0.16,62,0.062,45
5605,5324,281,676,15,6000,883,1000,0.883,200,0.2,83,0.083,45
6476,6114,362,886,16,7000,871,1000,0.871,210,0.21,81,0.081,45
7341,6893,448,1107,17,8000,865,1000,0.865,221,0.221,86,0.086,45
8177,7624,553,1376,18,9000,836,1000,0.836,269,0.269,105,0.105,45
9019,8372,647,1628,19,10000,842,1000,0.842,252,0.252,94,0.094,45
9855,9102,753,1898,20,11000,836,1000,0.836,270,0.27,106,0.106,45
10661,9788,873,2212,21,12000,806,1000,0.806,314,0.314,120,0.12,45
11475,10491,984,2509,22,13000,814,1000,0.814,297,0.297,111,0.111,45
12287,11191,1096,2809,23,14000,812,1000,0.812,300,0.3,112,0.112,45
13084,11870,1214,3130,24,15000,797,1000,0.797,321,0.321,118,0.118,45
13887,12567,1320,3433,25,16000,803,1000,0.803,303,0.303,106,0.106,45
14667,13225,1442,3775,26,17000,780,1000,0.78,342,0.342,122,0.122,45
15459,13901,1558,4099,27,18000,792,1000,0.792,324,0.324,116,0.116,45
16241,14567,1674,4433,28,19000,782,1000,0.782,334,0.334,116,0.116,45
16998,15195,1803,4805,29,20000,757,1000,0.757,372,0.372,129,0.129,45
17743,15807,1936,5193,30,21000,745,1000,0.745,388,0.388,133,0.133,45
18485,16419,2066,5581,31,22000,742,1000,0.742,388,0.388,130,0.13,45
19209,17011,2198,5989,32,23000,724,1000,0.724,408,0.408,132,0.132,45
19939,17603,2336,6397,33,24000,730,1000,0.73,408,0.408,138,0.138,45
20676,18216,2460,6784,34,25000,737,1000,0.737,387,0.387,124,0.124,45
21401,18777,2624,7223,35,26000,725,1000,0.725,439,0.439,164,0.164,45
22143,19389,2754,7611,36,27000,742,1000,0.742,388,0.388,130,0.13,45
22833,19935,2898,8065,37,28000,690,1000,0.69,454,0.454,144,0.144,45
23537,20487,3050,8513,38,29000,704,1000,0.704,448,0.448,152,0.152,45
24233,21052,3181,8948,39,30000,696,1000,0.696,435,0.435,131,0.131,45
24894,21542,3352,9458,40,31000,661,1000,0.661,510,0.51,171,0.171,45
25545,22031,3514,9969,41,32000,651,1000,0.651,511,0.511,162,0.162,45
26218,22542,3676,10458,42,33000,673,1000,0.673,489,0.489,162,0.162,45
26912,23097,3815,10903,43,34000,694,1000,0.694,445,0.445,139,0.139,45
27594,23632,3962,11368,44,35000,682,1000,0.682,465,0.465,147,0.147,45
28267,24160,4107,11840,45,36000,673,1000,0.673,472,0.472,145,0.145,45
28909,24640,4269,12360,46,37000,642,1000,0.642,520,0.52,162,0.162,45
29566,25152,4414,12848,47,38000,657,1000,0.657,488,0.488,145,0.145,45
30228,25664,4564,13336,48,39000,662,1000,0.662,488,0.488,150,0.15,45
30878,26162,4716,13838,49,40000,650,1000,0.65,502,0.502,152,0.152,45
31509,26607,4902,14393,50,41000,631,1000,0.631,555,0.555,186,0.186,45
32155,27074,5081,14926,51,42000,646,1000,0.646,533,0.533,179,0.179,45
32812,27585,5227,15415,52,43000,657,1000,0.657,489,0.489,146,0.146,45
33470,28096,5374,15904,53,44000,658,1000,0.658,489,0.489,147,0.147,45
34082,28539,5543,16461,54,45000,612,1000,0.612,557,0.557,169,0.169,45
34716,28996,5720,17004,55,46000,634,1000,0.634,543,0.543,177,0.177,45
35335,29450,5885,17550,56,47000,619,1000,0.619,546,0.546,165,0.165,45
35937,29873,6064,18127,57,48000,602,1000,0.602,577,0.577,179,0.179,45
36584,30353,6231,18647,58,49000,647,1000,0.647,520,0.52,167,0.167,45
37207,30812,6395,19188,59,50000,623,1000,0.623,541,0.541,164,0.164,45
37847,31308,6539,19692,60,51000,640,1000,0.64,504,0.504,144,0.144,45
38486,31776,6710,20224,61,52000,639,1000,0.639,532,0.532,171,0.171,45
39100,32230,6870,20770,62,53000,614,1000,0.614,546,0.546,160,0.16,45
39710,32684,7026,21316,63,54000,610,1000,0.61,546,0.546,156,0.156,45
40321,33143,7178,21857,64,55000,611,1000,0.611,541,0.541,152,0.152,45
40896,33550,7346,22450,65,56000,575,1000,0.575,593,0.593,168,0.168,45
41518,34028,7490,22972,66,57000,622,1000,0.622,522,0.522,144,0.144,45
42115,34447,7668,23553,67,58000,597,1000,0.597,581,0.581,178,0.178,45
42730,34922,7808,24078,68,59000,615,1000,0.615,525,0.525,140,0.14,45
43298,35340,7958,24660,69,60000,568,1000,0.568,582,0.582,150,0.15,45
43859,35706,8153,25294,70,61000,561,1000,0.561,634,0.634,195,0.195,45
44422,36097,8325,25903,71,62000,563,1000,0.563,609,0.609,172,0.172,45
45020,36525,8495,26475,72,63000,598,1000,0.598,572,0.572,170,0.17,45
45627,36989,8638,27011,73,64000,607,1000,0.607,536,0.536,143,0.143,45
46207,37401,8806,27599,74,65000,580,1000,0.58,588,0.588,168,0.168,45
46779,37807,8972,28193,75,66000,572,1000,0.572,594,0.594,166,0.166,45
47359,38223,9136,28777,76,67000,580,1000,0.58,584,0.584,164,0.164,45
47921,38623,9298,29377,77,68000,562,1000,0.562,600,0.6,162,0.162,45
48488,39026,9462,29974,78,69000,567,1000,0.567,597,0.597,164,0.164,45
49023,39382,9641,30618,79,70000,535,1000,0.535,644,0.644,179,0.179,45
49585,39793,9792,31207,80,71000,562,1000,0.562,589,0.589,151,0.151,45
50140,40173,9967,31827,81,72000,555,1000,0.555,620,0.62,175,0.175,45
50711,40581,10130,32419,82,73000,571,1000,0.571,592,0.592,163,0.163,45
51268,40949,10319,33051,83,74000,557,1000,0.557,632,0.632,189,0.189,45
51841,41370,10471,33630,84,75000,573,1000,0.573,579,0.579,152,0.152,45
52400,41768,10632,34232,85,76000,559,1000,0.559,602,0.602,161,0.161,45
52960,42170,10790,34830,86,77000,560,1000,0.56,598,0.598,158,0.158,45
53498,42538,10960,35462,87,78000,538,1000,0.538,632,0.632,170,0.17,45
54012,42866,11146,36134,88,79000,514,1000,0.514,672,0.672,186,0.186,45
54543,43218,11325,36782,89,80000,531,1000,0.531,648,0.648,179,0.179,45
55077,43572,11505,37428,90,81000,534,1000,0.534,646,0.646,180,0.18,45
55620,43959,11661,38041,91,82000,543,1000,0.543,613,0.613,156,0.156,45
56128,44291,11837,38709,92,83000,508,1000,0.508,668,0.668,176,0.176,45
56663,44652,12011,39348,93,84000,535,1000,0.535,639,0.639,174,0.174,45
57204,45025,12179,39975,94,85000,541,1000,0.541,627,0.627,168,0.168,45
57746,45394,12352,40606,95,86000,542,1000,0.542,631,0.631,173,0.173,45
58265,45743,12522,41257,96,87000,519,1000,0.519,651,0.651,170,0.17,45
58805,46120,12685,41880,97,88000,540,1000,0.54,623,0.623,163,0.163,45
59358,46514,12844,42486,98,89000,553,1000,0.553,606,0.606,159,0.159,45
59883,46862,13021,43138,99,90000,525,1000,0.525,652,0.652,177,0.177,45
60387,47181,13206,43819,100,91000,504,1000,0.504,681,0.681,185,0.185,45
60892,47505,13387,44495,101,92000,505,1000,0.505,676,0.676,181,0.181,45
61394,47829,13565,45171,102,93000,502,1000,0.502,676,0.676,178,0.178,45
61879,48132,13747,45868,103,94000,485,1000,0.485,697,0.697,182,0.182,45
62384,48468,13916,46532,104,95000,505,1000,0.505,664,0.664,169,0.169,45
62909,48827,14082,47173,105,96000,525,1000,0.525,641,0.641,166,0.166,45
63424,49154,14270,47846,106,97000,515,1000,0.515,673,0.673,188,0.188,45
63940,49510,14430,48490,107,98000,516,1000,0.516,644,0.644,160,0.16,45
64454,49857,14597,49143,108,99000,514,1000,0.514,653,0.653,167,0.167,45
64937,50166,14771,49834,109,100000,483,1000,0.483,691,0.691,174,0.174,45
65439,50499,14940,50501,110,101000,502,1000,0.502,667,0.667,169,0.169,45
65978,50889,15089,51111,111,102000,539,1000,0.539,610,0.61,149,0.149,45
66473,51222,15251,51778,112,103000,495,1000,0.495,667,0.667,162,0.162,45
66963,51522,15441,52478,113,104000,490,1000,0.49,700,0.7,190,0.19,45
67439,51794,15645,53206,114,105000,476,1000,0.476,728,0.728,204,0.204,45
67895,52072,15823,53928,115,106000,456,1000,0.456,722,0.722,178,0.178,45
68378,52379,15999,54621,116,107000,483,1000,0.483,693,0.693,176,0.176,45
68859,52701,16158,55299,117,108000,481,1000,0.481,678,0.678,159,0.159,45
69338,52998,16340,56002,118,109000,479,1000,0.479,703,0.703,182,0.182,45
69806,53299,16507,56701,119,110000,468,1000,0.468,699,0.699,167,0.167,45
70277,53586,16691,57414,120,111000,471,1000,0.471,713,0.713,184,0.184,45
70756,53885,16871,58115,121,112000,479,1000,0.479,701,0.701,180,0.18,45
71230,54205,17025,58795,122,113000,474,1000,0.474,680,0.68,154,0.154,45
71721,54534,17187,59466,123,114000,491,1000,0.491,671,0.671,162,0.162,45
71869,54638,17231,59660,124,114298,148,298,0.49664429530201343,194,0.6510067114093959,44,0.1476510067114094,45
100,100,0,0,1,100,NA,NA,NA,NA,NA,NA,NA,46
200,200,0,0,2,200,100,100,1,0,0,0,0,46
299,298,1,2,3,300,99,100,0.99,2,0.02,1,0.01,46
398,396,2,4,4,400,99,100,0.99,2,0.02,1,0.01,46
496,493,3,7,5,500,98,100,0.98,3,0.03,1,0.01,46
594,590,4,10,6,600,98,100,0.98,3,0.03,1,0.01,46
690,682,8,18,7,700,96,100,0.96,8,0.08,4,0.04,46
785,773,12,27,8,800,95,100,0.95,9,0.09,4,0.04,46
885,873,12,27,9,900,100,100,1,0,0,0,0,46
983,969,14,31,10,1000,98,100,0.98,4,0.04,2,0.02,46
1933,1885,48,115,11,2000,950,1000,0.95,84,0.084,34,0.034,46
2866,2772,94,228,12,3000,933,1000,0.933,113,0.113,46,0.046,46
3798,3662,136,338,13,4000,932,1000,0.932,110,0.11,42,0.042,46
4682,4473,209,527,14,5000,884,1000,0.884,189,0.189,73,0.073,46
5567,5284,283,716,15,6000,885,1000,0.885,189,0.189,74,0.074,46
6437,6073,364,927,16,7000,870,1000,0.87,211,0.211,81,0.081,46
7280,6809,471,1191,17,8000,843,1000,0.843,264,0.264,107,0.107,46
8124,7564,560,1436,18,9000,844,1000,0.844,245,0.245,89,0.089,46
8985,8347,638,1653,19,10000,861,1000,0.861,217,0.217,78,0.078,46
9795,9044,751,1956,20,11000,810,1000,0.81,303,0.303,113,0.113,46
10640,9786,854,2214,21,12000,845,1000,0.845,258,0.258,103,0.103,46
11449,10484,965,2516,22,13000,809,1000,0.809,302,0.302,111,0.111,46
12244,11164,1080,2836,23,14000,795,1000,0.795,320,0.32,115,0.115,46
13051,11867,1184,3133,24,15000,807,1000,0.807,297,0.297,104,0.104,46
13824,12513,1311,3487,25,16000,773,1000,0.773,354,0.354,127,0.127,46
14611,13170,1441,3830,26,17000,787,1000,0.787,343,0.343,130,0.13,46
15364,13805,1559,4195,27,18000,753,1000,0.753,365,0.365,118,0.118,46
16161,14485,1676,4515,28,19000,797,1000,0.797,320,0.32,117,0.117,46
16903,15081,1822,4919,29,20000,742,1000,0.742,404,0.404,146,0.146,46
17635,15668,1967,5332,30,21000,732,1000,0.732,413,0.413,145,0.145,46
18380,16289,2091,5711,31,22000,745,1000,0.745,379,0.379,124,0.124,46
19124,16892,2232,6108,32,23000,744,1000,0.744,397,0.397,141,0.141,46
19849,17463,2386,6537,33,24000,725,1000,0.725,429,0.429,154,0.154,46
20587,18073,2514,6927,34,25000,738,1000,0.738,390,0.39,128,0.128,46
21317,18657,2660,7343,35,26000,730,1000,0.73,416,0.416,146,0.146,46
22045,19236,2809,7764,36,27000,728,1000,0.728,421,0.421,149,0.149,46
22773,19824,2949,8176,37,28000,728,1000,0.728,412,0.412,140,0.14,46
23472,20375,3097,8625,38,29000,699,1000,0.699,449,0.449,148,0.148,46
24175,20950,3225,9050,39,30000,703,1000,0.703,425,0.425,128,0.128,46
24870,21497,3373,9503,40,31000,695,1000,0.695,453,0.453,148,0.148,46
25577,22063,3514,9937,41,32000,707,1000,0.707,434,0.434,141,0.141,46
26259,22598,3661,10402,42,33000,682,1000,0.682,465,0.465,147,0.147,46
26949,23120,3829,10880,43,34000,690,1000,0.69,478,0.478,168,0.168,46
27607,23624,3983,11376,44,35000,658,1000,0.658,496,0.496,154,0.154,46
28270,24127,4143,11873,45,36000,663,1000,0.663,497,0.497,160,0.16,46
28945,24655,4290,12345,46,37000,675,1000,0.675,472,0.472,147,0.147,46
29624,25185,4439,12815,47,38000,679,1000,0.679,470,0.47,149,0.149,46
30272,25672,4600,13328,48,39000,648,1000,0.648,513,0.513,161,0.161,46
30919,26172,4747,13828,49,40000,647,1000,0.647,500,0.5,147,0.147,46
31571,26673,4898,14327,50,41000,652,1000,0.652,499,0.499,151,0.151,46
32200,27137,5063,14863,51,42000,629,1000,0.629,536,0.536,165,0.165,46
32822,27591,5231,15409,52,43000,622,1000,0.622,546,0.546,168,0.168,46
33463,28068,5395,15932,53,44000,641,1000,0.641,523,0.523,164,0.164,46
34101,28540,5561,16460,54,45000,638,1000,0.638,528,0.528,166,0.166,46
34710,28985,5725,17015,55,46000,609,1000,0.609,555,0.555,164,0.164,46
35357,29485,5872,17515,56,47000,647,1000,0.647,500,0.5,147,0.147,46
35975,29967,6008,18033,57,48000,618,1000,0.618,518,0.518,136,0.136,46
36591,30421,6170,18579,58,49000,616,1000,0.616,546,0.546,162,0.162,46
37189,30844,6345,19156,59,50000,598,1000,0.598,577,0.577,175,0.175,46
37791,31260,6531,19740,60,51000,602,1000,0.602,584,0.584,186,0.186,46
38412,31709,6703,20291,61,52000,621,1000,0.621,551,0.551,172,0.172,46
39020,32155,6865,20845,62,53000,608,1000,0.608,554,0.554,162,0.162,46
39626,32595,7031,21405,63,54000,606,1000,0.606,560,0.56,166,0.166,46
40218,33030,7188,21970,64,55000,592,1000,0.592,565,0.565,157,0.157,46
40830,33475,7355,22525,65,56000,612,1000,0.612,555,0.555,167,0.167,46
41415,33888,7527,23112,66,57000,585,1000,0.585,587,0.587,172,0.172,46
42027,34340,7687,23660,67,58000,612,1000,0.612,548,0.548,160,0.16,46
42643,34812,7831,24188,68,59000,616,1000,0.616,528,0.528,144,0.144,46
43251,35264,7987,24736,69,60000,608,1000,0.608,548,0.548,156,0.156,46
43828,35668,8160,25332,70,61000,577,1000,0.577,596,0.596,173,0.173,46
44389,36047,8342,25953,71,62000,561,1000,0.561,621,0.621,182,0.182,46
44969,36449,8520,26551,72,63000,580,1000,0.58,598,0.598,178,0.178,46
45538,36850,8688,27150,73,64000,569,1000,0.569,599,0.599,168,0.168,46
46093,37203,8890,27797,74,65000,555,1000,0.555,647,0.647,202,0.202,46
46677,37627,9050,28373,75,66000,584,1000,0.584,576,0.576,160,0.16,46
47258,38064,9194,28936,76,67000,581,1000,0.581,563,0.563,144,0.144,46
47817,38460,9357,29540,77,68000,559,1000,0.559,604,0.604,163,0.163,46
48400,38878,9522,30122,78,69000,583,1000,0.583,582,0.582,165,0.165,46
48963,39298,9665,30702,79,70000,563,1000,0.563,580,0.58,143,0.143,46
49536,39712,9824,31288,80,71000,573,1000,0.573,586,0.586,159,0.159,46
50054,40036,10018,31964,81,72000,518,1000,0.518,676,0.676,194,0.194,46
50581,40399,10182,32601,82,73000,527,1000,0.527,637,0.637,164,0.164,46
51134,40778,10356,33222,83,74000,553,1000,0.553,621,0.621,174,0.174,46
51700,41180,10520,33820,84,75000,566,1000,0.566,598,0.598,164,0.164,46
52254,41590,10664,34410,85,76000,554,1000,0.554,590,0.59,144,0.144,46
52785,41929,10856,35071,86,77000,531,1000,0.531,661,0.661,192,0.192,46
53348,42329,11019,35671,87,78000,563,1000,0.563,600,0.6,163,0.163,46
53896,42719,11177,36281,88,79000,548,1000,0.548,610,0.61,158,0.158,46
54437,43090,11347,36910,89,80000,541,1000,0.541,629,0.629,170,0.17,46
54957,43441,11516,37559,90,81000,520,1000,0.52,649,0.649,169,0.169,46
55483,43792,11691,38208,91,82000,526,1000,0.526,649,0.649,175,0.175,46
56021,44140,11881,38860,92,83000,538,1000,0.538,652,0.652,190,0.19,46
56544,44492,12052,39508,93,84000,523,1000,0.523,648,0.648,171,0.171,46
57097,44877,12220,40123,94,85000,553,1000,0.553,615,0.615,168,0.168,46
57646,45250,12396,40750,95,86000,549,1000,0.549,627,0.627,176,0.176,46
58151,45587,12564,41413,96,87000,505,1000,0.505,663,0.663,168,0.168,46
58663,45917,12746,42083,97,88000,512,1000,0.512,670,0.67,182,0.182,46
59175,46250,12925,42750,98,89000,512,1000,0.512,667,0.667,179,0.179,46
59688,46569,13119,43431,99,90000,513,1000,0.513,681,0.681,194,0.194,46
60216,46928,13288,44072,100,91000,528,1000,0.528,641,0.641,169,0.169,46
60745,47291,13454,44709,101,92000,529,1000,0.529,637,0.637,166,0.166,46
61268,47642,13626,45358,102,93000,523,1000,0.523,649,0.649,172,0.172,46
61778,47980,13798,46020,103,94000,510,1000,0.51,662,0.662,172,0.172,46
62275,48289,13986,46711,104,95000,497,1000,0.497,691,0.691,188,0.188,46
62778,48590,14188,47410,105,96000,503,1000,0.503,699,0.699,202,0.202,46
63278,48904,14374,48096,106,97000,500,1000,0.5,686,0.686,186,0.186,46
63798,49267,14531,48733,107,98000,520,1000,0.52,637,0.637,157,0.157,46
64346,49661,14685,49339,108,99000,548,1000,0.548,606,0.606,154,0.154,46
64851,50014,14837,49986,109,100000,505,1000,0.505,647,0.647,152,0.152,46
65350,50341,15009,50659,110,101000,499,1000,0.499,673,0.673,172,0.172,46
65853,50663,15190,51337,111,102000,503,1000,0.503,678,0.678,181,0.181,46
66356,51020,15336,51980,112,103000,503,1000,0.503,643,0.643,146,0.146,46
66838,51324,15514,52676,113,104000,482,1000,0.482,696,0.696,178,0.178,46
67382,51699,15683,53301,114,105000,544,1000,0.544,625,0.625,169,0.169,46
67865,52025,15840,53975,115,106000,483,1000,0.483,674,0.674,157,0.157,46
68374,52374,16000,54626,116,107000,509,1000,0.509,651,0.651,160,0.16,46
68887,52732,16155,55268,117,108000,513,1000,0.513,642,0.642,155,0.155,46
69357,53043,16314,55957,118,109000,470,1000,0.47,689,0.689,159,0.159,46
69852,53372,16480,56628,119,110000,495,1000,0.495,671,0.671,166,0.166,46
70328,53665,16663,57335,120,111000,476,1000,0.476,707,0.707,183,0.183,46
70811,53985,16826,58015,121,112000,483,1000,0.483,680,0.68,163,0.163,46
71272,54270,17002,58730,122,113000,461,1000,0.461,715,0.715,176,0.176,46
71729,54538,17191,59462,123,114000,457,1000,0.457,732,0.732,189,0.189,46
71869,54638,17231,59660,124,114298,140,298,0.4697986577181208,198,0.6644295302013423,40,0.1342281879194631,46
100,100,0,0,1,100,NA,NA,NA,NA,NA,NA,NA,47
199,198,1,2,2,200,99,100,0.99,2,0.02,1,0.01,47
299,298,1,2,3,300,100,100,1,0,0,0,0,47
399,398,1,2,4,400,100,100,1,0,0,0,0,47
497,494,3,6,5,500,98,100,0.98,4,0.04,2,0.02,47
595,591,4,9,6,600,98,100,0.98,3,0.03,1,0.01,47
690,681,9,19,7,700,95,100,0.95,10,0.1,5,0.05,47
786,775,11,25,8,800,96,100,0.96,6,0.06,2,0.02,47
883,870,13,30,9,900,97,100,0.97,5,0.05,2,0.02,47
980,965,15,35,10,1000,97,100,0.97,5,0.05,2,0.02,47
1937,1883,54,117,11,2000,957,1000,0.957,82,0.082,39,0.039,47
2862,2754,108,246,12,3000,925,1000,0.925,129,0.129,54,0.054,47
3772,3602,170,398,13,4000,910,1000,0.91,152,0.152,62,0.062,47
4677,4444,233,556,14,5000,905,1000,0.905,158,0.158,63,0.063,47
5562,5262,300,738,15,6000,885,1000,0.885,182,0.182,67,0.067,47
6435,6053,382,947,16,7000,873,1000,0.873,209,0.209,82,0.082,47
7296,6819,477,1181,17,8000,861,1000,0.861,234,0.234,95,0.095,47
8133,7559,574,1441,18,9000,837,1000,0.837,260,0.26,97,0.097,47
8958,8279,679,1721,19,10000,825,1000,0.825,280,0.28,105,0.105,47
9768,8971,797,2029,20,11000,810,1000,0.81,308,0.308,118,0.118,47
10581,9675,906,2325,21,12000,813,1000,0.813,296,0.296,109,0.109,47
11377,10357,1020,2643,22,13000,796,1000,0.796,318,0.318,114,0.114,47
12209,11097,1112,2903,23,14000,832,1000,0.832,260,0.26,92,0.092,47
13012,11792,1220,3208,24,15000,803,1000,0.803,305,0.305,108,0.108,47
13784,12433,1351,3567,25,16000,772,1000,0.772,359,0.359,131,0.131,47
14549,13073,1476,3927,26,17000,765,1000,0.765,360,0.36,125,0.125,47
15333,13734,1599,4266,27,18000,784,1000,0.784,339,0.339,123,0.123,47
16102,14379,1723,4621,28,19000,769,1000,0.769,355,0.355,124,0.124,47
16855,15012,1843,4988,29,20000,753,1000,0.753,367,0.367,120,0.12,47
17612,15646,1966,5354,30,21000,757,1000,0.757,366,0.366,123,0.123,47
18355,16264,2091,5736,31,22000,743,1000,0.743,382,0.382,125,0.125,47
19071,16844,2227,6156,32,23000,716,1000,0.716,420,0.42,136,0.136,47
19816,17455,2361,6545,33,24000,745,1000,0.745,389,0.389,134,0.134,47
20535,18022,2513,6978,34,25000,719,1000,0.719,433,0.433,152,0.152,47
21237,18578,2659,7422,35,26000,702,1000,0.702,444,0.444,146,0.146,47
21973,19180,2793,7820,36,27000,736,1000,0.736,398,0.398,134,0.134,47
22698,19771,2927,8229,37,28000,725,1000,0.725,409,0.409,134,0.134,47
23401,20328,3073,8672,38,29000,703,1000,0.703,443,0.443,146,0.146,47
24104,20887,3217,9113,39,30000,703,1000,0.703,441,0.441,144,0.144,47
24805,21433,3372,9567,40,31000,701,1000,0.701,454,0.454,155,0.155,47
25485,21963,3522,10037,41,32000,680,1000,0.68,470,0.47,150,0.15,47
26169,22478,3691,10522,42,33000,684,1000,0.684,485,0.485,169,0.169,47
26830,22993,3837,11007,43,34000,661,1000,0.661,485,0.485,146,0.146,47
27489,23509,3980,11491,44,35000,659,1000,0.659,484,0.484,143,0.143,47
28165,24038,4127,11962,45,36000,676,1000,0.676,471,0.471,147,0.147,47
28843,24565,4278,12435,46,37000,678,1000,0.678,473,0.473,151,0.151,47
29515,25092,4423,12908,47,38000,672,1000,0.672,473,0.473,145,0.145,47
30168,25595,4573,13405,48,39000,653,1000,0.653,497,0.497,150,0.15,47
30838,26125,4713,13875,49,40000,670,1000,0.67,470,0.47,140,0.14,47
31477,26612,4865,14388,50,41000,639,1000,0.639,513,0.513,152,0.152,47
32160,27157,5003,14843,51,42000,683,1000,0.683,455,0.455,138,0.138,47
32800,27638,5162,15362,52,43000,640,1000,0.64,519,0.519,159,0.159,47
33437,28118,5319,15882,53,44000,637,1000,0.637,520,0.52,157,0.157,47
34049,28547,5502,16453,54,45000,612,1000,0.612,571,0.571,183,0.183,47
34680,29026,5654,16974,55,46000,631,1000,0.631,521,0.521,152,0.152,47
35307,29488,5819,17512,56,47000,627,1000,0.627,538,0.538,165,0.165,47
35919,29915,6004,18085,57,48000,612,1000,0.612,573,0.573,185,0.185,47
36541,30371,6170,18629,58,49000,622,1000,0.622,544,0.544,166,0.166,47
37147,30810,6337,19190,59,50000,606,1000,0.606,561,0.561,167,0.167,47
37776,31268,6508,19732,60,51000,629,1000,0.629,542,0.542,171,0.171,47
38394,31732,6662,20268,61,52000,618,1000,0.618,536,0.536,154,0.154,47
39018,32206,6812,20794,62,53000,624,1000,0.624,526,0.526,150,0.15,47
39625,32630,6995,21370,63,54000,607,1000,0.607,576,0.576,183,0.183,47
40236,33073,7163,21927,64,55000,611,1000,0.611,557,0.557,168,0.168,47
40834,33503,7331,22497,65,56000,598,1000,0.598,570,0.57,168,0.168,47
41437,33934,7503,23066,66,57000,603,1000,0.603,569,0.569,172,0.172,47
42052,34405,7647,23595,67,58000,615,1000,0.615,529,0.529,144,0.144,47
42665,34854,7811,24146,68,59000,613,1000,0.613,551,0.551,164,0.164,47
43276,35308,7968,24692,69,60000,611,1000,0.611,546,0.546,157,0.157,47
43844,35699,8145,25301,70,61000,568,1000,0.568,609,0.609,177,0.177,47
44404,36078,8326,25922,71,62000,560,1000,0.56,621,0.621,181,0.181,47
45001,36523,8478,26477,72,63000,597,1000,0.597,555,0.555,152,0.152,47
45567,36908,8659,27092,73,64000,566,1000,0.566,615,0.615,181,0.181,47
46135,37319,8816,27681,74,65000,568,1000,0.568,589,0.589,157,0.157,47
46733,37761,8972,28239,75,66000,598,1000,0.598,558,0.558,156,0.156,47
47296,38148,9148,28852,76,67000,563,1000,0.563,613,0.613,176,0.176,47
47871,38552,9319,29448,77,68000,575,1000,0.575,596,0.596,171,0.171,47
48442,38965,9477,30035,78,69000,571,1000,0.571,587,0.587,158,0.158,47
49016,39377,9639,30623,79,70000,574,1000,0.574,588,0.588,162,0.162,47
49574,39770,9804,31230,80,71000,558,1000,0.558,607,0.607,165,0.165,47
50130,40147,9983,31853,81,72000,556,1000,0.556,623,0.623,179,0.179,47
50714,40584,10130,32416,82,73000,584,1000,0.584,563,0.563,147,0.147,47
51245,40928,10317,33072,83,74000,531,1000,0.531,656,0.656,187,0.187,47
51755,41244,10511,33756,84,75000,510,1000,0.51,684,0.684,194,0.194,47
52293,41606,10687,34394,85,76000,538,1000,0.538,638,0.638,176,0.176,47
52833,41990,10843,35010,86,77000,540,1000,0.54,616,0.616,156,0.156,47
53394,42391,11003,35609,87,78000,561,1000,0.561,599,0.599,160,0.16,47
53914,42741,11173,36259,88,79000,520,1000,0.52,650,0.65,170,0.17,47
54461,43115,11346,36885,89,80000,547,1000,0.547,626,0.626,173,0.173,47
54995,43469,11526,37531,90,81000,534,1000,0.534,646,0.646,180,0.18,47
55553,43854,11699,38146,91,82000,558,1000,0.558,615,0.615,173,0.173,47
56066,44166,11900,38834,92,83000,513,1000,0.513,688,0.688,201,0.201,47
56590,44515,12075,39485,93,84000,524,1000,0.524,651,0.651,175,0.175,47
57129,44900,12229,40100,94,85000,539,1000,0.539,615,0.615,154,0.154,47
57640,45236,12404,40764,95,86000,511,1000,0.511,664,0.664,175,0.175,47
58187,45616,12571,41384,96,87000,547,1000,0.547,620,0.62,167,0.167,47
58705,45933,12772,42067,97,88000,518,1000,0.518,683,0.683,201,0.201,47
59224,46282,12942,42718,98,89000,519,1000,0.519,651,0.651,170,0.17,47
59776,46681,13095,43319,99,90000,552,1000,0.552,601,0.601,153,0.153,47
60305,47058,13247,43942,100,91000,529,1000,0.529,623,0.623,152,0.152,47
60841,47415,13426,44585,101,92000,536,1000,0.536,643,0.643,179,0.179,47
61361,47759,13602,45241,102,93000,520,1000,0.52,656,0.656,176,0.176,47
61865,48072,13793,45928,103,94000,504,1000,0.504,687,0.687,191,0.191,47
62389,48435,13954,46565,104,95000,524,1000,0.524,637,0.637,161,0.161,47
62909,48788,14121,47212,105,96000,520,1000,0.52,647,0.647,167,0.167,47
63414,49127,14287,47873,106,97000,505,1000,0.505,661,0.661,166,0.166,47
63936,49487,14449,48513,107,98000,522,1000,0.522,640,0.64,162,0.162,47
64436,49830,14606,49170,108,99000,500,1000,0.5,657,0.657,157,0.157,47
64942,50161,14781,49839,109,100000,506,1000,0.506,669,0.669,175,0.175,47
65418,50432,14986,50568,110,101000,476,1000,0.476,729,0.729,205,0.205,47
65900,50739,15161,51261,111,102000,482,1000,0.482,693,0.693,175,0.175,47
66367,51028,15339,51972,112,103000,467,1000,0.467,711,0.711,178,0.178,47
66882,51386,15496,52614,113,104000,515,1000,0.515,642,0.642,157,0.157,47
67364,51708,15656,53292,114,105000,482,1000,0.482,678,0.678,160,0.16,47
67832,52016,15816,53984,115,106000,468,1000,0.468,692,0.692,160,0.16,47
68317,52336,15981,54664,116,107000,485,1000,0.485,680,0.68,165,0.165,47
68798,52646,16152,55354,117,108000,481,1000,0.481,690,0.69,171,0.171,47
69287,52967,16320,56033,118,109000,489,1000,0.489,679,0.679,168,0.168,47
69764,53244,16520,56756,119,110000,477,1000,0.477,723,0.723,200,0.2,47
70245,53544,16701,57456,120,111000,481,1000,0.481,700,0.7,181,0.181,47
70739,53863,16876,58137,121,112000,494,1000,0.494,681,0.681,175,0.175,47
71227,54197,17030,58803,122,113000,488,1000,0.488,666,0.666,154,0.154,47
71733,54557,17176,59443,123,114000,506,1000,0.506,640,0.64,146,0.146,47
71869,54638,17231,59660,124,114298,136,298,0.4563758389261745,217,0.7281879194630873,55,0.18456375838926176,47
100,100,0,0,1,100,NA,NA,NA,NA,NA,NA,NA,48
200,200,0,0,2,200,100,100,1,0,0,0,0,48
299,298,1,2,3,300,99,100,0.99,2,0.02,1,0.01,48
399,398,1,2,4,400,100,100,1,0,0,0,0,48
498,496,2,4,5,500,99,100,0.99,2,0.02,1,0.01,48
596,592,4,8,6,600,98,100,0.98,4,0.04,2,0.02,48
695,690,5,10,7,700,99,100,0.99,2,0.02,1,0.01,48
795,790,5,10,8,800,100,100,1,0,0,0,0,48
892,884,8,16,9,900,97,100,0.97,6,0.06,3,0.03,48
986,973,13,27,10,1000,94,100,0.94,11,0.11,5,0.05,48
1940,1887,53,113,11,2000,954,1000,0.954,86,0.086,40,0.04,48
2863,2752,111,248,12,3000,923,1000,0.923,135,0.135,58,0.058,48
3754,3571,183,429,13,4000,891,1000,0.891,181,0.181,72,0.072,48
4645,4395,250,605,14,5000,891,1000,0.891,176,0.176,67,0.067,48
5541,5231,310,769,15,6000,896,1000,0.896,164,0.164,60,0.06,48
6409,6024,385,976,16,7000,868,1000,0.868,207,0.207,75,0.075,48
7266,6799,467,1201,17,8000,857,1000,0.857,225,0.225,82,0.082,48
8108,7537,571,1463,18,9000,842,1000,0.842,262,0.262,104,0.104,48
8958,8294,664,1706,19,10000,850,1000,0.85,243,0.243,93,0.093,48
9809,9056,753,1944,20,11000,851,1000,0.851,238,0.238,89,0.089,48
10596,9715,881,2285,21,12000,787,1000,0.787,341,0.341,128,0.128,48
11419,10432,987,2568,22,13000,823,1000,0.823,283,0.283,106,0.106,48
12214,11111,1103,2889,23,14000,795,1000,0.795,321,0.321,116,0.116,48
12999,11774,1225,3226,24,15000,785,1000,0.785,337,0.337,122,0.122,48
13782,12432,1350,3568,25,16000,783,1000,0.783,342,0.342,125,0.125,48
14564,13092,1472,3908,26,17000,782,1000,0.782,340,0.34,122,0.122,48
15355,13783,1572,4217,27,18000,791,1000,0.791,309,0.309,100,0.1,48
16119,14417,1702,4583,28,19000,764,1000,0.764,366,0.366,130,0.13,48
16878,15046,1832,4954,29,20000,759,1000,0.759,371,0.371,130,0.13,48
17627,15661,1966,5339,30,21000,749,1000,0.749,385,0.385,134,0.134,48
18390,16308,2082,5692,31,22000,763,1000,0.763,353,0.353,116,0.116,48
19142,16939,2203,6061,32,23000,752,1000,0.752,369,0.369,121,0.121,48
19877,17549,2328,6451,33,24000,735,1000,0.735,390,0.39,125,0.125,48
20606,18162,2444,6838,34,25000,729,1000,0.729,387,0.387,116,0.116,48
21331,18739,2592,7261,35,26000,725,1000,0.725,423,0.423,148,0.148,48
22040,19315,2725,7685,36,27000,709,1000,0.709,424,0.424,133,0.133,48
22752,19878,2874,8122,37,28000,712,1000,0.712,437,0.437,149,0.149,48
23482,20483,2999,8517,38,29000,730,1000,0.73,395,0.395,125,0.125,48
24195,21063,3132,8937,39,30000,713,1000,0.713,420,0.42,133,0.133,48
24890,21608,3282,9392,40,31000,695,1000,0.695,455,0.455,150,0.15,48
25599,22171,3428,9829,41,32000,709,1000,0.709,437,0.437,146,0.146,48
26302,22718,3584,10282,42,33000,703,1000,0.703,453,0.453,156,0.156,48
26957,23220,3737,10780,43,34000,655,1000,0.655,498,0.498,153,0.153,48
27623,23738,3885,11262,44,35000,666,1000,0.666,482,0.482,148,0.148,48
28304,24290,4014,11710,45,36000,681,1000,0.681,448,0.448,129,0.129,48
28989,24845,4144,12155,46,37000,685,1000,0.685,445,0.445,130,0.13,48
29666,25381,4285,12619,47,38000,677,1000,0.677,464,0.464,141,0.141,48
30327,25867,4460,13133,48,39000,661,1000,0.661,514,0.514,175,0.175,48
31003,26399,4604,13601,49,40000,676,1000,0.676,468,0.468,144,0.144,48
31648,26869,4779,14131,50,41000,645,1000,0.645,530,0.53,175,0.175,48
32294,27353,4941,14647,51,42000,646,1000,0.646,516,0.516,162,0.162,48
32945,27839,5106,15161,52,43000,651,1000,0.651,514,0.514,165,0.165,48
33583,28324,5259,15676,53,44000,638,1000,0.638,515,0.515,153,0.153,48
34213,28795,5418,16205,54,45000,630,1000,0.63,529,0.529,159,0.159,48
34846,29267,5579,16733,55,46000,633,1000,0.633,528,0.528,161,0.161,48
35476,29721,5755,17279,56,47000,630,1000,0.63,546,0.546,176,0.176,48
36102,30173,5929,17827,57,48000,626,1000,0.626,548,0.548,174,0.174,48
36695,30594,6101,18406,58,49000,593,1000,0.593,579,0.579,172,0.172,48
37343,31091,6252,18909,59,50000,648,1000,0.648,503,0.503,151,0.151,48
37974,31564,6410,19436,60,51000,631,1000,0.631,527,0.527,158,0.158,48
38580,32022,6558,19978,61,52000,606,1000,0.606,542,0.542,148,0.148,48
39195,32476,6719,20524,62,53000,615,1000,0.615,546,0.546,161,0.161,48
39831,32947,6884,21053,63,54000,636,1000,0.636,529,0.529,165,0.165,48
40421,33378,7043,21622,64,55000,590,1000,0.59,569,0.569,159,0.159,48
41026,33824,7202,22176,65,56000,605,1000,0.605,554,0.554,159,0.159,48
41630,34282,7348,22718,66,57000,604,1000,0.604,542,0.542,146,0.146,48
42196,34658,7538,23342,67,58000,566,1000,0.566,624,0.624,190,0.19,48
42785,35092,7693,23908,68,59000,589,1000,0.589,566,0.566,155,0.155,48
43373,35538,7835,24462,69,60000,588,1000,0.588,554,0.554,142,0.142,48
43952,35944,8008,25056,70,61000,579,1000,0.579,594,0.594,173,0.173,48
44529,36358,8171,25642,71,62000,577,1000,0.577,586,0.586,163,0.163,48
45101,36752,8349,26248,72,63000,572,1000,0.572,606,0.606,178,0.178,48
45688,37155,8533,26845,73,64000,587,1000,0.587,597,0.597,184,0.184,48
46278,37579,8699,27421,74,65000,590,1000,0.59,576,0.576,166,0.166,48
46871,38008,8863,27992,75,66000,593,1000,0.593,571,0.571,164,0.164,48
47436,38388,9048,28612,76,67000,565,1000,0.565,620,0.62,185,0.185,48
48005,38780,9225,29220,77,68000,569,1000,0.569,608,0.608,177,0.177,48
48556,39133,9423,29867,78,69000,551,1000,0.551,647,0.647,198,0.198,48
49093,39480,9613,30520,79,70000,537,1000,0.537,653,0.653,190,0.19,48
49655,39868,9787,31132,80,71000,562,1000,0.562,612,0.612,174,0.174,48
50198,40247,9951,31753,81,72000,543,1000,0.543,621,0.621,164,0.164,48
50767,40667,10100,32333,82,73000,569,1000,0.569,580,0.58,149,0.149,48
51318,41024,10294,32976,83,74000,551,1000,0.551,643,0.643,194,0.194,48
51896,41429,10467,33571,84,75000,578,1000,0.578,595,0.595,173,0.173,48
52445,41804,10641,34196,85,76000,549,1000,0.549,625,0.625,174,0.174,48
52989,42166,10823,34834,86,77000,544,1000,0.544,638,0.638,182,0.182,48
53525,42527,10998,35473,87,78000,536,1000,0.536,639,0.639,175,0.175,48
54068,42914,11154,36086,88,79000,543,1000,0.543,613,0.613,156,0.156,48
54604,43260,11344,36740,89,80000,536,1000,0.536,654,0.654,190,0.19,48
55148,43627,11521,37373,90,81000,544,1000,0.544,633,0.633,177,0.177,48
55676,44004,11672,37996,91,82000,528,1000,0.528,623,0.623,151,0.151,48
56218,44368,11850,38632,92,83000,542,1000,0.542,636,0.636,178,0.178,48
56739,44712,12027,39288,93,84000,521,1000,0.521,656,0.656,177,0.177,48
57245,45040,12205,39960,94,85000,506,1000,0.506,672,0.672,178,0.178,48
57795,45427,12368,40573,95,86000,550,1000,0.55,613,0.613,163,0.163,48
58320,45796,12524,41204,96,87000,525,1000,0.525,631,0.631,156,0.156,48
58845,46141,12704,41859,97,88000,525,1000,0.525,655,0.655,180,0.18,48
59365,46484,12881,42516,98,89000,520,1000,0.52,657,0.657,177,0.177,48
59869,46814,13055,43186,99,90000,504,1000,0.504,670,0.67,174,0.174,48
60378,47122,13256,43878,100,91000,509,1000,0.509,692,0.692,201,0.201,48
60875,47438,13437,44562,101,92000,497,1000,0.497,684,0.684,181,0.181,48
61373,47758,13615,45242,102,93000,498,1000,0.498,680,0.68,178,0.178,48
61894,48117,13777,45883,103,94000,521,1000,0.521,641,0.641,162,0.162,48
62378,48429,13949,46571,104,95000,484,1000,0.484,688,0.688,172,0.172,48
62918,48813,14105,47187,105,96000,540,1000,0.54,616,0.616,156,0.156,48
63421,49127,14294,47873,106,97000,503,1000,0.503,686,0.686,189,0.189,48
63922,49466,14456,48534,107,98000,501,1000,0.501,661,0.661,162,0.162,48
64433,49807,14626,49193,108,99000,511,1000,0.511,659,0.659,170,0.17,48
64956,50176,14780,49824,109,100000,523,1000,0.523,631,0.631,154,0.154,48
65444,50487,14957,50513,110,101000,488,1000,0.488,689,0.689,177,0.177,48
65947,50812,15135,51188,111,102000,503,1000,0.503,675,0.675,178,0.178,48
66439,51132,15307,51868,112,103000,492,1000,0.492,680,0.68,172,0.172,48
66943,51477,15466,52523,113,104000,504,1000,0.504,655,0.655,159,0.159,48
67415,51784,15631,53216,114,105000,472,1000,0.472,693,0.693,165,0.165,48
67896,52089,15807,53911,115,106000,481,1000,0.481,695,0.695,176,0.176,48
68355,52383,15972,54617,116,107000,459,1000,0.459,706,0.706,165,0.165,48
68854,52709,16145,55291,117,108000,499,1000,0.499,674,0.674,173,0.173,48
69347,53045,16302,55955,118,109000,493,1000,0.493,664,0.664,157,0.157,48
69828,53351,16477,56649,119,110000,481,1000,0.481,694,0.694,175,0.175,48
70299,53646,16653,57354,120,111000,471,1000,0.471,705,0.705,176,0.176,48
70780,53956,16824,58044,121,112000,481,1000,0.481,690,0.69,171,0.171,48
71272,54263,17009,58737,122,113000,492,1000,0.492,693,0.693,185,0.185,48
71731,54553,17178,59447,123,114000,459,1000,0.459,710,0.71,169,0.169,48
71869,54638,17231,59660,124,114298,138,298,0.46308724832214765,213,0.714765100671141,53,0.17785234899328858,48
100,100,0,0,1,100,NA,NA,NA,NA,NA,NA,NA,49
200,200,0,0,2,200,100,100,1,0,0,0,0,49
299,298,1,2,3,300,99,100,0.99,2,0.02,1,0.01,49
398,396,2,4,4,400,99,100,0.99,2,0.02,1,0.01,49
496,492,4,8,5,500,98,100,0.98,4,0.04,2,0.02,49
595,590,5,10,6,600,99,100,0.99,2,0.02,1,0.01,49
691,682,9,18,7,700,96,100,0.96,8,0.08,4,0.04,49
789,778,11,22,8,800,98,100,0.98,4,0.04,2,0.02,49
887,874,13,26,9,900,98,100,0.98,4,0.04,2,0.02,49
977,957,20,43,10,1000,90,100,0.9,17,0.17,7,0.07,49
1929,1874,55,126,11,2000,952,1000,0.952,83,0.083,35,0.035,49
2863,2764,99,236,12,3000,934,1000,0.934,110,0.11,44,0.044,49
3779,3620,159,380,13,4000,916,1000,0.916,144,0.144,60,0.06,49
4674,4439,235,561,14,5000,895,1000,0.895,181,0.181,76,0.076,49
5549,5235,314,765,15,6000,875,1000,0.875,204,0.204,79,0.079,49
6408,6005,403,995,16,7000,859,1000,0.859,230,0.23,89,0.089,49
7255,6754,501,1246,17,8000,847,1000,0.847,251,0.251,98,0.098,49
8125,7553,572,1447,18,9000,870,1000,0.87,201,0.201,71,0.071,49
8959,8276,683,1724,19,10000,834,1000,0.834,277,0.277,111,0.111,49
9786,9009,777,1991,20,11000,827,1000,0.827,267,0.267,94,0.094,49
10616,9741,875,2259,21,12000,830,1000,0.83,268,0.268,98,0.098,49
11406,10399,1007,2601,22,13000,790,1000,0.79,342,0.342,132,0.132,49
12199,11065,1134,2935,23,14000,793,1000,0.793,334,0.334,127,0.127,49
12995,11734,1261,3266,24,15000,796,1000,0.796,331,0.331,127,0.127,49
13785,12405,1380,3595,25,16000,790,1000,0.79,329,0.329,119,0.119,49
14556,13053,1503,3947,26,17000,771,1000,0.771,352,0.352,123,0.123,49
15338,13715,1623,4285,27,18000,782,1000,0.782,338,0.338,120,0.12,49
16093,14330,1763,4670,28,19000,755,1000,0.755,385,0.385,140,0.14,49
16848,14956,1892,5044,29,20000,755,1000,0.755,374,0.374,129,0.129,49
17586,15547,2039,5453,30,21000,738,1000,0.738,409,0.409,147,0.147,49
18320,16141,2179,5859,31,22000,734,1000,0.734,406,0.406,140,0.14,49
19049,16730,2319,6270,32,23000,729,1000,0.729,411,0.411,140,0.14,49
19770,17319,2451,6681,33,24000,721,1000,0.721,411,0.411,132,0.132,49
20518,17945,2573,7055,34,25000,748,1000,0.748,374,0.374,122,0.122,49
21242,18522,2720,7478,35,26000,724,1000,0.724,423,0.423,147,0.147,49
21967,19114,2853,7886,36,27000,725,1000,0.725,408,0.408,133,0.133,49
22700,19711,2989,8289,37,28000,733,1000,0.733,403,0.403,136,0.136,49
23398,20251,3147,8749,38,29000,698,1000,0.698,460,0.46,158,0.158,49
24111,20816,3295,9184,39,30000,713,1000,0.713,435,0.435,148,0.148,49
24785,21336,3449,9664,40,31000,674,1000,0.674,480,0.48,154,0.154,49
25477,21877,3600,10123,41,32000,692,1000,0.692,459,0.459,151,0.151,49
26149,22382,3767,10618,42,33000,672,1000,0.672,495,0.495,167,0.167,49
26828,22905,3923,11095,43,34000,679,1000,0.679,477,0.477,156,0.156,49
27479,23405,4074,11595,44,35000,651,1000,0.651,500,0.5,151,0.151,49
28116,23874,4242,12126,45,36000,637,1000,0.637,531,0.531,168,0.168,49
28789,24384,4405,12616,46,37000,673,1000,0.673,490,0.49,163,0.163,49
29484,24934,4550,13066,47,38000,695,1000,0.695,450,0.45,145,0.145,49
30141,25437,4704,13563,48,39000,657,1000,0.657,497,0.497,154,0.154,49
30762,25901,4861,14099,49,40000,621,1000,0.621,536,0.536,157,0.157,49
31396,26381,5015,14619,50,41000,634,1000,0.634,520,0.52,154,0.154,49
32030,26855,5175,15145,51,42000,634,1000,0.634,526,0.526,160,0.16,49
32653,27304,5349,15696,52,43000,623,1000,0.623,551,0.551,174,0.174,49
33308,27816,5492,16184,53,44000,655,1000,0.655,488,0.488,143,0.143,49
33949,28304,5645,16696,54,45000,641,1000,0.641,512,0.512,153,0.153,49
34565,28764,5801,17236,55,46000,616,1000,0.616,540,0.54,156,0.156,49
35186,29216,5970,17784,56,47000,621,1000,0.621,548,0.548,169,0.169,49
35805,29684,6121,18316,57,48000,619,1000,0.619,532,0.532,151,0.151,49
36430,30144,6286,18856,58,49000,625,1000,0.625,540,0.54,165,0.165,49
37045,30590,6455,19410,59,50000,615,1000,0.615,554,0.554,169,0.169,49
37680,31066,6614,19934,60,51000,635,1000,0.635,524,0.524,159,0.159,49
38320,31565,6755,20435,61,52000,640,1000,0.64,501,0.501,141,0.141,49
38925,32021,6904,20979,62,53000,605,1000,0.605,544,0.544,149,0.149,49
39511,32424,7087,21576,63,54000,586,1000,0.586,597,0.597,183,0.183,49
40147,32907,7240,22093,64,55000,636,1000,0.636,517,0.517,153,0.153,49
40761,33368,7393,22632,65,56000,614,1000,0.614,539,0.539,153,0.153,49
41376,33820,7556,23180,66,57000,615,1000,0.615,548,0.548,163,0.163,49
41965,34237,7728,23763,67,58000,589,1000,0.589,583,0.583,172,0.172,49
42551,34667,7884,24333,68,59000,586,1000,0.586,570,0.57,156,0.156,49
43146,35102,8044,24898,69,60000,595,1000,0.595,565,0.565,160,0.16,49
43744,35553,8191,25447,70,61000,598,1000,0.598,549,0.549,147,0.147,49
44319,35939,8380,26061,71,62000,575,1000,0.575,614,0.614,189,0.189,49
44892,36351,8541,26649,72,63000,573,1000,0.573,588,0.588,161,0.161,49
45474,36748,8726,27252,73,64000,582,1000,0.582,603,0.603,185,0.185,49
46051,37149,8902,27851,74,65000,577,1000,0.577,599,0.599,176,0.176,49
46618,37544,9074,28456,75,66000,567,1000,0.567,605,0.605,172,0.172,49
47189,37942,9247,29058,76,67000,571,1000,0.571,602,0.602,173,0.173,49
47767,38348,9419,29652,77,68000,578,1000,0.578,594,0.594,172,0.172,49
48329,38746,9583,30254,78,69000,562,1000,0.562,602,0.602,164,0.164,49
48882,39125,9757,30875,79,70000,553,1000,0.553,621,0.621,174,0.174,49
49425,39498,9927,31502,80,71000,543,1000,0.543,627,0.627,170,0.17,49
49974,39883,10091,32117,81,72000,549,1000,0.549,615,0.615,164,0.164,49
50512,40235,10277,32765,82,73000,538,1000,0.538,648,0.648,186,0.186,49
51068,40634,10434,33366,83,74000,556,1000,0.556,601,0.601,157,0.157,49
51616,41017,10599,33983,84,75000,548,1000,0.548,617,0.617,165,0.165,49
52167,41402,10765,34598,85,76000,551,1000,0.551,615,0.615,166,0.166,49
52715,41773,10942,35227,86,77000,548,1000,0.548,629,0.629,177,0.177,49
53264,42161,11103,35839,87,78000,549,1000,0.549,612,0.612,161,0.161,49
53843,42594,11249,36406,88,79000,579,1000,0.579,567,0.567,146,0.146,49
54377,42944,11433,37056,89,80000,534,1000,0.534,650,0.65,184,0.184,49
54921,43323,11598,37677,90,81000,544,1000,0.544,621,0.621,165,0.165,49
55454,43704,11750,38296,91,82000,533,1000,0.533,619,0.619,152,0.152,49
56011,44105,11906,38895,92,83000,557,1000,0.557,599,0.599,156,0.156,49
56527,44440,12087,39560,93,84000,516,1000,0.516,665,0.665,181,0.181,49
57045,44775,12270,40225,94,85000,518,1000,0.518,665,0.665,183,0.183,49
57611,45183,12428,40817,95,86000,566,1000,0.566,592,0.592,158,0.158,49
58166,45591,12575,41409,96,87000,555,1000,0.555,592,0.592,147,0.147,49
58701,45960,12741,42040,97,88000,535,1000,0.535,631,0.631,166,0.166,49
59241,46326,12915,42674,98,89000,540,1000,0.54,634,0.634,174,0.174,49
59753,46658,13095,43342,99,90000,512,1000,0.512,668,0.668,180,0.18,49
60300,47036,13264,43964,100,91000,547,1000,0.547,622,0.622,169,0.169,49
60789,47345,13444,44655,101,92000,489,1000,0.489,691,0.691,180,0.18,49
61296,47665,13631,45335,102,93000,507,1000,0.507,680,0.68,187,0.187,49
61830,48054,13776,45946,103,94000,534,1000,0.534,611,0.611,145,0.145,49
62317,48355,13962,46645,104,95000,487,1000,0.487,699,0.699,186,0.186,49
62835,48713,14122,47287,105,96000,518,1000,0.518,642,0.642,160,0.16,49
63359,49079,14280,47921,106,97000,524,1000,0.524,634,0.634,158,0.158,49
63846,49393,14453,48607,107,98000,487,1000,0.487,686,0.686,173,0.173,49
64356,49730,14626,49270,108,99000,510,1000,0.51,663,0.663,173,0.173,49
64870,50064,14806,49936,109,100000,514,1000,0.514,666,0.666,180,0.18,49
65372,50388,14984,50612,110,101000,502,1000,0.502,676,0.676,178,0.178,49
65854,50698,15156,51302,111,102000,482,1000,0.482,690,0.69,172,0.172,49
66352,51037,15315,51963,112,103000,498,1000,0.498,661,0.661,159,0.159,49
66846,51357,15489,52643,113,104000,494,1000,0.494,680,0.68,174,0.174,49
67335,51697,15638,53303,114,105000,489,1000,0.489,660,0.66,149,0.149,49
67820,52021,15799,53979,115,106000,485,1000,0.485,676,0.676,161,0.161,49
68293,52320,15973,54680,116,107000,473,1000,0.473,701,0.701,174,0.174,49
68811,52666,16145,55334,117,108000,518,1000,0.518,654,0.654,172,0.172,49
69298,52981,16317,56019,118,109000,487,1000,0.487,685,0.685,172,0.172,49
69810,53343,16467,56657,119,110000,512,1000,0.512,638,0.638,150,0.15,49
70305,53668,16637,57332,120,111000,495,1000,0.495,675,0.675,170,0.17,49
70761,53940,16821,58060,121,112000,456,1000,0.456,728,0.728,184,0.184,49
71252,54254,16998,58746,122,113000,491,1000,0.491,686,0.686,177,0.177,49
71720,54546,17174,59454,123,114000,468,1000,0.468,708,0.708,176,0.176,49
71869,54638,17231,59660,124,114298,149,298,0.5,206,0.6912751677852349,57,0.1912751677852349,49
99,98,1,2,1,100,NA,NA,NA,NA,NA,NA,NA,50
197,195,2,5,2,200,98,100,0.98,3,0.03,1,0.01,50
294,291,3,9,3,300,97,100,0.97,4,0.04,1,0.01,50
391,386,5,14,4,400,97,100,0.97,5,0.05,2,0.02,50
488,480,8,20,5,500,97,100,0.97,6,0.06,3,0.03,50
585,574,11,26,6,600,97,100,0.97,6,0.06,3,0.03,50
683,670,13,30,7,700,98,100,0.98,4,0.04,2,0.02,50
780,765,15,35,8,800,97,100,0.97,5,0.05,2,0.02,50
876,859,17,41,9,900,96,100,0.96,6,0.06,2,0.02,50
974,955,19,45,10,1000,98,100,0.98,4,0.04,2,0.02,50
1929,1875,54,125,11,2000,955,1000,0.955,80,0.08,35,0.035,50
2872,2779,93,221,12,3000,943,1000,0.943,96,0.096,39,0.039,50
3799,3653,146,347,13,4000,927,1000,0.927,126,0.126,53,0.053,50
4684,4463,221,537,14,5000,885,1000,0.885,190,0.19,75,0.075,50
5581,5290,291,710,15,6000,897,1000,0.897,173,0.173,70,0.07,50
6471,6109,362,891,16,7000,890,1000,0.89,181,0.181,71,0.071,50
7317,6859,458,1141,17,8000,846,1000,0.846,250,0.25,96,0.096,50
8165,7599,566,1401,18,9000,848,1000,0.848,260,0.26,108,0.108,50
8990,8321,669,1679,19,10000,825,1000,0.825,278,0.278,103,0.103,50
9836,9087,749,1913,20,11000,846,1000,0.846,234,0.234,80,0.08,50
10655,9787,868,2213,21,12000,819,1000,0.819,300,0.3,119,0.119,50
11469,10486,983,2514,22,13000,814,1000,0.814,301,0.301,115,0.115,50
12271,11183,1088,2817,23,14000,802,1000,0.802,303,0.303,105,0.105,50
13072,11874,1198,3126,24,15000,801,1000,0.801,309,0.309,110,0.11,50
13868,12543,1325,3457,25,16000,796,1000,0.796,331,0.331,127,0.127,50
14650,13212,1438,3788,26,17000,782,1000,0.782,331,0.331,113,0.113,50
15442,13885,1557,4115,27,18000,792,1000,0.792,327,0.327,119,0.119,50
16200,14518,1682,4482,28,19000,758,1000,0.758,367,0.367,125,0.125,50
16956,15146,1810,4854,29,20000,756,1000,0.756,372,0.372,128,0.128,50
17699,15754,1945,5246,30,21000,743,1000,0.743,392,0.392,135,0.135,50
18432,16339,2093,5661,31,22000,733,1000,0.733,415,0.415,148,0.148,50
19171,16952,2219,6048,32,23000,739,1000,0.739,387,0.387,126,0.126,50
19917,17570,2347,6430,33,24000,746,1000,0.746,382,0.382,128,0.128,50
20636,18135,2501,6865,34,25000,719,1000,0.719,435,0.435,154,0.154,50
21333,18676,2657,7324,35,26000,697,1000,0.697,459,0.459,156,0.156,50
22033,19229,2804,7771,36,27000,700,1000,0.7,447,0.447,147,0.147,50
22752,19803,2949,8197,37,28000,719,1000,0.719,426,0.426,145,0.145,50
23450,20340,3110,8660,38,29000,698,1000,0.698,463,0.463,161,0.161,50
24144,20883,3261,9117,39,30000,694,1000,0.694,457,0.457,151,0.151,50
24826,21419,3407,9581,40,31000,682,1000,0.682,464,0.464,146,0.146,50
25499,21940,3559,10060,41,32000,673,1000,0.673,479,0.479,152,0.152,50
26177,22471,3706,10529,42,33000,678,1000,0.678,469,0.469,147,0.147,50
26859,23000,3859,11000,43,34000,682,1000,0.682,471,0.471,153,0.153,50
27516,23501,4015,11499,44,35000,657,1000,0.657,499,0.499,156,0.156,50
28203,24039,4164,11961,45,36000,687,1000,0.687,462,0.462,149,0.149,50
28881,24571,4310,12429,46,37000,678,1000,0.678,468,0.468,146,0.146,50
29531,25056,4475,12944,47,38000,650,1000,0.65,515,0.515,165,0.165,50
30189,25552,4637,13448,48,39000,658,1000,0.658,504,0.504,162,0.162,50
30812,25993,4819,14007,49,40000,623,1000,0.623,559,0.559,182,0.182,50
31454,26476,4978,14524,50,41000,642,1000,0.642,517,0.517,159,0.159,50
32105,26974,5131,15026,51,42000,651,1000,0.651,502,0.502,153,0.153,50
32740,27426,5314,15574,52,43000,635,1000,0.635,548,0.548,183,0.183,50
33380,27918,5462,16082,53,44000,640,1000,0.64,508,0.508,148,0.148,50
34019,28417,5602,16583,54,45000,639,1000,0.639,501,0.501,140,0.14,50
34638,28877,5761,17123,55,46000,619,1000,0.619,540,0.54,159,0.159,50
35259,29328,5931,17672,56,47000,621,1000,0.621,549,0.549,170,0.17,50
35865,29769,6096,18231,57,48000,606,1000,0.606,559,0.559,165,0.165,50
36524,30293,6231,18707,58,49000,659,1000,0.659,476,0.476,135,0.135,50
37154,30775,6379,19225,59,50000,630,1000,0.63,518,0.518,148,0.148,50
37776,31231,6545,19769,60,51000,622,1000,0.622,544,0.544,166,0.166,50
38391,31675,6716,20325,61,52000,615,1000,0.615,556,0.556,171,0.171,50
39013,32133,6880,20867,62,53000,622,1000,0.622,542,0.542,164,0.164,50
39600,32533,7067,21467,63,54000,587,1000,0.587,600,0.6,187,0.187,50
40194,32960,7234,22040,64,55000,594,1000,0.594,573,0.573,167,0.167,50
40795,33414,7381,22586,65,56000,601,1000,0.601,546,0.546,147,0.147,50
41385,33848,7537,23152,66,57000,590,1000,0.59,566,0.566,156,0.156,50
41961,34256,7705,23744,67,58000,576,1000,0.576,592,0.592,168,0.168,50
42553,34696,7857,24304,68,59000,592,1000,0.592,560,0.56,152,0.152,50
43125,35117,8008,24883,69,60000,572,1000,0.572,579,0.579,151,0.151,50
43683,35492,8191,25508,70,61000,558,1000,0.558,625,0.625,183,0.183,50
44263,35923,8340,26077,71,62000,580,1000,0.58,569,0.569,149,0.149,50
44848,36337,8511,26663,72,63000,585,1000,0.585,586,0.586,171,0.171,50
45427,36754,8673,27246,73,64000,579,1000,0.579,583,0.583,162,0.162,50
46037,37216,8821,27784,74,65000,610,1000,0.61,538,0.538,148,0.148,50
46629,37656,8973,28344,75,66000,592,1000,0.592,560,0.56,152,0.152,50
47198,38045,9153,28955,76,67000,569,1000,0.569,611,0.611,180,0.18,50
47735,38384,9351,29616,77,68000,537,1000,0.537,661,0.661,198,0.198,50
48306,38794,9512,30206,78,69000,571,1000,0.571,590,0.59,161,0.161,50
48885,39183,9702,30817,79,70000,579,1000,0.579,611,0.611,190,0.19,50
49447,39582,9865,31418,80,71000,562,1000,0.562,601,0.601,163,0.163,50
49986,39935,10051,32065,81,72000,539,1000,0.539,647,0.647,186,0.186,50
50525,40308,10217,32692,82,73000,539,1000,0.539,627,0.627,166,0.166,50
51072,40683,10389,33317,83,74000,547,1000,0.547,625,0.625,172,0.172,50
51632,41066,10566,33934,84,75000,560,1000,0.56,617,0.617,177,0.177,50
52185,41447,10738,34553,85,76000,553,1000,0.553,619,0.619,172,0.172,50
52711,41805,10906,35195,86,77000,526,1000,0.526,642,0.642,168,0.168,50
53250,42171,11079,35829,87,78000,539,1000,0.539,634,0.634,173,0.173,50
53782,42525,11257,36475,88,79000,532,1000,0.532,646,0.646,178,0.178,50
54298,42862,11436,37138,89,80000,516,1000,0.516,663,0.663,179,0.179,50
54830,43200,11630,37800,90,81000,532,1000,0.532,662,0.662,194,0.194,50
55395,43598,11797,38402,91,82000,565,1000,0.565,602,0.602,167,0.167,50
55941,43987,11954,39013,92,83000,546,1000,0.546,611,0.611,157,0.157,50
56469,44344,12125,39656,93,84000,528,1000,0.528,643,0.643,171,0.171,50
56994,44697,12297,40303,94,85000,525,1000,0.525,647,0.647,172,0.172,50
57525,45069,12456,40931,95,86000,531,1000,0.531,628,0.628,159,0.159,50
58042,45433,12609,41567,96,87000,517,1000,0.517,636,0.636,153,0.153,50
58556,45775,12781,42225,97,88000,514,1000,0.514,658,0.658,172,0.172,50
59080,46122,12958,42878,98,89000,524,1000,0.524,653,0.653,177,0.177,50
59606,46483,13123,43517,99,90000,526,1000,0.526,639,0.639,165,0.165,50
60125,46833,13292,44167,100,91000,519,1000,0.519,650,0.65,169,0.169,50
60617,47144,13473,44856,101,92000,492,1000,0.492,689,0.689,181,0.181,50
61136,47492,13644,45508,102,93000,519,1000,0.519,652,0.652,171,0.171,50
61638,47827,13811,46173,103,94000,502,1000,0.502,665,0.665,167,0.167,50
62127,48149,13978,46851,104,95000,489,1000,0.489,678,0.678,167,0.167,50
62668,48530,14138,47470,105,96000,541,1000,0.541,619,0.619,160,0.16,50
63169,48876,14293,48124,106,97000,501,1000,0.501,654,0.654,155,0.155,50
63680,49216,14464,48784,107,98000,511,1000,0.511,660,0.66,171,0.171,50
64213,49573,14640,49427,108,99000,533,1000,0.533,643,0.643,176,0.176,50
64731,49925,14806,50075,109,100000,518,1000,0.518,648,0.648,166,0.166,50
65233,50262,14971,50738,110,101000,502,1000,0.502,663,0.663,165,0.165,50
65743,50615,15128,51385,111,102000,510,1000,0.51,647,0.647,157,0.157,50
66247,50932,15315,52068,112,103000,504,1000,0.504,683,0.683,187,0.187,50
66749,51266,15483,52734,113,104000,502,1000,0.502,666,0.666,168,0.168,50
67233,51576,15657,53424,114,105000,484,1000,0.484,690,0.69,174,0.174,50
67736,51918,15818,54082,115,106000,503,1000,0.503,658,0.658,161,0.161,50
68229,52252,15977,54748,116,107000,493,1000,0.493,666,0.666,159,0.159,50
68760,52633,16127,55367,117,108000,531,1000,0.531,619,0.619,150,0.15,50
69294,52986,16308,56014,118,109000,534,1000,0.534,647,0.647,181,0.181,50
69770,53264,16506,56736,119,110000,476,1000,0.476,722,0.722,198,0.198,50
70260,53593,16667,57407,120,111000,490,1000,0.49,671,0.671,161,0.161,50
70743,53910,16833,58090,121,112000,483,1000,0.483,683,0.683,166,0.166,50
71231,54228,17003,58772,122,113000,488,1000,0.488,682,0.682,170,0.17,50
71739,54563,17176,59437,123,114000,508,1000,0.508,665,0.665,173,0.173,50
71869,54638,17231,59660,124,114298,130,298,0.436241610738255,223,0.7483221476510067,55,0.18456375838926176,50
99,98,1,2,1,100,NA,NA,NA,NA,NA,NA,NA,51
199,198,1,2,2,200,100,100,1,0,0,0,0,51
299,298,1,2,3,300,100,100,1,0,0,0,0,51
399,398,1,2,4,400,100,100,1,0,0,0,0,51
496,492,4,8,5,500,97,100,0.97,6,0.06,3,0.03,51
595,590,5,10,6,600,99,100,0.99,2,0.02,1,0.01,51
691,682,9,18,7,700,96,100,0.96,8,0.08,4,0.04,51
789,778,11,22,8,800,98,100,0.98,4,0.04,2,0.02,51
883,867,16,33,9,900,94,100,0.94,11,0.11,5,0.05,51
979,959,20,41,10,1000,96,100,0.96,8,0.08,4,0.04,51
1938,1882,56,118,11,2000,959,1000,0.959,77,0.077,36,0.036,51
2866,2754,112,246,12,3000,928,1000,0.928,128,0.128,56,0.056,51
3793,3636,157,364,13,4000,927,1000,0.927,118,0.118,45,0.045,51
4689,4464,225,536,14,5000,896,1000,0.896,172,0.172,68,0.068,51
5560,5256,304,744,15,6000,871,1000,0.871,208,0.208,79,0.079,51
6432,6051,381,949,16,7000,872,1000,0.872,205,0.205,77,0.077,51
7301,6838,463,1162,17,8000,869,1000,0.869,213,0.213,82,0.082,51
8144,7580,564,1420,18,9000,843,1000,0.843,258,0.258,101,0.101,51
8977,8311,666,1689,19,10000,833,1000,0.833,269,0.269,102,0.102,51
9818,9049,769,1951,20,11000,841,1000,0.841,262,0.262,103,0.103,51
10640,9770,870,2230,21,12000,822,1000,0.822,279,0.279,101,0.101,51
11452,10485,967,2515,22,13000,812,1000,0.812,285,0.285,97,0.097,51
12268,11204,1064,2796,23,14000,816,1000,0.816,281,0.281,97,0.097,51
13065,11881,1184,3119,24,15000,797,1000,0.797,323,0.323,120,0.12,51
13828,12516,1312,3484,25,16000,763,1000,0.763,365,0.365,128,0.128,51
14577,13131,1446,3869,26,17000,749,1000,0.749,385,0.385,134,0.134,51
15342,13781,1561,4219,27,18000,765,1000,0.765,350,0.35,115,0.115,51
16086,14365,1721,4635,28,19000,744,1000,0.744,416,0.416,160,0.16,51
16841,14996,1845,5004,29,20000,755,1000,0.755,369,0.369,124,0.124,51
17604,15634,1970,5366,30,21000,763,1000,0.763,362,0.362,125,0.125,51
18354,16244,2110,5756,31,22000,750,1000,0.75,390,0.39,140,0.14,51
19100,16847,2253,6153,32,23000,746,1000,0.746,397,0.397,143,0.143,51
19807,17403,2404,6597,33,24000,707,1000,0.707,444,0.444,151,0.151,51
20556,18028,2528,6972,34,25000,749,1000,0.749,375,0.375,124,0.124,51
21260,18578,2682,7422,35,26000,704,1000,0.704,450,0.45,154,0.154,51
21969,19128,2841,7872,36,27000,709,1000,0.709,450,0.45,159,0.159,51
22667,19674,2993,8326,37,28000,698,1000,0.698,454,0.454,152,0.152,51
23365,20204,3161,8796,38,29000,698,1000,0.698,470,0.47,168,0.168,51
24054,20743,3311,9257,39,30000,689,1000,0.689,461,0.461,150,0.15,51
24777,21334,3443,9666,40,31000,723,1000,0.723,409,0.409,132,0.132,51
25460,21869,3591,10131,41,32000,683,1000,0.683,465,0.465,148,0.148,51
26143,22392,3751,10608,42,33000,683,1000,0.683,477,0.477,160,0.16,51
26832,22919,3913,11081,43,34000,689,1000,0.689,473,0.473,162,0.162,51
27519,23466,4053,11534,44,35000,687,1000,0.687,453,0.453,140,0.14,51
28216,24016,4200,11984,45,36000,697,1000,0.697,450,0.45,147,0.147,51
28898,24544,4354,12456,46,37000,682,1000,0.682,472,0.472,154,0.154,51
29590,25106,4484,12894,47,38000,692,1000,0.692,438,0.438,130,0.13,51
30254,25616,4638,13384,48,39000,664,1000,0.664,490,0.49,154,0.154,51
30896,26088,4808,13912,49,40000,642,1000,0.642,528,0.528,170,0.17,51
31531,26554,4977,14446,50,41000,635,1000,0.635,534,0.534,169,0.169,51
32187,27060,5127,14940,51,42000,656,1000,0.656,494,0.494,150,0.15,51
32844,27553,5291,15447,52,43000,657,1000,0.657,507,0.507,164,0.164,51
33491,28043,5448,15957,53,44000,647,1000,0.647,510,0.51,157,0.157,51
34117,28504,5613,16496,54,45000,626,1000,0.626,539,0.539,165,0.165,51
34755,28982,5773,17018,55,46000,638,1000,0.638,522,0.522,160,0.16,51
35374,29444,5930,17556,56,47000,619,1000,0.619,538,0.538,157,0.157,51
35987,29896,6091,18104,57,48000,613,1000,0.613,548,0.548,161,0.161,51
36600,30336,6264,18664,58,49000,613,1000,0.613,560,0.56,173,0.173,51
37200,30777,6423,19223,59,50000,600,1000,0.6,559,0.559,159,0.159,51
37805,31214,6591,19786,60,51000,605,1000,0.605,563,0.563,168,0.168,51
38425,31655,6770,20345,61,52000,620,1000,0.62,559,0.559,179,0.179,51
39038,32103,6935,20897,62,53000,613,1000,0.613,552,0.552,165,0.165,51
39632,32523,7109,21477,63,54000,594,1000,0.594,580,0.58,174,0.174,51
40223,32949,7274,22051,64,55000,591,1000,0.591,574,0.574,165,0.165,51
40834,33399,7435,22601,65,56000,611,1000,0.611,550,0.55,161,0.161,51
41430,33835,7595,23165,66,57000,596,1000,0.596,564,0.564,160,0.16,51
42023,34262,7761,23738,67,58000,593,1000,0.593,573,0.573,166,0.166,51
42600,34662,7938,24338,68,59000,577,1000,0.577,600,0.6,177,0.177,51
43182,35095,8087,24905,69,60000,582,1000,0.582,567,0.567,149,0.149,51
43774,35521,8253,25479,70,61000,592,1000,0.592,574,0.574,166,0.166,51
44366,35966,8400,26034,71,62000,592,1000,0.592,555,0.555,147,0.147,51
44940,36381,8559,26619,72,63000,574,1000,0.574,585,0.585,159,0.159,51
45530,36815,8715,27185,73,64000,590,1000,0.59,566,0.566,156,0.156,51
46097,37222,8875,27778,74,65000,567,1000,0.567,593,0.593,160,0.16,51
46663,37624,9039,28376,75,66000,566,1000,0.566,598,0.598,164,0.164,51
47247,38060,9187,28940,76,67000,584,1000,0.584,564,0.564,148,0.148,51
47840,38502,9338,29498,77,68000,593,1000,0.593,558,0.558,151,0.151,51
48400,38878,9522,30122,78,69000,560,1000,0.56,624,0.624,184,0.184,51
48983,39293,9690,30707,79,70000,583,1000,0.583,585,0.585,168,0.168,51
49554,39727,9827,31273,80,71000,571,1000,0.571,566,0.566,137,0.137,51
50086,40089,9997,31911,81,72000,532,1000,0.532,638,0.638,170,0.17,51
50648,40484,10164,32516,82,73000,562,1000,0.562,605,0.605,167,0.167,51
51229,40891,10338,33109,83,74000,581,1000,0.581,593,0.593,174,0.174,51
51789,41276,10513,33724,84,75000,560,1000,0.56,615,0.615,175,0.175,51
52351,41677,10674,34323,85,76000,562,1000,0.562,599,0.599,161,0.161,51
52899,42062,10837,34938,86,77000,548,1000,0.548,615,0.615,163,0.163,51
53464,42466,10998,35534,87,78000,565,1000,0.565,596,0.596,161,0.161,51
54020,42875,11145,36125,88,79000,556,1000,0.556,591,0.591,147,0.147,51
54577,43260,11317,36740,89,80000,557,1000,0.557,615,0.615,172,0.172,51
55089,43609,11480,37391,90,81000,512,1000,0.512,651,0.651,163,0.163,51
55623,43975,11648,38025,91,82000,534,1000,0.534,634,0.634,168,0.168,51
56177,44346,11831,38654,92,83000,554,1000,0.554,629,0.629,183,0.183,51
56695,44688,12007,39312,93,84000,518,1000,0.518,658,0.658,176,0.176,51
57252,45085,12167,39915,94,85000,557,1000,0.557,603,0.603,160,0.16,51
57788,45458,12330,40542,95,86000,536,1000,0.536,627,0.627,163,0.163,51
58300,45788,12512,41212,96,87000,512,1000,0.512,670,0.67,182,0.182,51
58825,46142,12683,41858,97,88000,525,1000,0.525,646,0.646,171,0.171,51
59349,46490,12859,42510,98,89000,524,1000,0.524,652,0.652,176,0.176,51
59859,46837,13022,43163,99,90000,510,1000,0.51,653,0.653,163,0.163,51
60365,47146,13219,43854,100,91000,506,1000,0.506,691,0.691,197,0.197,51
60865,47464,13401,44536,101,92000,500,1000,0.5,682,0.682,182,0.182,51
61379,47800,13579,45200,102,93000,514,1000,0.514,664,0.664,178,0.178,51
61891,48127,13764,45873,103,94000,512,1000,0.512,673,0.673,185,0.185,51
62439,48534,13905,46466,104,95000,548,1000,0.548,593,0.593,141,0.141,51
62945,48856,14089,47144,105,96000,506,1000,0.506,678,0.678,184,0.184,51
63465,49212,14253,47788,106,97000,520,1000,0.52,644,0.644,164,0.164,51
63954,49529,14425,48471,107,98000,489,1000,0.489,683,0.683,172,0.172,51
64436,49837,14599,49163,108,99000,482,1000,0.482,692,0.692,174,0.174,51
64906,50123,14783,49877,109,100000,470,1000,0.47,714,0.714,184,0.184,51
65384,50426,14958,50574,110,101000,478,1000,0.478,697,0.697,175,0.175,51
65892,50751,15141,51249,111,102000,508,1000,0.508,675,0.675,183,0.183,51
66401,51096,15305,51904,112,103000,509,1000,0.509,655,0.655,164,0.164,51
66893,51426,15467,52574,113,104000,492,1000,0.492,670,0.67,162,0.162,51
67373,51723,15650,53277,114,105000,480,1000,0.48,703,0.703,183,0.183,51
67852,52029,15823,53971,115,106000,479,1000,0.479,694,0.694,173,0.173,51
68331,52342,15989,54658,116,107000,479,1000,0.479,687,0.687,166,0.166,51
68856,52702,16154,55298,117,108000,525,1000,0.525,640,0.64,165,0.165,51
69333,53007,16326,55993,118,109000,477,1000,0.477,695,0.695,172,0.172,51
69804,53301,16503,56699,119,110000,471,1000,0.471,706,0.706,177,0.177,51
70294,53636,16658,57364,120,111000,490,1000,0.49,665,0.665,155,0.155,51
70763,53920,16843,58080,121,112000,469,1000,0.469,716,0.716,185,0.185,51
71243,54215,17028,58785,122,113000,480,1000,0.48,705,0.705,185,0.185,51
71717,54537,17180,59463,123,114000,474,1000,0.474,678,0.678,152,0.152,51
71869,54638,17231,59660,124,114298,152,298,0.5100671140939598,197,0.6610738255033557,51,0.17114093959731544,51
100,100,0,0,1,100,NA,NA,NA,NA,NA,NA,NA,52
200,200,0,0,2,200,100,100,1,0,0,0,0,52
300,300,0,0,3,300,100,100,1,0,0,0,0,52
400,400,0,0,4,400,100,100,1,0,0,0,0,52
499,498,1,2,5,500,99,100,0.99,2,0.02,1,0.01,52
598,596,2,4,6,600,99,100,0.99,2,0.02,1,0.01,52
695,690,5,10,7,700,97,100,0.97,6,0.06,3,0.03,52
790,782,8,18,8,800,95,100,0.95,8,0.08,3,0.03,52
886,875,11,25,9,900,96,100,0.96,7,0.07,3,0.03,52
981,967,14,33,10,1000,95,100,0.95,8,0.08,3,0.03,52
1939,1893,46,107,11,2000,958,1000,0.958,74,0.074,32,0.032,52
2879,2789,90,211,12,3000,940,1000,0.94,104,0.104,44,0.044,52
3809,3670,139,330,13,4000,930,1000,0.93,119,0.119,49,0.049,52
4698,4477,221,523,14,5000,889,1000,0.889,193,0.193,82,0.082,52
5579,5282,297,718,15,6000,881,1000,0.881,195,0.195,76,0.076,52
6452,6068,384,932,16,7000,873,1000,0.873,214,0.214,87,0.087,52
7308,6835,473,1165,17,8000,856,1000,0.856,233,0.233,89,0.089,52
8140,7567,573,1433,18,9000,832,1000,0.832,268,0.268,100,0.1,52
8978,8305,673,1695,19,10000,838,1000,0.838,262,0.262,100,0.1,52
9817,9044,773,1956,20,11000,839,1000,0.839,261,0.261,100,0.1,52
10637,9756,881,2244,21,12000,820,1000,0.82,288,0.288,108,0.108,52
11407,10389,1018,2611,22,13000,770,1000,0.77,367,0.367,137,0.137,52
12202,11067,1135,2933,23,14000,795,1000,0.795,322,0.322,117,0.117,52
13010,11753,1257,3247,24,15000,808,1000,0.808,314,0.314,122,0.122,52
13801,12430,1371,3570,25,16000,791,1000,0.791,323,0.323,114,0.114,52
14571,13094,1477,3906,26,17000,770,1000,0.77,336,0.336,106,0.106,52
15329,13720,1609,4280,27,18000,758,1000,0.758,374,0.374,132,0.132,52
16084,14345,1739,4655,28,19000,755,1000,0.755,375,0.375,130,0.13,52
16842,14955,1887,5045,29,20000,758,1000,0.758,390,0.39,148,0.148,52
17601,15585,2016,5415,30,21000,759,1000,0.759,370,0.37,129,0.129,52
18323,16157,2166,5843,31,22000,722,1000,0.722,428,0.428,150,0.15,52
19056,16750,2306,6250,32,23000,733,1000,0.733,407,0.407,140,0.14,52
19762,17319,2443,6681,33,24000,706,1000,0.706,431,0.431,137,0.137,52
20522,17954,2568,7046,34,25000,760,1000,0.76,365,0.365,125,0.125,52
21252,18541,2711,7459,35,26000,730,1000,0.73,413,0.413,143,0.143,52
21964,19113,2851,7887,36,27000,712,1000,0.712,428,0.428,140,0.14,52
22674,19684,2990,8316,37,28000,710,1000,0.71,429,0.429,139,0.139,52
23369,20235,3134,8765,38,29000,695,1000,0.695,449,0.449,144,0.144,52
24056,20768,3288,9232,39,30000,687,1000,0.687,467,0.467,154,0.154,52
24750,21311,3439,9689,40,31000,694,1000,0.694,457,0.457,151,0.151,52
25432,21833,3599,10167,41,32000,682,1000,0.682,478,0.478,160,0.16,52
26112,22361,3751,10639,42,33000,680,1000,0.68,472,0.472,152,0.152,52
26774,22866,3908,11134,43,34000,662,1000,0.662,495,0.495,157,0.157,52
27442,23397,4045,11603,44,35000,668,1000,0.668,469,0.469,137,0.137,52
28109,23909,4200,12091,45,36000,667,1000,0.667,488,0.488,155,0.155,52
28783,24444,4339,12556,46,37000,674,1000,0.674,465,0.465,139,0.139,52
29444,24962,4482,13038,47,38000,661,1000,0.661,482,0.482,143,0.143,52
30112,25478,4634,13522,48,39000,668,1000,0.668,484,0.484,152,0.152,52
30748,25942,4806,14058,49,40000,636,1000,0.636,536,0.536,172,0.172,52
31392,26439,4953,14561,50,41000,644,1000,0.644,503,0.503,147,0.147,52
32043,26937,5106,15063,51,42000,651,1000,0.651,502,0.502,153,0.153,52
32692,27428,5264,15572,52,43000,649,1000,0.649,509,0.509,158,0.158,52
33333,27908,5425,16092,53,44000,641,1000,0.641,520,0.52,161,0.161,52
33999,28433,5566,16567,54,45000,666,1000,0.666,475,0.475,141,0.141,52
34622,28912,5710,17088,55,46000,623,1000,0.623,521,0.521,144,0.144,52
35269,29408,5861,17592,56,47000,647,1000,0.647,504,0.504,151,0.151,52
35898,29873,6025,18127,57,48000,629,1000,0.629,535,0.535,164,0.164,52
36510,30314,6196,18686,58,49000,612,1000,0.612,559,0.559,171,0.171,52
37144,30800,6344,19200,59,50000,634,1000,0.634,514,0.514,148,0.148,52
37780,31282,6498,19718,60,51000,636,1000,0.636,518,0.518,154,0.154,52
38392,31736,6656,20264,61,52000,612,1000,0.612,546,0.546,158,0.158,52
38998,32191,6807,20809,62,53000,606,1000,0.606,545,0.545,151,0.151,52
39632,32674,6958,21326,63,54000,634,1000,0.634,517,0.517,151,0.151,52
40227,33093,7134,21907,64,55000,595,1000,0.595,581,0.581,176,0.176,52
40838,33527,7311,22473,65,56000,611,1000,0.611,566,0.566,177,0.177,52
41447,33988,7459,23012,66,57000,609,1000,0.609,539,0.539,148,0.148,52
42041,34410,7631,23590,67,58000,594,1000,0.594,578,0.578,172,0.172,52
42633,34820,7813,24180,68,59000,592,1000,0.592,590,0.59,182,0.182,52
43219,35252,7967,24748,69,60000,586,1000,0.586,568,0.568,154,0.154,52
43804,35677,8127,25323,70,61000,585,1000,0.585,575,0.575,160,0.16,52
44387,36103,8284,25897,71,62000,583,1000,0.583,574,0.574,157,0.157,52
44959,36502,8457,26498,72,63000,572,1000,0.572,601,0.601,173,0.173,52
45534,36903,8631,27097,73,64000,575,1000,0.575,599,0.599,174,0.174,52
46112,37317,8795,27683,74,65000,578,1000,0.578,586,0.586,164,0.164,52
46670,37704,8966,28296,75,66000,558,1000,0.558,613,0.613,171,0.171,52
47251,38129,9122,28871,76,67000,581,1000,0.581,575,0.575,156,0.156,52
47856,38589,9267,29411,77,68000,605,1000,0.605,540,0.54,145,0.145,52
48427,38997,9430,30003,78,69000,571,1000,0.571,592,0.592,163,0.163,52
48985,39379,9606,30621,79,70000,558,1000,0.558,618,0.618,176,0.176,52
49557,39781,9776,31219,80,71000,572,1000,0.572,598,0.598,170,0.17,52
50112,40171,9941,31829,81,72000,555,1000,0.555,610,0.61,165,0.165,52
50676,40573,10103,32427,82,73000,564,1000,0.564,598,0.598,162,0.162,52
51223,40949,10274,33051,83,74000,547,1000,0.547,624,0.624,171,0.171,52
51776,41329,10447,33671,84,75000,553,1000,0.553,620,0.62,173,0.173,52
52349,41753,10596,34247,85,76000,573,1000,0.573,576,0.576,149,0.149,52
52885,42127,10758,34873,86,77000,536,1000,0.536,626,0.626,162,0.162,52
53451,42520,10931,35480,87,78000,566,1000,0.566,607,0.607,173,0.173,52
53997,42908,11089,36092,88,79000,546,1000,0.546,612,0.612,158,0.158,52
54553,43284,11269,36716,89,80000,556,1000,0.556,624,0.624,180,0.18,52
55100,43672,11428,37328,90,81000,547,1000,0.547,612,0.612,159,0.159,52
55644,44042,11602,37958,91,82000,544,1000,0.544,630,0.63,174,0.174,52
56165,44383,11782,38617,92,83000,521,1000,0.521,659,0.659,180,0.18,52
56697,44746,11951,39254,93,84000,532,1000,0.532,637,0.637,169,0.169,52
57233,45114,12119,39886,94,85000,536,1000,0.536,632,0.632,168,0.168,52
57762,45466,12296,40534,95,86000,529,1000,0.529,648,0.648,177,0.177,52
58288,45813,12475,41187,96,87000,526,1000,0.526,653,0.653,179,0.179,52
58804,46146,12658,41854,97,88000,516,1000,0.516,667,0.667,183,0.183,52
59303,46492,12811,42508,98,89000,499,1000,0.499,654,0.654,153,0.153,52
59826,46848,12978,43152,99,90000,523,1000,0.523,644,0.644,167,0.167,52
60362,47227,13135,43773,100,91000,536,1000,0.536,621,0.621,157,0.157,52
60837,47508,13329,44492,101,92000,475,1000,0.475,719,0.719,194,0.194,52
61338,47810,13528,45190,102,93000,501,1000,0.501,698,0.698,199,0.199,52
61840,48150,13690,45850,103,94000,502,1000,0.502,660,0.66,162,0.162,52
62348,48499,13849,46501,104,95000,508,1000,0.508,651,0.651,159,0.159,52
62858,48831,14027,47169,105,96000,510,1000,0.51,668,0.668,178,0.178,52
63344,49133,14211,47867,106,97000,486,1000,0.486,698,0.698,184,0.184,52
63838,49464,14374,48536,107,98000,494,1000,0.494,669,0.669,163,0.163,52
64355,49791,14564,49209,108,99000,517,1000,0.517,673,0.673,190,0.19,52
64847,50108,14739,49892,109,100000,492,1000,0.492,683,0.683,175,0.175,52
65324,50399,14925,50601,110,101000,477,1000,0.477,709,0.709,186,0.186,52
65816,50708,15108,51292,111,102000,492,1000,0.492,691,0.691,183,0.183,52
66325,51046,15279,51954,112,103000,509,1000,0.509,662,0.662,171,0.171,52
66826,51376,15450,52624,113,104000,501,1000,0.501,670,0.67,171,0.171,52
67317,51697,15620,53303,114,105000,491,1000,0.491,679,0.679,170,0.17,52
67818,52021,15797,53979,115,106000,501,1000,0.501,676,0.676,177,0.177,52
68325,52357,15968,54643,116,107000,507,1000,0.507,664,0.664,171,0.171,52
68805,52674,16131,55326,117,108000,480,1000,0.48,683,0.683,163,0.163,52
69288,52992,16296,56008,118,109000,483,1000,0.483,682,0.682,165,0.165,52
69769,53277,16492,56723,119,110000,481,1000,0.481,715,0.715,196,0.196,52
70240,53577,16663,57423,120,111000,471,1000,0.471,700,0.7,171,0.171,52
70736,53897,16839,58103,121,112000,496,1000,0.496,680,0.68,176,0.176,52
71230,54212,17018,58788,122,113000,494,1000,0.494,685,0.685,179,0.179,52
71720,54544,17176,59456,123,114000,490,1000,0.49,668,0.668,158,0.158,52
71869,54638,17231,59660,124,114298,149,298,0.5,204,0.6845637583892618,55,0.18456375838926176,52
100,100,0,0,1,100,NA,NA,NA,NA,NA,NA,NA,53
200,200,0,0,2,200,100,100,1,0,0,0,0,53
299,298,1,2,3,300,99,100,0.99,2,0.02,1,0.01,53
396,392,4,8,4,400,97,100,0.97,6,0.06,3,0.03,53
488,476,12,24,5,500,92,100,0.92,16,0.16,8,0.08,53
587,574,13,26,6,600,99,100,0.99,2,0.02,1,0.01,53
684,668,16,32,7,700,97,100,0.97,6,0.06,3,0.03,53
780,760,20,40,8,800,96,100,0.96,8,0.08,4,0.04,53
876,854,22,46,9,900,96,100,0.96,6,0.06,2,0.02,53
976,954,22,46,10,1000,100,100,1,0,0,0,0,53
1923,1863,60,137,11,2000,947,1000,0.947,91,0.091,38,0.038,53
2871,2775,96,225,12,3000,948,1000,0.948,88,0.088,36,0.036,53
3788,3639,149,361,13,4000,917,1000,0.917,136,0.136,53,0.053,53
4689,4470,219,530,14,5000,901,1000,0.901,169,0.169,70,0.07,53
5574,5281,293,719,15,6000,885,1000,0.885,189,0.189,74,0.074,53
6433,6046,387,954,16,7000,859,1000,0.859,235,0.235,94,0.094,53
7284,6804,480,1196,17,8000,851,1000,0.851,242,0.242,93,0.093,53
8127,7553,574,1447,18,9000,843,1000,0.843,251,0.251,94,0.094,53
8978,8313,665,1687,19,10000,851,1000,0.851,240,0.24,91,0.091,53
9819,9056,763,1944,20,11000,841,1000,0.841,257,0.257,98,0.098,53
10622,9743,879,2257,21,12000,803,1000,0.803,313,0.313,116,0.116,53
11433,10446,987,2554,22,13000,811,1000,0.811,297,0.297,108,0.108,53
12236,11131,1105,2869,23,14000,803,1000,0.803,315,0.315,118,0.118,53
13012,11776,1236,3224,24,15000,776,1000,0.776,355,0.355,131,0.131,53
13828,12487,1341,3513,25,16000,816,1000,0.816,289,0.289,105,0.105,53
14587,13117,1470,3883,26,17000,759,1000,0.759,370,0.37,129,0.129,53
15364,13773,1591,4227,27,18000,777,1000,0.777,344,0.344,121,0.121,53
16118,14399,1719,4601,28,19000,754,1000,0.754,374,0.374,128,0.128,53
16878,15029,1849,4971,29,20000,760,1000,0.76,370,0.37,130,0.13,53
17635,15653,1982,5347,30,21000,757,1000,0.757,376,0.376,133,0.133,53
18379,16280,2099,5720,31,22000,744,1000,0.744,373,0.373,117,0.117,53
19119,16863,2256,6137,32,23000,740,1000,0.74,417,0.417,157,0.157,53
19862,17484,2378,6516,33,24000,743,1000,0.743,379,0.379,122,0.122,53
20596,18068,2528,6932,34,25000,734,1000,0.734,416,0.416,150,0.15,53
21320,18657,2663,7343,35,26000,724,1000,0.724,411,0.411,135,0.135,53
22041,19249,2792,7751,36,27000,721,1000,0.721,408,0.408,129,0.129,53
22748,19805,2943,8195,37,28000,707,1000,0.707,444,0.444,151,0.151,53
23419,20309,3110,8691,38,29000,671,1000,0.671,496,0.496,167,0.167,53
24123,20883,3240,9117,39,30000,704,1000,0.704,426,0.426,130,0.13,53
24808,21412,3396,9588,40,31000,685,1000,0.685,471,0.471,156,0.156,53
25508,21963,3545,10037,41,32000,700,1000,0.7,449,0.449,149,0.149,53
26177,22478,3699,10522,42,33000,669,1000,0.669,485,0.485,154,0.154,53
26861,23002,3859,10998,43,34000,684,1000,0.684,476,0.476,160,0.16,53
27524,23512,4012,11488,44,35000,663,1000,0.663,490,0.49,153,0.153,53
28204,24036,4168,11964,45,36000,680,1000,0.68,476,0.476,156,0.156,53
28871,24550,4321,12450,46,37000,667,1000,0.667,486,0.486,153,0.153,53
29555,25098,4457,12902,47,38000,684,1000,0.684,452,0.452,136,0.136,53
30210,25606,4604,13394,48,39000,655,1000,0.655,492,0.492,147,0.147,53
30873,26119,4754,13881,49,40000,663,1000,0.663,487,0.487,150,0.15,53
31529,26632,4897,14368,50,41000,656,1000,0.656,487,0.487,143,0.143,53
32180,27118,5062,14882,51,42000,651,1000,0.651,514,0.514,165,0.165,53
32811,27588,5223,15412,52,43000,631,1000,0.631,530,0.53,161,0.161,53
33441,28056,5385,15944,53,44000,630,1000,0.63,532,0.532,162,0.162,53
34072,28520,5552,16480,54,45000,631,1000,0.631,536,0.536,167,0.167,53
34697,28989,5708,17011,55,46000,625,1000,0.625,531,0.531,156,0.156,53
35319,29443,5876,17557,56,47000,622,1000,0.622,546,0.546,168,0.168,53
35925,29885,6040,18115,57,48000,606,1000,0.606,558,0.558,164,0.164,53
36552,30353,6199,18647,58,49000,627,1000,0.627,532,0.532,159,0.159,53
37173,30807,6366,19193,59,50000,621,1000,0.621,546,0.546,167,0.167,53
37777,31227,6550,19773,60,51000,604,1000,0.604,580,0.58,184,0.184,53
38431,31742,6689,20258,61,52000,654,1000,0.654,485,0.485,139,0.139,53
39067,32237,6830,20763,62,53000,636,1000,0.636,505,0.505,141,0.141,53
39685,32688,6997,21312,63,54000,618,1000,0.618,549,0.549,167,0.167,53
40311,33159,7152,21841,64,55000,626,1000,0.626,529,0.529,155,0.155,53
40891,33567,7324,22433,65,56000,580,1000,0.58,592,0.592,172,0.172,53
41500,33997,7503,23003,66,57000,609,1000,0.609,570,0.57,179,0.179,53
42082,34396,7686,23604,67,58000,582,1000,0.582,601,0.601,183,0.183,53
42670,34829,7841,24171,68,59000,588,1000,0.588,567,0.567,155,0.155,53
43251,35239,8012,24761,69,60000,581,1000,0.581,590,0.59,171,0.171,53
43819,35628,8191,25372,70,61000,568,1000,0.568,611,0.611,179,0.179,53
44386,36038,8348,25962,71,62000,567,1000,0.567,590,0.59,157,0.157,53
44987,36482,8505,26518,72,63000,601,1000,0.601,556,0.556,157,0.157,53
45535,36850,8685,27150,73,64000,548,1000,0.548,632,0.632,180,0.18,53
46102,37236,8866,27764,74,65000,567,1000,0.567,614,0.614,181,0.181,53
46673,37639,9034,28361,75,66000,571,1000,0.571,597,0.597,168,0.168,53
47251,38037,9214,28963,76,67000,578,1000,0.578,602,0.602,180,0.18,53
47788,38417,9371,29583,77,68000,537,1000,0.537,620,0.62,157,0.157,53
48330,38781,9549,30219,78,69000,542,1000,0.542,636,0.636,178,0.178,53
48913,39211,9702,30789,79,70000,583,1000,0.583,570,0.57,153,0.153,53
49507,39640,9867,31360,80,71000,594,1000,0.594,571,0.571,165,0.165,53
50086,40058,10028,31942,81,72000,579,1000,0.579,582,0.582,161,0.161,53
50638,40440,10198,32560,82,73000,552,1000,0.552,618,0.618,170,0.17,53
51189,40831,10358,33169,83,74000,551,1000,0.551,609,0.609,160,0.16,53
51766,41240,10526,33760,84,75000,577,1000,0.577,591,0.591,168,0.168,53
52295,41592,10703,34408,85,76000,529,1000,0.529,648,0.648,177,0.177,53
52837,41955,10882,35045,86,77000,542,1000,0.542,637,0.637,179,0.179,53
53395,42348,11047,35652,87,78000,558,1000,0.558,607,0.607,165,0.165,53
53961,42749,11212,36251,88,79000,566,1000,0.566,599,0.599,165,0.165,53
54491,43111,11380,36889,89,80000,530,1000,0.53,638,0.638,168,0.168,53
55027,43479,11548,37521,90,81000,536,1000,0.536,632,0.632,168,0.168,53
55563,43840,11723,38160,91,82000,536,1000,0.536,639,0.639,175,0.175,53
56095,44191,11904,38809,92,83000,532,1000,0.532,649,0.649,181,0.181,53
56637,44579,12058,39421,93,84000,542,1000,0.542,612,0.612,154,0.154,53
57154,44921,12233,40079,94,85000,517,1000,0.517,658,0.658,175,0.175,53
57664,45246,12418,40754,95,86000,510,1000,0.51,675,0.675,185,0.185,53
58176,45591,12585,41409,96,87000,512,1000,0.512,655,0.655,167,0.167,53
58676,45916,12760,42084,97,88000,500,1000,0.5,675,0.675,175,0.175,53
59189,46263,12926,42737,98,89000,513,1000,0.513,653,0.653,166,0.166,53
59703,46603,13100,43397,99,90000,514,1000,0.514,660,0.66,174,0.174,53
60217,46939,13278,44061,100,91000,514,1000,0.514,664,0.664,178,0.178,53
60747,47292,13455,44708,101,92000,530,1000,0.53,647,0.647,177,0.177,53
61264,47643,13621,45357,102,93000,517,1000,0.517,649,0.649,166,0.166,53
61785,48013,13772,45987,103,94000,521,1000,0.521,630,0.63,151,0.151,53
62287,48353,13934,46647,104,95000,502,1000,0.502,660,0.66,162,0.162,53
62790,48676,14114,47324,105,96000,503,1000,0.503,677,0.677,180,0.18,53
63289,48987,14302,48013,106,97000,499,1000,0.499,689,0.689,188,0.188,53
63811,49319,14492,48681,107,98000,522,1000,0.522,668,0.668,190,0.19,53
64311,49657,14654,49343,108,99000,500,1000,0.5,662,0.662,162,0.162,53
64794,49965,14829,50035,109,100000,483,1000,0.483,692,0.692,175,0.175,53
65297,50299,14998,50701,110,101000,503,1000,0.503,666,0.666,169,0.169,53
65796,50631,15165,51369,111,102000,499,1000,0.499,668,0.668,167,0.167,53
66328,51006,15322,51994,112,103000,532,1000,0.532,625,0.625,157,0.157,53
66778,51253,15525,52747,113,104000,450,1000,0.45,753,0.753,203,0.203,53
67250,51550,15700,53450,114,105000,472,1000,0.472,703,0.703,175,0.175,53
67742,51869,15873,54131,115,106000,492,1000,0.492,681,0.681,173,0.173,53
68249,52224,16025,54776,116,107000,507,1000,0.507,645,0.645,152,0.152,53
68733,52549,16184,55451,117,108000,484,1000,0.484,675,0.675,159,0.159,53
69210,52863,16347,56137,118,109000,477,1000,0.477,686,0.686,163,0.163,53
69717,53220,16497,56780,119,110000,507,1000,0.507,643,0.643,150,0.15,53
70203,53534,16669,57466,120,111000,486,1000,0.486,686,0.686,172,0.172,53
70725,53887,16838,58113,121,112000,522,1000,0.522,647,0.647,169,0.169,53
71207,54202,17005,58798,122,113000,482,1000,0.482,685,0.685,167,0.167,53
71717,54534,17183,59466,123,114000,510,1000,0.51,668,0.668,178,0.178,53
71869,54638,17231,59660,124,114298,152,298,0.5100671140939598,194,0.6510067114093959,48,0.1610738255033557,53
100,100,0,0,1,100,NA,NA,NA,NA,NA,NA,NA,54
200,200,0,0,2,200,100,100,1,0,0,0,0,54
300,300,0,0,3,300,100,100,1,0,0,0,0,54
398,396,2,4,4,400,98,100,0.98,4,0.04,2,0.02,54
497,494,3,6,5,500,99,100,0.99,2,0.02,1,0.01,54
593,586,7,14,6,600,96,100,0.96,8,0.08,4,0.04,54
692,684,8,16,7,700,99,100,0.99,2,0.02,1,0.01,54
791,783,8,17,8,800,99,100,0.99,1,0.01,0,0,54
887,875,12,25,9,900,96,100,0.96,8,0.08,4,0.04,54
982,965,17,35,10,1000,95,100,0.95,10,0.1,5,0.05,54
1947,1902,45,98,11,2000,965,1000,0.965,63,0.063,28,0.028,54
2888,2802,86,198,12,3000,941,1000,0.941,100,0.1,41,0.041,54
3810,3666,144,334,13,4000,922,1000,0.922,136,0.136,58,0.058,54
4706,4496,210,504,14,5000,896,1000,0.896,170,0.17,66,0.066,54
5589,5301,288,699,15,6000,883,1000,0.883,195,0.195,78,0.078,54
6459,6085,374,915,16,7000,870,1000,0.87,216,0.216,86,0.086,54
7324,6858,466,1142,17,8000,865,1000,0.865,227,0.227,92,0.092,54
8170,7603,567,1397,18,9000,846,1000,0.846,255,0.255,101,0.101,54
9001,8324,677,1676,19,10000,831,1000,0.831,279,0.279,110,0.11,54
9838,9066,772,1934,20,11000,837,1000,0.837,258,0.258,95,0.095,54
10662,9779,883,2221,21,12000,824,1000,0.824,287,0.287,111,0.111,54
11478,10498,980,2502,22,13000,816,1000,0.816,281,0.281,97,0.097,54
12268,11171,1097,2829,23,14000,790,1000,0.79,327,0.327,117,0.117,54
13066,11841,1225,3159,24,15000,798,1000,0.798,330,0.33,128,0.128,54
13847,12512,1335,3488,25,16000,781,1000,0.781,329,0.329,110,0.11,54
14624,13159,1465,3841,26,17000,777,1000,0.777,353,0.353,130,0.13,54
15394,13811,1583,4189,27,18000,770,1000,0.77,348,0.348,118,0.118,54
16138,14421,1717,4579,28,19000,744,1000,0.744,390,0.39,134,0.134,54
16894,15060,1834,4940,29,20000,756,1000,0.756,361,0.361,117,0.117,54
17654,15695,1959,5305,30,21000,760,1000,0.76,365,0.365,125,0.125,54
18413,16332,2081,5668,31,22000,759,1000,0.759,363,0.363,122,0.122,54
19143,16943,2200,6057,32,23000,730,1000,0.73,389,0.389,119,0.119,54
19875,17528,2347,6472,33,24000,732,1000,0.732,415,0.415,147,0.147,54
20596,18099,2497,6901,34,25000,721,1000,0.721,429,0.429,150,0.15,54
21306,18668,2638,7332,35,26000,710,1000,0.71,431,0.431,141,0.141,54
22016,19228,2788,7772,36,27000,710,1000,0.71,440,0.44,150,0.15,54
22750,19836,2914,8164,37,28000,734,1000,0.734,392,0.392,126,0.126,54
23444,20382,3062,8618,38,29000,694,1000,0.694,454,0.454,148,0.148,54
24125,20905,3220,9095,39,30000,681,1000,0.681,477,0.477,158,0.158,54
24845,21486,3359,9514,40,31000,720,1000,0.72,419,0.419,139,0.139,54
25549,22051,3498,9949,41,32000,704,1000,0.704,435,0.435,139,0.139,54
26240,22587,3653,10413,42,33000,691,1000,0.691,464,0.464,155,0.155,54
26901,23099,3802,10901,43,34000,661,1000,0.661,488,0.488,149,0.149,54
27568,23602,3966,11398,44,35000,667,1000,0.667,497,0.497,164,0.164,54
28228,24090,4138,11910,45,36000,660,1000,0.66,512,0.512,172,0.172,54
28895,24605,4290,12395,46,37000,667,1000,0.667,485,0.485,152,0.152,54
29573,25138,4435,12862,47,38000,678,1000,0.678,467,0.467,145,0.145,54
30235,25660,4575,13340,48,39000,662,1000,0.662,478,0.478,140,0.14,54
30890,26169,4721,13831,49,40000,655,1000,0.655,491,0.491,146,0.146,54
31547,26681,4866,14319,50,41000,657,1000,0.657,488,0.488,145,0.145,54
32205,27188,5017,14812,51,42000,658,1000,0.658,493,0.493,151,0.151,54
32852,27697,5155,15303,52,43000,647,1000,0.647,491,0.491,138,0.138,54
33506,28199,5307,15801,53,44000,654,1000,0.654,498,0.498,152,0.152,54
34144,28681,5463,16319,54,45000,638,1000,0.638,518,0.518,156,0.156,54
34800,29182,5618,16818,55,46000,656,1000,0.656,499,0.499,155,0.155,54
35446,29679,5767,17321,56,47000,646,1000,0.646,503,0.503,149,0.149,54
36075,30145,5930,17855,57,48000,629,1000,0.629,534,0.534,163,0.163,54
36726,30633,6093,18367,58,49000,651,1000,0.651,512,0.512,163,0.163,54
37337,31079,6258,18921,59,50000,611,1000,0.611,554,0.554,165,0.165,54
37937,31509,6428,19491,60,51000,600,1000,0.6,570,0.57,170,0.17,54
38567,31986,6581,20014,61,52000,630,1000,0.63,523,0.523,153,0.153,54
39166,32411,6755,20589,62,53000,599,1000,0.599,575,0.575,174,0.174,54
39757,32819,6938,21181,63,54000,591,1000,0.591,592,0.592,183,0.183,54
40339,33231,7108,21769,64,55000,582,1000,0.582,588,0.588,170,0.17,54
40932,33654,7278,22346,65,56000,593,1000,0.593,577,0.577,170,0.17,54
41521,34069,7452,22931,66,57000,589,1000,0.589,585,0.585,174,0.174,54
42095,34479,7616,23521,67,58000,574,1000,0.574,590,0.59,164,0.164,54
42695,34908,7787,24092,68,59000,600,1000,0.6,571,0.571,171,0.171,54
43288,35321,7967,24679,69,60000,593,1000,0.593,587,0.587,180,0.18,54
43890,35758,8132,25242,70,61000,602,1000,0.602,563,0.563,165,0.165,54
44450,36164,8286,25836,71,62000,560,1000,0.56,594,0.594,154,0.154,54
45047,36599,8448,26401,72,63000,597,1000,0.597,565,0.565,162,0.162,54
45619,37003,8616,26997,73,64000,572,1000,0.572,596,0.596,168,0.168,54
46208,37427,8781,27573,74,65000,589,1000,0.589,576,0.576,165,0.165,54
46784,37837,8947,28163,75,66000,576,1000,0.576,590,0.59,166,0.166,54
47369,38257,9112,28743,76,67000,585,1000,0.585,580,0.58,165,0.165,54
47932,38644,9288,29356,77,68000,563,1000,0.563,613,0.613,176,0.176,54
48524,39080,9444,29920,78,69000,592,1000,0.592,564,0.564,156,0.156,54
49075,39465,9610,30535,79,70000,551,1000,0.551,615,0.615,166,0.166,54
49628,39857,9771,31143,80,71000,553,1000,0.553,608,0.608,161,0.161,54
50164,40213,9951,31787,81,72000,536,1000,0.536,644,0.644,180,0.18,54
50734,40635,10099,32365,82,73000,570,1000,0.57,578,0.578,148,0.148,54
51309,41031,10278,32969,83,74000,575,1000,0.575,604,0.604,179,0.179,54
51878,41432,10446,33568,84,75000,569,1000,0.569,599,0.599,168,0.168,54
52426,41825,10601,34175,85,76000,548,1000,0.548,607,0.607,155,0.155,54
52987,42205,10782,34795,86,77000,561,1000,0.561,620,0.62,181,0.181,54
53516,42568,10948,35432,87,78000,529,1000,0.529,637,0.637,166,0.166,54
54070,42946,11124,36054,88,79000,554,1000,0.554,622,0.622,176,0.176,54
54605,43319,11286,36681,89,80000,535,1000,0.535,627,0.627,162,0.162,54
55182,43748,11434,37252,90,81000,577,1000,0.577,571,0.571,148,0.148,54
55684,44053,11631,37947,91,82000,502,1000,0.502,695,0.695,197,0.197,54
56203,44396,11807,38604,92,83000,519,1000,0.519,657,0.657,176,0.176,54
56715,44720,11995,39280,93,84000,512,1000,0.512,676,0.676,188,0.188,54
57252,45107,12145,39893,94,85000,537,1000,0.537,613,0.613,150,0.15,54
57783,45475,12308,40525,95,86000,531,1000,0.531,632,0.632,163,0.163,54
58286,45798,12488,41202,96,87000,503,1000,0.503,677,0.677,180,0.18,54
58806,46131,12675,41869,97,88000,520,1000,0.52,667,0.667,187,0.187,54
59316,46488,12828,42512,98,89000,510,1000,0.51,643,0.643,153,0.153,54
59824,46797,13027,43203,99,90000,508,1000,0.508,691,0.691,199,0.199,54
60331,47125,13206,43875,100,91000,507,1000,0.507,672,0.672,179,0.179,54
60829,47458,13371,44542,101,92000,498,1000,0.498,667,0.667,165,0.165,54
61341,47799,13542,45201,102,93000,512,1000,0.512,659,0.659,171,0.171,54
61861,48155,13706,45845,103,94000,520,1000,0.52,644,0.644,164,0.164,54
62362,48471,13891,46529,104,95000,501,1000,0.501,684,0.684,185,0.185,54
62875,48826,14049,47174,105,96000,513,1000,0.513,645,0.645,158,0.158,54
63346,49109,14237,47891,106,97000,471,1000,0.471,717,0.717,188,0.188,54
63858,49451,14407,48549,107,98000,512,1000,0.512,658,0.658,170,0.17,54
64370,49781,14589,49219,108,99000,512,1000,0.512,670,0.67,182,0.182,54
64896,50132,14764,49868,109,100000,526,1000,0.526,649,0.649,175,0.175,54
65376,50438,14938,50562,110,101000,480,1000,0.48,694,0.694,174,0.174,54
65867,50768,15099,51232,111,102000,491,1000,0.491,670,0.67,161,0.161,54
66356,51080,15276,51920,112,103000,489,1000,0.489,688,0.688,177,0.177,54
66833,51375,15458,52625,113,104000,477,1000,0.477,705,0.705,182,0.182,54
67300,51664,15636,53336,114,105000,467,1000,0.467,711,0.711,178,0.178,54
67802,51982,15820,54018,115,106000,502,1000,0.502,682,0.682,184,0.184,54
68293,52303,15990,54697,116,107000,491,1000,0.491,679,0.679,170,0.17,54
68787,52631,16156,55369,117,108000,494,1000,0.494,672,0.672,166,0.166,54
69281,52961,16320,56039,118,109000,494,1000,0.494,670,0.67,164,0.164,54
69777,53298,16479,56702,119,110000,496,1000,0.496,663,0.663,159,0.159,54
70246,53578,16668,57422,120,111000,469,1000,0.469,720,0.72,189,0.189,54
70737,53903,16834,58097,121,112000,491,1000,0.491,675,0.675,166,0.166,54
71246,54249,16997,58751,122,113000,509,1000,0.509,654,0.654,163,0.163,54
71721,54544,17177,59456,123,114000,475,1000,0.475,705,0.705,180,0.18,54
71869,54638,17231,59660,124,114298,148,298,0.49664429530201343,204,0.6845637583892618,54,0.18120805369127516,54
100,100,0,0,1,100,NA,NA,NA,NA,NA,NA,NA,55
200,200,0,0,2,200,100,100,1,0,0,0,0,55
300,300,0,0,3,300,100,100,1,0,0,0,0,55
399,398,1,2,4,400,99,100,0.99,2,0.02,1,0.01,55
498,496,2,4,5,500,99,100,0.99,2,0.02,1,0.01,55
596,592,4,8,6,600,98,100,0.98,4,0.04,2,0.02,55
694,688,6,12,7,700,98,100,0.98,4,0.04,2,0.02,55
794,788,6,12,8,800,100,100,1,0,0,0,0,55
891,883,8,17,9,900,97,100,0.97,5,0.05,2,0.02,55
984,969,15,31,10,1000,93,100,0.93,14,0.14,7,0.07,55
1945,1897,48,103,11,2000,961,1000,0.961,72,0.072,33,0.033,55
2871,2763,108,237,12,3000,926,1000,0.926,134,0.134,60,0.06,55
3787,3623,164,377,13,4000,916,1000,0.916,140,0.14,56,0.056,55
4689,4460,229,540,14,5000,902,1000,0.902,163,0.163,65,0.065,55
5580,5282,298,718,15,6000,891,1000,0.891,178,0.178,69,0.069,55
6452,6073,379,927,16,7000,872,1000,0.872,209,0.209,81,0.081,55
7302,6836,466,1164,17,8000,850,1000,0.85,237,0.237,87,0.087,55
8171,7626,545,1374,18,9000,869,1000,0.869,210,0.21,79,0.079,55
9021,8392,629,1608,19,10000,850,1000,0.85,234,0.234,84,0.084,55
9851,9124,727,1876,20,11000,830,1000,0.83,268,0.268,98,0.098,55
10659,9820,839,2180,21,12000,808,1000,0.808,304,0.304,112,0.112,55
11483,10531,952,2469,22,13000,824,1000,0.824,289,0.289,113,0.113,55
12295,11240,1055,2760,23,14000,812,1000,0.812,291,0.291,103,0.103,55
13089,11929,1160,3071,24,15000,794,1000,0.794,311,0.311,105,0.105,55
13881,12598,1283,3402,25,16000,792,1000,0.792,331,0.331,123,0.123,55
14665,13272,1393,3728,26,17000,784,1000,0.784,326,0.326,110,0.11,55
15408,13876,1532,4124,27,18000,743,1000,0.743,396,0.396,139,0.139,55
16189,14543,1646,4457,28,19000,781,1000,0.781,333,0.333,114,0.114,55
16942,15163,1779,4837,29,20000,753,1000,0.753,380,0.38,133,0.133,55
17693,15782,1911,5218,30,21000,751,1000,0.751,381,0.381,132,0.132,55
18435,16390,2045,5610,31,22000,742,1000,0.742,392,0.392,134,0.134,55
19170,16973,2197,6027,32,23000,735,1000,0.735,417,0.417,152,0.152,55
19937,17633,2304,6367,33,24000,767,1000,0.767,340,0.34,107,0.107,55
20658,18214,2444,6786,34,25000,721,1000,0.721,419,0.419,140,0.14,55
21372,18785,2587,7215,35,26000,714,1000,0.714,429,0.429,143,0.143,55
22078,19340,2738,7660,36,27000,706,1000,0.706,445,0.445,151,0.151,55
22762,19868,2894,8132,37,28000,684,1000,0.684,472,0.472,156,0.156,55
23493,20471,3022,8529,38,29000,731,1000,0.731,397,0.397,128,0.128,55
24206,21037,3169,8963,39,30000,713,1000,0.713,434,0.434,147,0.147,55
24914,21599,3315,9401,40,31000,708,1000,0.708,438,0.438,146,0.146,55
25608,22131,3477,9869,41,32000,694,1000,0.694,468,0.468,162,0.162,55
26298,22671,3627,10329,42,33000,690,1000,0.69,460,0.46,150,0.15,55
26984,23198,3786,10802,43,34000,686,1000,0.686,473,0.473,159,0.159,55
27701,23769,3932,11231,44,35000,717,1000,0.717,429,0.429,146,0.146,55
28351,24241,4110,11759,45,36000,650,1000,0.65,528,0.528,178,0.178,55
29020,24772,4248,12228,46,37000,669,1000,0.669,469,0.469,138,0.138,55
29688,25294,4394,12706,47,38000,668,1000,0.668,478,0.478,146,0.146,55
30327,25765,4562,13235,48,39000,639,1000,0.639,529,0.529,168,0.168,55
30977,26256,4721,13744,49,40000,650,1000,0.65,509,0.509,159,0.159,55
31636,26755,4881,14245,50,41000,659,1000,0.659,501,0.501,160,0.16,55
32298,27260,5038,14740,51,42000,662,1000,0.662,495,0.495,157,0.157,55
32928,27719,5209,15281,52,43000,630,1000,0.63,541,0.541,171,0.171,55
33568,28195,5373,15805,53,44000,640,1000,0.64,524,0.524,164,0.164,55
34188,28638,5550,16362,54,45000,620,1000,0.62,557,0.557,177,0.177,55
34834,29144,5690,16856,55,46000,646,1000,0.646,494,0.494,140,0.14,55
35480,29633,5847,17367,56,47000,646,1000,0.646,511,0.511,157,0.157,55
36136,30141,5995,17859,57,48000,656,1000,0.656,492,0.492,148,0.148,55
36757,30606,6151,18394,58,49000,621,1000,0.621,535,0.535,156,0.156,55
37396,31083,6313,18917,59,50000,639,1000,0.639,523,0.523,162,0.162,55
38016,31535,6481,19465,60,51000,620,1000,0.62,548,0.548,168,0.168,55
38614,31952,6662,20048,61,52000,598,1000,0.598,583,0.583,181,0.181,55
39207,32367,6840,20633,62,53000,593,1000,0.593,585,0.585,178,0.178,55
39831,32829,7002,21171,63,54000,624,1000,0.624,538,0.538,162,0.162,55
40429,33267,7162,21733,64,55000,598,1000,0.598,562,0.562,160,0.16,55
41018,33683,7335,22317,65,56000,589,1000,0.589,584,0.584,173,0.173,55
41633,34130,7503,22870,66,57000,615,1000,0.615,553,0.553,168,0.168,55
42226,34584,7642,23416,67,58000,593,1000,0.593,546,0.546,139,0.139,55
42817,35014,7803,23986,68,59000,591,1000,0.591,570,0.57,161,0.161,55
43394,35441,7953,24559,69,60000,577,1000,0.577,573,0.573,150,0.15,55
43991,35881,8110,25119,70,61000,597,1000,0.597,560,0.56,157,0.157,55
44560,36269,8291,25731,71,62000,569,1000,0.569,612,0.612,181,0.181,55
45139,36676,8463,26324,72,63000,579,1000,0.579,593,0.593,172,0.172,55
45724,37105,8619,26895,73,64000,585,1000,0.585,571,0.571,156,0.156,55
46326,37556,8770,27444,74,65000,602,1000,0.602,549,0.549,151,0.151,55
46875,37931,8944,28069,75,66000,549,1000,0.549,625,0.625,174,0.174,55
47456,38350,9106,28650,76,67000,581,1000,0.581,581,0.581,162,0.162,55
48026,38754,9272,29246,77,68000,570,1000,0.57,596,0.596,166,0.166,55
48582,39140,9442,29860,78,69000,556,1000,0.556,614,0.614,170,0.17,55
49129,39516,9613,30484,79,70000,547,1000,0.547,624,0.624,171,0.171,55
49699,39925,9774,31075,80,71000,570,1000,0.57,591,0.591,161,0.161,55
50257,40333,9924,31667,81,72000,558,1000,0.558,592,0.592,150,0.15,55
50821,40738,10083,32262,82,73000,564,1000,0.564,595,0.595,159,0.159,55
51370,41109,10261,32891,83,74000,549,1000,0.549,629,0.629,178,0.178,55
51936,41507,10429,33493,84,75000,566,1000,0.566,602,0.602,168,0.168,55
52463,41859,10604,34141,85,76000,527,1000,0.527,648,0.648,175,0.175,55
53017,42245,10772,34755,86,77000,554,1000,0.554,614,0.614,168,0.168,55
53557,42616,10941,35384,87,78000,540,1000,0.54,629,0.629,169,0.169,55
54093,42985,11108,36015,88,79000,536,1000,0.536,631,0.631,167,0.167,55
54621,43337,11284,36663,89,80000,528,1000,0.528,648,0.648,176,0.176,55
55141,43684,11457,37316,90,81000,520,1000,0.52,653,0.653,173,0.173,55
55703,44078,11625,37922,91,82000,562,1000,0.562,606,0.606,168,0.168,55
56240,44432,11808,38568,92,83000,537,1000,0.537,646,0.646,183,0.183,55
56803,44832,11971,39168,93,84000,563,1000,0.563,600,0.6,163,0.163,55
57313,45154,12159,39846,94,85000,510,1000,0.51,678,0.678,188,0.188,55
57830,45486,12344,40514,95,86000,517,1000,0.517,668,0.668,185,0.185,55
58360,45840,12520,41160,96,87000,530,1000,0.53,646,0.646,176,0.176,55
58875,46165,12710,41835,97,88000,515,1000,0.515,675,0.675,190,0.19,55
59378,46499,12879,42501,98,89000,503,1000,0.503,666,0.666,169,0.169,55
59930,46882,13048,43118,99,90000,552,1000,0.552,617,0.617,169,0.169,55
60460,47253,13207,43747,100,91000,530,1000,0.53,629,0.629,159,0.159,55
60988,47620,13368,44380,101,92000,528,1000,0.528,633,0.633,161,0.161,55
61508,47957,13551,45043,102,93000,520,1000,0.52,663,0.663,183,0.183,55
62013,48292,13721,45708,103,94000,505,1000,0.505,665,0.665,170,0.17,55
62507,48619,13888,46381,104,95000,494,1000,0.494,673,0.673,167,0.167,55
63015,48935,14080,47065,105,96000,508,1000,0.508,684,0.684,192,0.192,55
63548,49301,14247,47699,106,97000,533,1000,0.533,634,0.634,167,0.167,55
64011,49596,14415,48404,107,98000,463,1000,0.463,705,0.705,168,0.168,55
64515,49926,14589,49074,108,99000,504,1000,0.504,670,0.67,174,0.174,55
64987,50223,14764,49777,109,100000,472,1000,0.472,703,0.703,175,0.175,55
65451,50494,14957,50506,110,101000,464,1000,0.464,729,0.729,193,0.193,55
65933,50800,15133,51200,111,102000,482,1000,0.482,694,0.694,176,0.176,55
66435,51132,15303,51868,112,103000,502,1000,0.502,668,0.668,170,0.17,55
66921,51445,15476,52555,113,104000,486,1000,0.486,687,0.687,173,0.173,55
67438,51794,15644,53206,114,105000,517,1000,0.517,651,0.651,168,0.168,55
67918,52118,15800,53882,115,106000,480,1000,0.48,676,0.676,156,0.156,55
68409,52457,15952,54543,116,107000,491,1000,0.491,661,0.661,152,0.152,55
68882,52760,16122,55240,117,108000,473,1000,0.473,697,0.697,170,0.17,55
69366,53066,16300,55934,118,109000,484,1000,0.484,694,0.694,178,0.178,55
69833,53337,16496,56663,119,110000,467,1000,0.467,729,0.729,196,0.196,55
70319,53639,16680,57361,120,111000,486,1000,0.486,698,0.698,184,0.184,55
70785,53940,16845,58060,121,112000,466,1000,0.466,699,0.699,165,0.165,55
71245,54216,17029,58784,122,113000,460,1000,0.46,724,0.724,184,0.184,55
71730,54550,17180,59450,123,114000,485,1000,0.485,666,0.666,151,0.151,55
71869,54638,17231,59660,124,114298,139,298,0.4664429530201342,210,0.7046979865771812,51,0.17114093959731544,55
100,100,0,0,1,100,NA,NA,NA,NA,NA,NA,NA,56
200,200,0,0,2,200,100,100,1,0,0,0,0,56
299,298,1,2,3,300,99,100,0.99,2,0.02,1,0.01,56
397,394,3,6,4,400,98,100,0.98,4,0.04,2,0.02,56
494,489,5,11,5,500,97,100,0.97,5,0.05,2,0.02,56
593,587,6,13,6,600,99,100,0.99,2,0.02,1,0.01,56
688,679,9,21,7,700,95,100,0.95,8,0.08,3,0.03,56
787,777,10,23,8,800,99,100,0.99,2,0.02,1,0.01,56
886,875,11,25,9,900,99,100,0.99,2,0.02,1,0.01,56
981,967,14,33,10,1000,95,100,0.95,8,0.08,3,0.03,56
1935,1888,47,112,11,2000,954,1000,0.954,79,0.079,33,0.033,56
2872,2780,92,220,12,3000,937,1000,0.937,108,0.108,45,0.045,56
3793,3645,148,355,13,4000,921,1000,0.921,135,0.135,56,0.056,56
4685,4471,214,529,14,5000,892,1000,0.892,174,0.174,66,0.066,56
5586,5315,271,685,15,6000,901,1000,0.901,156,0.156,57,0.057,56
6478,6141,337,859,16,7000,892,1000,0.892,174,0.174,66,0.066,56
7347,6922,425,1078,17,8000,869,1000,0.869,219,0.219,88,0.088,56
8206,7694,512,1306,18,9000,859,1000,0.859,228,0.228,87,0.087,56
9038,8423,615,1577,19,10000,832,1000,0.832,271,0.271,103,0.103,56
9872,9153,719,1847,20,11000,834,1000,0.834,270,0.27,104,0.104,56
10683,9846,837,2154,21,12000,811,1000,0.811,307,0.307,118,0.118,56
11485,10539,946,2461,22,13000,802,1000,0.802,307,0.307,109,0.109,56
12297,11236,1061,2764,23,14000,812,1000,0.812,303,0.303,115,0.115,56
13084,11895,1189,3105,24,15000,787,1000,0.787,341,0.341,128,0.128,56
13878,12583,1295,3417,25,16000,794,1000,0.794,312,0.312,106,0.106,56
14645,13228,1417,3772,26,17000,767,1000,0.767,355,0.355,122,0.122,56
15384,13819,1565,4181,27,18000,739,1000,0.739,409,0.409,148,0.148,56
16131,14420,1711,4580,28,19000,747,1000,0.747,399,0.399,146,0.146,56
16900,15073,1827,4927,29,20000,769,1000,0.769,347,0.347,116,0.116,56
17653,15703,1950,5297,30,21000,753,1000,0.753,370,0.37,123,0.123,56
18418,16349,2069,5651,31,22000,765,1000,0.765,354,0.354,119,0.119,56
19160,16953,2207,6047,32,23000,742,1000,0.742,396,0.396,138,0.138,56
19893,17539,2354,6461,33,24000,733,1000,0.733,414,0.414,147,0.147,56
20626,18128,2498,6872,34,25000,733,1000,0.733,411,0.411,144,0.144,56
21349,18711,2638,7289,35,26000,723,1000,0.723,417,0.417,140,0.14,56
22038,19242,2796,7758,36,27000,689,1000,0.689,469,0.469,158,0.158,56
22764,19839,2925,8161,37,28000,726,1000,0.726,403,0.403,129,0.129,56
23454,20374,3080,8626,38,29000,690,1000,0.69,465,0.465,155,0.155,56
24123,20881,3242,9119,39,30000,669,1000,0.669,493,0.493,162,0.162,56
24797,21390,3407,9610,40,31000,674,1000,0.674,491,0.491,165,0.165,56
25502,21952,3550,10048,41,32000,705,1000,0.705,438,0.438,143,0.143,56
26176,22473,3703,10527,42,33000,674,1000,0.674,479,0.479,153,0.153,56
26870,23019,3851,10981,43,34000,694,1000,0.694,454,0.454,148,0.148,56
27557,23560,3997,11440,44,35000,687,1000,0.687,459,0.459,146,0.146,56
28220,24049,4171,11951,45,36000,663,1000,0.663,511,0.511,174,0.174,56
28910,24612,4298,12388,46,37000,690,1000,0.69,437,0.437,127,0.127,56
29560,25098,4462,12902,47,38000,650,1000,0.65,514,0.514,164,0.164,56
30214,25581,4633,13419,48,39000,654,1000,0.654,517,0.517,171,0.171,56
30860,26075,4785,13925,49,40000,646,1000,0.646,506,0.506,152,0.152,56
31509,26558,4951,14442,50,41000,649,1000,0.649,517,0.517,166,0.166,56
32177,27081,5096,14919,51,42000,668,1000,0.668,477,0.477,145,0.145,56
32827,27560,5267,15440,52,43000,650,1000,0.65,521,0.521,171,0.171,56
33452,28016,5436,15984,53,44000,625,1000,0.625,544,0.544,169,0.169,56
34119,28535,5584,16465,54,45000,667,1000,0.667,481,0.481,148,0.148,56
34739,28991,5748,17009,55,46000,620,1000,0.62,544,0.544,164,0.164,56
35371,29459,5912,17541,56,47000,632,1000,0.632,532,0.532,164,0.164,56
35998,29925,6073,18075,57,48000,627,1000,0.627,534,0.534,161,0.161,56
36636,30393,6243,18607,58,49000,638,1000,0.638,532,0.532,170,0.17,56
37274,30875,6399,19125,59,50000,638,1000,0.638,518,0.518,156,0.156,56
37888,31336,6552,19664,60,51000,614,1000,0.614,539,0.539,153,0.153,56
38498,31788,6710,20212,61,52000,610,1000,0.61,548,0.548,158,0.158,56
39115,32237,6878,20763,62,53000,617,1000,0.617,551,0.551,168,0.168,56
39730,32704,7026,21296,63,54000,615,1000,0.615,533,0.533,148,0.148,56
40337,33150,7187,21850,64,55000,607,1000,0.607,554,0.554,161,0.161,56
40948,33613,7335,22387,65,56000,611,1000,0.611,537,0.537,148,0.148,56
41577,34089,7488,22911,66,57000,629,1000,0.629,524,0.524,153,0.153,56
42199,34552,7647,23448,67,58000,622,1000,0.622,537,0.537,159,0.159,56
42783,34966,7817,24034,68,59000,584,1000,0.584,586,0.586,170,0.17,56
43393,35408,7985,24592,69,60000,610,1000,0.61,558,0.558,168,0.168,56
43976,35832,8144,25168,70,61000,583,1000,0.583,576,0.576,159,0.159,56
44564,36265,8299,25735,71,62000,588,1000,0.588,567,0.567,155,0.155,56
45147,36671,8476,26329,72,63000,583,1000,0.583,594,0.594,177,0.177,56
45707,37059,8648,26941,73,64000,560,1000,0.56,612,0.612,172,0.172,56
46285,37456,8829,27544,74,65000,578,1000,0.578,603,0.603,181,0.181,56
46860,37866,8994,28134,75,66000,575,1000,0.575,590,0.59,165,0.165,56
47425,38262,9163,28738,76,67000,565,1000,0.565,604,0.604,169,0.169,56
47975,38624,9351,29376,77,68000,550,1000,0.55,638,0.638,188,0.188,56
48533,39020,9513,29980,78,69000,558,1000,0.558,604,0.604,162,0.162,56
49087,39414,9673,30586,79,70000,554,1000,0.554,606,0.606,160,0.16,56
49653,39828,9825,31172,80,71000,566,1000,0.566,586,0.586,152,0.152,56
50229,40252,9977,31748,81,72000,576,1000,0.576,576,0.576,152,0.152,56
50802,40677,10125,32323,82,73000,573,1000,0.573,575,0.575,148,0.148,56
51369,41065,10304,32935,83,74000,567,1000,0.567,612,0.612,179,0.179,56
51904,41419,10485,33581,84,75000,535,1000,0.535,646,0.646,181,0.181,56
52446,41810,10636,34190,85,76000,542,1000,0.542,609,0.609,151,0.151,56
52989,42178,10811,34822,86,77000,543,1000,0.543,632,0.632,175,0.175,56
53539,42565,10974,35435,87,78000,550,1000,0.55,613,0.613,163,0.163,56
54070,42941,11129,36059,88,79000,531,1000,0.531,624,0.624,155,0.155,56
54617,43306,11311,36694,89,80000,547,1000,0.547,635,0.635,182,0.182,56
55154,43655,11499,37345,90,81000,537,1000,0.537,651,0.651,188,0.188,56
55690,44017,11673,37983,91,82000,536,1000,0.536,638,0.638,174,0.174,56
56210,44352,11858,38648,92,83000,520,1000,0.52,665,0.665,185,0.185,56
56737,44715,12022,39285,93,84000,527,1000,0.527,637,0.637,164,0.164,56
57282,45084,12198,39916,94,85000,545,1000,0.545,631,0.631,176,0.176,56
57808,45428,12380,40572,95,86000,526,1000,0.526,656,0.656,182,0.182,56
58335,45785,12550,41215,96,87000,527,1000,0.527,643,0.643,170,0.17,56
58860,46147,12713,41853,97,88000,525,1000,0.525,638,0.638,163,0.163,56
59374,46490,12884,42510,98,89000,514,1000,0.514,657,0.657,171,0.171,56
59896,46843,13053,43157,99,90000,522,1000,0.522,647,0.647,169,0.169,56
60388,47157,13231,43843,100,91000,492,1000,0.492,686,0.686,178,0.178,56
60905,47508,13397,44492,101,92000,517,1000,0.517,649,0.649,166,0.166,56
61393,47817,13576,45183,102,93000,488,1000,0.488,691,0.691,179,0.179,56
61900,48153,13747,45847,103,94000,507,1000,0.507,664,0.664,171,0.171,56
62386,48450,13936,46550,104,95000,486,1000,0.486,703,0.703,189,0.189,56
62897,48795,14102,47205,105,96000,511,1000,0.511,655,0.655,166,0.166,56
63395,49126,14269,47874,106,97000,498,1000,0.498,669,0.669,167,0.167,56
63894,49448,14446,48552,107,98000,499,1000,0.499,678,0.678,177,0.177,56
64394,49754,14640,49246,108,99000,500,1000,0.5,694,0.694,194,0.194,56
64876,50066,14810,49934,109,100000,482,1000,0.482,688,0.688,170,0.17,56
65375,50400,14975,50600,110,101000,499,1000,0.499,666,0.666,165,0.165,56
65877,50736,15141,51264,111,102000,502,1000,0.502,664,0.664,166,0.166,56
66362,51042,15320,51958,112,103000,485,1000,0.485,694,0.694,179,0.179,56
66859,51366,15493,52634,113,104000,497,1000,0.497,676,0.676,173,0.173,56
67352,51715,15637,53285,114,105000,493,1000,0.493,651,0.651,144,0.144,56
67839,52012,15827,53988,115,106000,487,1000,0.487,703,0.703,190,0.19,56
68340,52338,16002,54662,116,107000,501,1000,0.501,674,0.674,175,0.175,56
68866,52717,16149,55283,117,108000,526,1000,0.526,621,0.621,147,0.147,56
69350,53046,16304,55954,118,109000,484,1000,0.484,671,0.671,155,0.155,56
69825,53354,16471,56646,119,110000,475,1000,0.475,692,0.692,167,0.167,56
70312,53657,16655,57343,120,111000,487,1000,0.487,697,0.697,184,0.184,56
70783,53969,16814,58031,121,112000,471,1000,0.471,688,0.688,159,0.159,56
71257,54247,17010,58753,122,113000,474,1000,0.474,722,0.722,196,0.196,56
71712,54522,17190,59478,123,114000,455,1000,0.455,725,0.725,180,0.18,56
71869,54638,17231,59660,124,114298,157,298,0.5268456375838926,182,0.610738255033557,41,0.13758389261744966,56
100,100,0,0,1,100,NA,NA,NA,NA,NA,NA,NA,57
200,200,0,0,2,200,100,100,1,0,0,0,0,57
299,298,1,2,3,300,99,100,0.99,2,0.02,1,0.01,57
397,394,3,6,4,400,98,100,0.98,4,0.04,2,0.02,57
496,492,4,8,5,500,99,100,0.99,2,0.02,1,0.01,57
592,584,8,16,6,600,96,100,0.96,8,0.08,4,0.04,57
691,682,9,18,7,700,99,100,0.99,2,0.02,1,0.01,57
789,779,10,21,8,800,98,100,0.98,3,0.03,1,0.01,57
885,872,13,28,9,900,96,100,0.96,7,0.07,3,0.03,57
979,961,18,39,10,1000,94,100,0.94,11,0.11,5,0.05,57
1924,1860,64,140,11,2000,945,1000,0.945,101,0.101,46,0.046,57
2867,2765,102,235,12,3000,943,1000,0.943,95,0.095,38,0.038,57
3774,3605,169,395,13,4000,907,1000,0.907,160,0.16,67,0.067,57
4665,4425,240,575,14,5000,891,1000,0.891,180,0.18,71,0.071,57
5558,5247,311,753,15,6000,893,1000,0.893,178,0.178,71,0.071,57
6422,6039,383,961,16,7000,864,1000,0.864,208,0.208,72,0.072,57
7283,6814,469,1186,17,8000,861,1000,0.861,225,0.225,86,0.086,57
8145,7600,545,1400,18,9000,862,1000,0.862,214,0.214,76,0.076,57
9000,8379,621,1621,19,10000,855,1000,0.855,221,0.221,76,0.076,57
9839,9127,712,1873,20,11000,839,1000,0.839,252,0.252,91,0.091,57
10649,9825,824,2175,21,12000,810,1000,0.81,302,0.302,112,0.112,57
11488,10570,918,2430,22,13000,839,1000,0.839,255,0.255,94,0.094,57
12273,11226,1047,2774,23,14000,785,1000,0.785,344,0.344,129,0.129,57
13072,11897,1175,3103,24,15000,799,1000,0.799,329,0.329,128,0.128,57
13850,12546,1304,3454,25,16000,778,1000,0.778,351,0.351,129,0.129,57
14614,13193,1421,3807,26,17000,764,1000,0.764,353,0.353,117,0.117,57
15371,13819,1552,4181,27,18000,757,1000,0.757,374,0.374,131,0.131,57
16146,14467,1679,4533,28,19000,775,1000,0.775,352,0.352,127,0.127,57
16898,15083,1815,4917,29,20000,752,1000,0.752,384,0.384,136,0.136,57
17658,15733,1925,5267,30,21000,760,1000,0.76,350,0.35,110,0.11,57
18395,16333,2062,5667,31,22000,737,1000,0.737,400,0.4,137,0.137,57
19140,16940,2200,6060,32,23000,745,1000,0.745,393,0.393,138,0.138,57
19875,17537,2338,6463,33,24000,735,1000,0.735,403,0.403,138,0.138,57
20596,18114,2482,6886,34,25000,721,1000,0.721,423,0.423,144,0.144,57
21327,18695,2632,7305,35,26000,731,1000,0.731,419,0.419,150,0.15,57
22036,19259,2777,7741,36,27000,709,1000,0.709,436,0.436,145,0.145,57
22745,19818,2927,8182,37,28000,709,1000,0.709,441,0.441,150,0.15,57
23451,20378,3073,8622,38,29000,706,1000,0.706,440,0.44,146,0.146,57
24152,20933,3219,9067,39,30000,701,1000,0.701,445,0.445,146,0.146,57
24870,21511,3359,9489,40,31000,718,1000,0.718,422,0.422,140,0.14,57
25538,22010,3528,9990,41,32000,668,1000,0.668,501,0.501,169,0.169,57
26202,22518,3684,10482,42,33000,664,1000,0.664,492,0.492,156,0.156,57
26880,23040,3840,10960,43,34000,678,1000,0.678,478,0.478,156,0.156,57
27571,23576,3995,11424,44,35000,691,1000,0.691,464,0.464,155,0.155,57
28259,24123,4136,11877,45,36000,688,1000,0.688,453,0.453,141,0.141,57
28922,24644,4278,12356,46,37000,663,1000,0.663,479,0.479,142,0.142,57
29621,25191,4430,12809,47,38000,699,1000,0.699,453,0.453,152,0.152,57
30254,25668,4586,13332,48,39000,633,1000,0.633,523,0.523,156,0.156,57
30903,26158,4745,13842,49,40000,649,1000,0.649,510,0.51,159,0.159,57
31544,26635,4909,14365,50,41000,641,1000,0.641,523,0.523,164,0.164,57
32197,27136,5061,14864,51,42000,653,1000,0.653,499,0.499,152,0.152,57
32826,27611,5215,15389,52,43000,629,1000,0.629,525,0.525,154,0.154,57
33480,28100,5380,15900,53,44000,654,1000,0.654,511,0.511,165,0.165,57
34092,28537,5555,16463,54,45000,612,1000,0.612,563,0.563,175,0.175,57
34737,29025,5712,16975,55,46000,645,1000,0.645,512,0.512,157,0.157,57
35353,29474,5879,17526,56,47000,616,1000,0.616,551,0.551,167,0.167,57
35978,29936,6042,18064,57,48000,625,1000,0.625,538,0.538,163,0.163,57
36613,30404,6209,18596,58,49000,635,1000,0.635,532,0.532,167,0.167,57
37227,30850,6377,19150,59,50000,614,1000,0.614,554,0.554,168,0.168,57
37864,31323,6541,19677,60,51000,637,1000,0.637,527,0.527,164,0.164,57
38488,31793,6695,20207,61,52000,624,1000,0.624,530,0.53,154,0.154,57
39100,32249,6851,20751,62,53000,612,1000,0.612,544,0.544,156,0.156,57
39683,32668,7015,21332,63,54000,583,1000,0.583,581,0.581,164,0.164,57
40285,33096,7189,21904,64,55000,602,1000,0.602,572,0.572,174,0.174,57
40896,33545,7351,22455,65,56000,611,1000,0.611,551,0.551,162,0.162,57
41497,33993,7504,23007,66,57000,601,1000,0.601,552,0.552,153,0.153,57
42067,34389,7678,23611,67,58000,570,1000,0.57,604,0.604,174,0.174,57
42643,34796,7847,24204,68,59000,576,1000,0.576,593,0.593,169,0.169,57
43252,35248,8004,24752,69,60000,609,1000,0.609,548,0.548,157,0.157,57
43844,35652,8192,25348,70,61000,592,1000,0.592,596,0.596,188,0.188,57
44430,36061,8369,25939,71,62000,586,1000,0.586,591,0.591,177,0.177,57
45007,36453,8554,26547,72,63000,577,1000,0.577,608,0.608,185,0.185,57
45574,36856,8718,27144,73,64000,567,1000,0.567,597,0.597,164,0.164,57
46154,37275,8879,27725,74,65000,580,1000,0.58,581,0.581,161,0.161,57
46696,37634,9062,28366,75,66000,542,1000,0.542,641,0.641,183,0.183,57
47299,38098,9201,28902,76,67000,603,1000,0.603,536,0.536,139,0.139,57
47855,38491,9364,29509,77,68000,556,1000,0.556,607,0.607,163,0.163,57
48395,38854,9541,30146,78,69000,540,1000,0.54,637,0.637,177,0.177,57
48949,39227,9722,30773,79,70000,554,1000,0.554,627,0.627,181,0.181,57
49541,39663,9878,31337,80,71000,592,1000,0.592,564,0.564,156,0.156,57
50096,40039,10057,31961,81,72000,555,1000,0.555,624,0.624,179,0.179,57
50640,40411,10229,32589,82,73000,544,1000,0.544,628,0.628,172,0.172,57
51138,40725,10413,33275,83,74000,498,1000,0.498,686,0.686,184,0.184,57
51706,41131,10575,33869,84,75000,568,1000,0.568,594,0.594,162,0.162,57
52260,41513,10747,34487,85,76000,554,1000,0.554,618,0.618,172,0.172,57
52805,41880,10925,35120,86,77000,545,1000,0.545,633,0.633,178,0.178,57
53370,42284,11086,35716,87,78000,565,1000,0.565,596,0.596,161,0.161,57
53904,42646,11258,36354,88,79000,534,1000,0.534,638,0.638,172,0.172,57
54427,42984,11443,37016,89,80000,523,1000,0.523,662,0.662,185,0.185,57
54969,43357,11612,37643,90,81000,542,1000,0.542,627,0.627,169,0.169,57
55507,43714,11793,38286,91,82000,538,1000,0.538,643,0.643,181,0.181,57
56021,44061,11960,38939,92,83000,514,1000,0.514,653,0.653,167,0.167,57
56545,44432,12113,39568,93,84000,524,1000,0.524,629,0.629,153,0.153,57
57075,44793,12282,40207,94,85000,530,1000,0.53,639,0.639,169,0.169,57
57589,45143,12446,40857,95,86000,514,1000,0.514,650,0.65,164,0.164,57
58126,45517,12609,41483,96,87000,537,1000,0.537,626,0.626,163,0.163,57
58640,45846,12794,42154,97,88000,514,1000,0.514,671,0.671,185,0.185,57
59159,46179,12980,42821,98,89000,519,1000,0.519,667,0.667,186,0.186,57
59679,46518,13161,43482,99,90000,520,1000,0.52,661,0.661,181,0.181,57
60176,46845,13331,44155,100,91000,497,1000,0.497,673,0.673,170,0.17,57
60674,47150,13524,44850,101,92000,498,1000,0.498,695,0.695,193,0.193,57
61173,47468,13705,45532,102,93000,499,1000,0.499,682,0.682,181,0.181,57
61688,47816,13872,46184,103,94000,515,1000,0.515,652,0.652,167,0.167,57
62182,48127,14055,46873,104,95000,494,1000,0.494,689,0.689,183,0.183,57
62707,48516,14191,47484,105,96000,525,1000,0.525,611,0.611,136,0.136,57
63199,48840,14359,48160,106,97000,492,1000,0.492,676,0.676,168,0.168,57
63729,49212,14517,48788,107,98000,530,1000,0.53,628,0.628,158,0.158,57
64230,49561,14669,49439,108,99000,501,1000,0.501,651,0.651,152,0.152,57
64781,49956,14825,50044,109,100000,551,1000,0.551,605,0.605,156,0.156,57
65259,50270,14989,50730,110,101000,478,1000,0.478,686,0.686,164,0.164,57
65754,50576,15178,51424,111,102000,495,1000,0.495,694,0.694,189,0.189,57
66231,50874,15357,52126,112,103000,477,1000,0.477,702,0.702,179,0.179,57
66746,51247,15499,52753,113,104000,515,1000,0.515,627,0.627,142,0.142,57
67255,51584,15671,53416,114,105000,509,1000,0.509,663,0.663,172,0.172,57
67793,51966,15827,54034,115,106000,538,1000,0.538,618,0.618,156,0.156,57
68321,52338,15983,54662,116,107000,528,1000,0.528,628,0.628,156,0.156,57
68812,52670,16142,55330,117,108000,491,1000,0.491,668,0.668,159,0.159,57
69308,52978,16330,56022,118,109000,496,1000,0.496,692,0.692,188,0.188,57
69788,53285,16503,56715,119,110000,480,1000,0.48,693,0.693,173,0.173,57
70278,53598,16680,57402,120,111000,490,1000,0.49,687,0.687,177,0.177,57
70771,53925,16846,58075,121,112000,493,1000,0.493,673,0.673,166,0.166,57
71258,54242,17016,58758,122,113000,487,1000,0.487,683,0.683,170,0.17,57
71739,54552,17187,59448,123,114000,481,1000,0.481,690,0.69,171,0.171,57
71869,54638,17231,59660,124,114298,130,298,0.436241610738255,212,0.7114093959731543,44,0.1476510067114094,57
100,100,0,0,1,100,NA,NA,NA,NA,NA,NA,NA,58
199,198,1,2,2,200,99,100,0.99,2,0.02,1,0.01,58
297,294,3,6,3,300,98,100,0.98,4,0.04,2,0.02,58
396,392,4,8,4,400,99,100,0.99,2,0.02,1,0.01,58
494,488,6,12,5,500,98,100,0.98,4,0.04,2,0.02,58
594,588,6,12,6,600,100,100,1,0,0,0,0,58
693,686,7,14,7,700,99,100,0.99,2,0.02,1,0.01,58
792,784,8,16,8,800,99,100,0.99,2,0.02,1,0.01,58
888,877,11,23,9,900,96,100,0.96,7,0.07,3,0.03,58
982,967,15,33,10,1000,94,100,0.94,10,0.1,4,0.04,58
1942,1895,47,105,11,2000,960,1000,0.96,72,0.072,32,0.032,58
2883,2790,93,210,12,3000,941,1000,0.941,105,0.105,46,0.046,58
3806,3657,149,343,13,4000,923,1000,0.923,133,0.133,56,0.056,58
4727,4522,205,478,14,5000,921,1000,0.921,135,0.135,56,0.056,58
5615,5332,283,668,15,6000,888,1000,0.888,190,0.19,78,0.078,58
6498,6137,361,863,16,7000,883,1000,0.883,195,0.195,78,0.078,58
7359,6908,451,1092,17,8000,861,1000,0.861,229,0.229,90,0.09,58
8218,7669,549,1331,18,9000,859,1000,0.859,239,0.239,98,0.098,58
9063,8422,641,1578,19,10000,845,1000,0.845,247,0.247,92,0.092,58
9890,9140,750,1860,20,11000,827,1000,0.827,282,0.282,109,0.109,58
10702,9837,865,2163,21,12000,812,1000,0.812,303,0.303,115,0.115,58
11503,10518,985,2482,22,13000,801,1000,0.801,319,0.319,120,0.12,58
12292,11187,1105,2813,23,14000,789,1000,0.789,331,0.331,120,0.12,58
13077,11860,1217,3140,24,15000,785,1000,0.785,327,0.327,112,0.112,58
13879,12548,1331,3452,25,16000,802,1000,0.802,312,0.312,114,0.114,58
14654,13202,1452,3798,26,17000,775,1000,0.775,346,0.346,121,0.121,58
15408,13823,1585,4177,27,18000,754,1000,0.754,379,0.379,133,0.133,58
16185,14473,1712,4527,28,19000,777,1000,0.777,350,0.35,127,0.127,58
16942,15088,1854,4912,29,20000,757,1000,0.757,385,0.385,142,0.142,58
17702,15711,1991,5289,30,21000,760,1000,0.76,377,0.377,137,0.137,58
18455,16327,2128,5673,31,22000,753,1000,0.753,384,0.384,137,0.137,58
19192,16927,2265,6073,32,23000,737,1000,0.737,400,0.4,137,0.137,58
19922,17514,2408,6486,33,24000,730,1000,0.73,413,0.413,143,0.143,58
20645,18098,2547,6902,34,25000,723,1000,0.723,416,0.416,139,0.139,58
21362,18666,2696,7334,35,26000,717,1000,0.717,432,0.432,149,0.149,58
22078,19243,2835,7757,36,27000,716,1000,0.716,423,0.423,139,0.139,58
22790,19799,2991,8201,37,28000,712,1000,0.712,444,0.444,156,0.156,58
23475,20329,3146,8671,38,29000,685,1000,0.685,470,0.47,155,0.155,58
24151,20851,3300,9149,39,30000,676,1000,0.676,478,0.478,154,0.154,58
24834,21393,3441,9607,40,31000,683,1000,0.683,458,0.458,141,0.141,58
25530,21950,3580,10050,41,32000,696,1000,0.696,443,0.443,139,0.139,58
26203,22462,3741,10538,42,33000,673,1000,0.673,488,0.488,161,0.161,58
26861,22951,3910,11049,43,34000,658,1000,0.658,511,0.511,169,0.169,58
27548,23500,4048,11500,44,35000,687,1000,0.687,451,0.451,138,0.138,58
28218,24019,4199,11981,45,36000,670,1000,0.67,481,0.481,151,0.151,58
28898,24552,4346,12448,46,37000,680,1000,0.68,467,0.467,147,0.147,58
29553,25055,4498,12945,47,38000,655,1000,0.655,497,0.497,152,0.152,58
30211,25565,4646,13435,48,39000,658,1000,0.658,490,0.49,148,0.148,58
30874,26088,4786,13912,49,40000,663,1000,0.663,477,0.477,140,0.14,58
31540,26588,4952,14412,50,41000,666,1000,0.666,500,0.5,166,0.166,58
32173,27067,5106,14933,51,42000,633,1000,0.633,521,0.521,154,0.154,58
32819,27551,5268,15449,52,43000,646,1000,0.646,516,0.516,162,0.162,58
33481,28064,5417,15936,53,44000,662,1000,0.662,487,0.487,149,0.149,58
34140,28571,5569,16429,54,45000,659,1000,0.659,493,0.493,152,0.152,58
34775,29042,5733,16958,55,46000,635,1000,0.635,529,0.529,164,0.164,58
35392,29483,5909,17517,56,47000,617,1000,0.617,559,0.559,176,0.176,58
36020,29943,6077,18057,57,48000,628,1000,0.628,540,0.54,168,0.168,58
36663,30442,6221,18558,58,49000,643,1000,0.643,501,0.501,144,0.144,58
37277,30900,6377,19100,59,50000,614,1000,0.614,542,0.542,156,0.156,58
37891,31338,6553,19662,60,51000,614,1000,0.614,562,0.562,176,0.176,58
38520,31816,6704,20184,61,52000,629,1000,0.629,522,0.522,151,0.151,58
39131,32266,6865,20734,62,53000,611,1000,0.611,550,0.55,161,0.161,58
39737,32720,7017,21280,63,54000,606,1000,0.606,546,0.546,152,0.152,58
40367,33204,7163,21796,64,55000,630,1000,0.63,516,0.516,146,0.146,58
40960,33619,7341,22381,65,56000,593,1000,0.593,585,0.585,178,0.178,58
41516,33983,7533,23017,66,57000,556,1000,0.556,636,0.636,192,0.192,58
42103,34407,7696,23593,67,58000,587,1000,0.587,576,0.576,163,0.163,58
42676,34814,7862,24186,68,59000,573,1000,0.573,593,0.593,166,0.166,58
43267,35229,8038,24771,69,60000,591,1000,0.591,585,0.585,176,0.176,58
43834,35639,8195,25361,70,61000,567,1000,0.567,590,0.59,157,0.157,58
44447,36108,8339,25892,71,62000,613,1000,0.613,531,0.531,144,0.144,58
45022,36501,8521,26499,72,63000,575,1000,0.575,607,0.607,182,0.182,58
45615,36921,8694,27079,73,64000,593,1000,0.593,580,0.58,173,0.173,58
46177,37320,8857,27680,74,65000,562,1000,0.562,601,0.601,163,0.163,58
46758,37735,9023,28265,75,66000,581,1000,0.581,585,0.585,166,0.166,58
47338,38156,9182,28844,76,67000,580,1000,0.58,579,0.579,159,0.159,58
47930,38578,9352,29422,77,68000,592,1000,0.592,578,0.578,170,0.17,58
48492,38965,9527,30035,78,69000,562,1000,0.562,613,0.613,175,0.175,58
49051,39358,9693,30642,79,70000,559,1000,0.559,607,0.607,166,0.166,58
49625,39779,9846,31221,80,71000,574,1000,0.574,579,0.579,153,0.153,58
50176,40155,10021,31845,81,72000,551,1000,0.551,624,0.624,175,0.175,58
50754,40567,10187,32433,82,73000,578,1000,0.578,588,0.588,166,0.166,58
51306,40961,10345,33039,83,74000,552,1000,0.552,606,0.606,158,0.158,58
51867,41339,10528,33661,84,75000,561,1000,0.561,622,0.622,183,0.183,58
52384,41668,10716,34332,85,76000,517,1000,0.517,671,0.671,188,0.188,58
52938,42056,10882,34944,86,77000,554,1000,0.554,612,0.612,166,0.166,58
53500,42450,11050,35550,87,78000,562,1000,0.562,606,0.606,168,0.168,58
54065,42868,11197,36132,88,79000,565,1000,0.565,582,0.582,147,0.147,58
54622,43255,11367,36745,89,80000,557,1000,0.557,613,0.613,170,0.17,58
55160,43645,11515,37355,90,81000,538,1000,0.538,610,0.61,148,0.148,58
55707,44034,11673,37966,91,82000,547,1000,0.547,611,0.611,158,0.158,58
56240,44386,11854,38614,92,83000,533,1000,0.533,648,0.648,181,0.181,58
56789,44770,12019,39230,93,84000,549,1000,0.549,616,0.616,165,0.165,58
57322,45138,12184,39862,94,85000,533,1000,0.533,632,0.632,165,0.165,58
57865,45531,12334,40469,95,86000,543,1000,0.543,607,0.607,150,0.15,58
58379,45867,12512,41133,96,87000,514,1000,0.514,664,0.664,178,0.178,58
58894,46216,12678,41784,97,88000,515,1000,0.515,651,0.651,166,0.166,58
59407,46538,12869,42462,98,89000,513,1000,0.513,678,0.678,191,0.191,58
59935,46907,13028,43093,99,90000,528,1000,0.528,631,0.631,159,0.159,58
60466,47274,13192,43726,100,91000,531,1000,0.531,633,0.633,164,0.164,58
60986,47624,13362,44376,101,92000,520,1000,0.52,650,0.65,170,0.17,58
61486,47967,13519,45033,102,93000,500,1000,0.5,657,0.657,157,0.157,58
61981,48286,13695,45714,103,94000,495,1000,0.495,681,0.681,176,0.176,58
62512,48665,13847,46335,104,95000,531,1000,0.531,621,0.621,152,0.152,58
62996,48985,14011,47015,105,96000,484,1000,0.484,680,0.68,164,0.164,58
63516,49325,14191,47675,106,97000,520,1000,0.52,660,0.66,180,0.18,58
64032,49661,14371,48339,107,98000,516,1000,0.516,664,0.664,180,0.18,58
64534,49990,14544,49010,108,99000,502,1000,0.502,671,0.671,173,0.173,58
65055,50336,14719,49664,109,100000,521,1000,0.521,654,0.654,175,0.175,58
65549,50641,14908,50359,110,101000,494,1000,0.494,695,0.695,189,0.189,58
66042,50968,15074,51032,111,102000,493,1000,0.493,673,0.673,166,0.166,58
66515,51258,15257,51742,112,103000,473,1000,0.473,710,0.71,183,0.183,58
67016,51587,15429,52413,113,104000,501,1000,0.501,671,0.671,172,0.172,58
67479,51881,15598,53119,114,105000,463,1000,0.463,706,0.706,169,0.169,58
67966,52208,15758,53792,115,106000,487,1000,0.487,673,0.673,160,0.16,58
68441,52499,15942,54501,116,107000,475,1000,0.475,709,0.709,184,0.184,58
68909,52786,16123,55214,117,108000,468,1000,0.468,713,0.713,181,0.181,58
69401,53106,16295,55894,118,109000,492,1000,0.492,680,0.68,172,0.172,58
69892,53412,16480,56588,119,110000,491,1000,0.491,694,0.694,185,0.185,58
70386,53739,16647,57261,120,111000,494,1000,0.494,673,0.673,167,0.167,58
70841,54016,16825,57984,121,112000,455,1000,0.455,723,0.723,178,0.178,58
71291,54286,17005,58714,122,113000,450,1000,0.45,730,0.73,180,0.18,58
71727,54539,17188,59461,123,114000,436,1000,0.436,747,0.747,183,0.183,58
71869,54638,17231,59660,124,114298,142,298,0.47651006711409394,199,0.6677852348993288,43,0.14429530201342283,58
100,100,0,0,1,100,NA,NA,NA,NA,NA,NA,NA,59
200,200,0,0,2,200,100,100,1,0,0,0,0,59
299,298,1,2,3,300,99,100,0.99,2,0.02,1,0.01,59
397,395,2,5,4,400,98,100,0.98,3,0.03,1,0.01,59
496,493,3,7,5,500,99,100,0.99,2,0.02,1,0.01,59
594,589,5,11,6,600,98,100,0.98,4,0.04,2,0.02,59
691,684,7,16,7,700,97,100,0.97,5,0.05,2,0.02,59
787,776,11,24,8,800,96,100,0.96,8,0.08,4,0.04,59
887,876,11,24,9,900,100,100,1,0,0,0,0,59
986,974,12,26,10,1000,99,100,0.99,2,0.02,1,0.01,59
1946,1897,49,103,11,2000,960,1000,0.96,77,0.077,37,0.037,59
2873,2767,106,233,12,3000,927,1000,0.927,130,0.13,57,0.057,59
3778,3608,170,392,13,4000,905,1000,0.905,159,0.159,64,0.064,59
4690,4468,222,532,14,5000,912,1000,0.912,140,0.14,52,0.052,59
5585,5302,283,698,15,6000,895,1000,0.895,166,0.166,61,0.061,59
6464,6095,369,905,16,7000,879,1000,0.879,207,0.207,86,0.086,59
7313,6851,462,1149,17,8000,849,1000,0.849,244,0.244,93,0.093,59
8149,7578,571,1422,18,9000,836,1000,0.836,273,0.273,109,0.109,59
8977,8310,667,1690,19,10000,828,1000,0.828,268,0.268,96,0.096,59
9796,9019,777,1981,20,11000,819,1000,0.819,291,0.291,110,0.11,59
10615,9739,876,2261,21,12000,819,1000,0.819,280,0.28,99,0.099,59
11433,10451,982,2549,22,13000,818,1000,0.818,288,0.288,106,0.106,59
12243,11151,1092,2849,23,14000,810,1000,0.81,300,0.3,110,0.11,59
13050,11851,1199,3149,24,15000,807,1000,0.807,300,0.3,107,0.107,59
13829,12510,1319,3490,25,16000,779,1000,0.779,341,0.341,120,0.12,59
14626,13188,1438,3812,26,17000,797,1000,0.797,322,0.322,119,0.119,59
15376,13791,1585,4209,27,18000,750,1000,0.75,397,0.397,147,0.147,59
16130,14409,1721,4591,28,19000,754,1000,0.754,382,0.382,136,0.136,59
16896,15057,1839,4943,29,20000,766,1000,0.766,352,0.352,118,0.118,59
17658,15685,1973,5315,30,21000,762,1000,0.762,372,0.372,134,0.134,59
18408,16300,2108,5700,31,22000,750,1000,0.75,385,0.385,135,0.135,59
19127,16859,2268,6141,32,23000,719,1000,0.719,441,0.441,160,0.16,59
19871,17460,2411,6540,33,24000,744,1000,0.744,399,0.399,143,0.143,59
20607,18066,2541,6934,34,25000,736,1000,0.736,394,0.394,130,0.13,59
21331,18657,2674,7343,35,26000,724,1000,0.724,409,0.409,133,0.133,59
22045,19230,2815,7770,36,27000,714,1000,0.714,427,0.427,141,0.141,59
22760,19802,2958,8198,37,28000,715,1000,0.715,428,0.428,143,0.143,59
23481,20392,3089,8608,38,29000,721,1000,0.721,410,0.41,131,0.131,59
24173,20923,3250,9077,39,30000,692,1000,0.692,469,0.469,161,0.161,59
24849,21461,3388,9539,40,31000,676,1000,0.676,462,0.462,138,0.138,59
25550,22036,3514,9964,41,32000,701,1000,0.701,425,0.425,126,0.126,59
26214,22526,3688,10474,42,33000,664,1000,0.664,510,0.51,174,0.174,59
26894,23064,3830,10936,43,34000,680,1000,0.68,462,0.462,142,0.142,59
27583,23605,3978,11395,44,35000,689,1000,0.689,459,0.459,148,0.148,59
28258,24148,4110,11852,45,36000,675,1000,0.675,457,0.457,132,0.132,59
28931,24673,4258,12327,46,37000,673,1000,0.673,475,0.475,148,0.148,59
29600,25181,4419,12819,47,38000,669,1000,0.669,492,0.492,161,0.161,59
30281,25716,4565,13284,48,39000,681,1000,0.681,465,0.465,146,0.146,59
30931,26192,4739,13808,49,40000,650,1000,0.65,524,0.524,174,0.174,59
31591,26702,4889,14298,50,41000,660,1000,0.66,490,0.49,150,0.15,59
32226,27180,5046,14820,51,42000,635,1000,0.635,522,0.522,157,0.157,59
32885,27700,5185,15300,52,43000,659,1000,0.659,480,0.48,139,0.139,59
33513,28148,5365,15852,53,44000,628,1000,0.628,552,0.552,180,0.18,59
34179,28671,5508,16329,54,45000,666,1000,0.666,477,0.477,143,0.143,59
34823,29174,5649,16826,55,46000,644,1000,0.644,497,0.497,141,0.141,59
35427,29600,5827,17400,56,47000,604,1000,0.604,574,0.574,178,0.178,59
36053,30066,5987,17934,57,48000,626,1000,0.626,534,0.534,160,0.16,59
36664,30502,6162,18498,58,49000,611,1000,0.611,564,0.564,175,0.175,59
37275,30958,6317,19042,59,50000,611,1000,0.611,544,0.544,155,0.155,59
37900,31427,6473,19573,60,51000,625,1000,0.625,531,0.531,156,0.156,59
38492,31843,6649,20157,61,52000,592,1000,0.592,584,0.584,176,0.176,59
39110,32286,6824,20714,62,53000,618,1000,0.618,557,0.557,175,0.175,59
39713,32731,6982,21269,63,54000,603,1000,0.603,555,0.555,158,0.158,59
40351,33229,7122,21771,64,55000,638,1000,0.638,502,0.502,140,0.14,59
40948,33661,7287,22339,65,56000,597,1000,0.597,568,0.568,165,0.165,59
41556,34129,7427,22871,66,57000,608,1000,0.608,532,0.532,140,0.14,59
42146,34562,7584,23438,67,58000,590,1000,0.59,567,0.567,157,0.157,59
42762,35008,7754,23992,68,59000,616,1000,0.616,554,0.554,170,0.17,59
43356,35430,7926,24570,69,60000,594,1000,0.594,578,0.578,172,0.172,59
43927,35823,8104,25177,70,61000,571,1000,0.571,607,0.607,178,0.178,59
44505,36227,8278,25773,71,62000,578,1000,0.578,596,0.596,174,0.174,59
45068,36622,8446,26378,72,63000,563,1000,0.563,605,0.605,168,0.168,59
45658,37041,8617,26959,73,64000,590,1000,0.59,581,0.581,171,0.171,59
46247,37478,8769,27522,74,65000,589,1000,0.589,563,0.563,152,0.152,59
46824,37894,8930,28106,75,66000,577,1000,0.577,584,0.584,161,0.161,59
47396,38294,9102,28706,76,67000,572,1000,0.572,600,0.6,172,0.172,59
47966,38697,9269,29303,77,68000,570,1000,0.57,597,0.597,167,0.167,59
48511,39056,9455,29944,78,69000,545,1000,0.545,641,0.641,186,0.186,59
49090,39481,9609,30519,79,70000,579,1000,0.579,575,0.575,154,0.154,59
49655,39890,9765,31110,80,71000,565,1000,0.565,591,0.591,156,0.156,59
50218,40278,9940,31722,81,72000,563,1000,0.563,612,0.612,175,0.175,59
50785,40671,10114,32329,82,73000,567,1000,0.567,607,0.607,174,0.174,59
51342,41069,10273,32931,83,74000,557,1000,0.557,602,0.602,159,0.159,59
51906,41471,10435,33529,84,75000,564,1000,0.564,598,0.598,162,0.162,59
52426,41814,10612,34186,85,76000,520,1000,0.52,657,0.657,177,0.177,59
52965,42173,10792,34827,86,77000,539,1000,0.539,641,0.641,180,0.18,59
53524,42565,10959,35435,87,78000,559,1000,0.559,608,0.608,167,0.167,59
54063,42921,11142,36079,88,79000,539,1000,0.539,644,0.644,183,0.183,59
54598,43295,11303,36705,89,80000,535,1000,0.535,626,0.626,161,0.161,59
55100,43613,11487,37387,90,81000,502,1000,0.502,682,0.682,184,0.184,59
55636,43988,11648,38012,91,82000,536,1000,0.536,625,0.625,161,0.161,59
56147,44307,11840,38693,92,83000,511,1000,0.511,681,0.681,192,0.192,59
56675,44647,12028,39353,93,84000,528,1000,0.528,660,0.66,188,0.188,59
57207,45015,12192,39985,94,85000,532,1000,0.532,632,0.632,164,0.164,59
57714,45336,12378,40664,95,86000,507,1000,0.507,679,0.679,186,0.186,59
58244,45691,12553,41309,96,87000,530,1000,0.53,645,0.645,175,0.175,59
58767,46049,12718,41951,97,88000,523,1000,0.523,642,0.642,165,0.165,59
59314,46433,12881,42567,98,89000,547,1000,0.547,616,0.616,163,0.163,59
59820,46782,13038,43218,99,90000,506,1000,0.506,651,0.651,157,0.157,59
60326,47119,13207,43881,100,91000,506,1000,0.506,663,0.663,169,0.169,59
60835,47460,13375,44540,101,92000,509,1000,0.509,659,0.659,168,0.168,59
61340,47804,13536,45196,102,93000,505,1000,0.505,656,0.656,161,0.161,59
61842,48143,13699,45857,103,94000,502,1000,0.502,661,0.661,163,0.163,59
62370,48505,13865,46495,104,95000,528,1000,0.528,638,0.638,166,0.166,59
62869,48813,14056,47187,105,96000,499,1000,0.499,692,0.692,191,0.191,59
63390,49184,14206,47816,106,97000,521,1000,0.521,629,0.629,150,0.15,59
63908,49532,14376,48468,107,98000,518,1000,0.518,652,0.652,170,0.17,59
64406,49859,14547,49141,108,99000,498,1000,0.498,673,0.673,171,0.171,59
64904,50190,14714,49810,109,100000,498,1000,0.498,669,0.669,167,0.167,59
65419,50531,14888,50469,110,101000,515,1000,0.515,659,0.659,174,0.174,59
65932,50900,15032,51100,111,102000,513,1000,0.513,631,0.631,144,0.144,59
66424,51229,15195,51771,112,103000,492,1000,0.492,671,0.671,163,0.163,59
66921,51544,15377,52456,113,104000,497,1000,0.497,685,0.685,182,0.182,59
67429,51878,15551,53122,114,105000,508,1000,0.508,666,0.666,174,0.174,59
67900,52171,15729,53829,115,106000,471,1000,0.471,707,0.707,178,0.178,59
68392,52483,15909,54517,116,107000,492,1000,0.492,688,0.688,180,0.18,59
68872,52766,16106,55234,117,108000,480,1000,0.48,717,0.717,197,0.197,59
69347,53053,16294,55947,118,109000,475,1000,0.475,713,0.713,188,0.188,59
69830,53362,16468,56638,119,110000,483,1000,0.483,691,0.691,174,0.174,59
70308,53655,16653,57345,120,111000,478,1000,0.478,707,0.707,185,0.185,59
70772,53933,16839,58067,121,112000,464,1000,0.464,722,0.722,186,0.186,59
71268,54285,16983,58715,122,113000,496,1000,0.496,648,0.648,144,0.144,59
71739,54569,17170,59431,123,114000,471,1000,0.471,716,0.716,187,0.187,59
71869,54638,17231,59660,124,114298,130,298,0.436241610738255,229,0.7684563758389261,61,0.20469798657718122,59
100,100,0,0,1,100,NA,NA,NA,NA,NA,NA,NA,60
200,200,0,0,2,200,100,100,1,0,0,0,0,60
298,296,2,4,3,300,98,100,0.98,4,0.04,2,0.02,60
397,394,3,6,4,400,99,100,0.99,2,0.02,1,0.01,60
495,490,5,10,5,500,98,100,0.98,4,0.04,2,0.02,60
594,588,6,12,6,600,99,100,0.99,2,0.02,1,0.01,60
692,684,8,16,7,700,98,100,0.98,4,0.04,2,0.02,60
789,779,10,21,8,800,97,100,0.97,5,0.05,2,0.02,60
886,873,13,27,9,900,97,100,0.97,6,0.06,3,0.03,60
985,971,14,29,10,1000,99,100,0.99,2,0.02,1,0.01,60
1933,1878,55,122,11,2000,948,1000,0.948,93,0.093,41,0.041,60
2877,2783,94,217,12,3000,944,1000,0.944,95,0.095,39,0.039,60
3794,3640,154,360,13,4000,917,1000,0.917,143,0.143,60,0.06,60
4703,4488,215,512,14,5000,909,1000,0.909,152,0.152,61,0.061,60
5596,5317,279,683,15,6000,893,1000,0.893,171,0.171,64,0.064,60
6464,6094,370,906,16,7000,868,1000,0.868,223,0.223,91,0.091,60
7329,6879,450,1121,17,8000,865,1000,0.865,215,0.215,80,0.08,60
8188,7649,539,1351,18,9000,859,1000,0.859,230,0.23,89,0.089,60
9034,8402,632,1598,19,10000,846,1000,0.846,247,0.247,93,0.093,60
9870,9137,733,1863,20,11000,836,1000,0.836,265,0.265,101,0.101,60
10700,9862,838,2138,21,12000,830,1000,0.83,275,0.275,105,0.105,60
11493,10533,960,2467,22,13000,793,1000,0.793,329,0.329,122,0.122,60
12300,11217,1083,2783,23,14000,807,1000,0.807,316,0.316,123,0.123,60
13103,11908,1195,3092,24,15000,803,1000,0.803,309,0.309,112,0.112,60
13892,12586,1306,3414,25,16000,789,1000,0.789,322,0.322,111,0.111,60
14668,13226,1442,3774,26,17000,776,1000,0.776,360,0.36,136,0.136,60
15434,13861,1573,4139,27,18000,766,1000,0.766,365,0.365,131,0.131,60
16191,14477,1714,4523,28,19000,757,1000,0.757,384,0.384,141,0.141,60
16944,15096,1848,4904,29,20000,753,1000,0.753,381,0.381,134,0.134,60
17692,15703,1989,5297,30,21000,748,1000,0.748,393,0.393,141,0.141,60
18431,16298,2133,5702,31,22000,739,1000,0.739,405,0.405,144,0.144,60
19187,16934,2253,6066,32,23000,756,1000,0.756,364,0.364,120,0.12,60
19917,17510,2407,6490,33,24000,730,1000,0.73,424,0.424,154,0.154,60
20643,18105,2538,6895,34,25000,726,1000,0.726,405,0.405,131,0.131,60
21376,18693,2683,7307,35,26000,733,1000,0.733,412,0.412,145,0.145,60
22095,19266,2829,7734,36,27000,719,1000,0.719,427,0.427,146,0.146,60
22803,19827,2976,8173,37,28000,708,1000,0.708,439,0.439,147,0.147,60
23490,20357,3133,8643,38,29000,687,1000,0.687,470,0.47,157,0.157,60
24214,20942,3272,9058,39,30000,724,1000,0.724,415,0.415,139,0.139,60
24885,21458,3427,9542,40,31000,671,1000,0.671,484,0.484,155,0.155,60
25573,22001,3572,9999,41,32000,688,1000,0.688,457,0.457,145,0.145,60
26232,22490,3742,10510,42,33000,659,1000,0.659,511,0.511,170,0.17,60
26886,22976,3910,11024,43,34000,654,1000,0.654,514,0.514,168,0.168,60
27554,23501,4053,11499,44,35000,668,1000,0.668,475,0.475,143,0.143,60
28238,24032,4206,11968,45,36000,684,1000,0.684,469,0.469,153,0.153,60
28904,24542,4362,12458,46,37000,666,1000,0.666,490,0.49,156,0.156,60
29563,25032,4531,12968,47,38000,659,1000,0.659,510,0.51,169,0.169,60
30215,25517,4698,13483,48,39000,652,1000,0.652,515,0.515,167,0.167,60
30896,26061,4835,13939,49,40000,681,1000,0.681,456,0.456,137,0.137,60
31563,26580,4983,14420,50,41000,667,1000,0.667,481,0.481,148,0.148,60
32199,27071,5128,14929,51,42000,636,1000,0.636,509,0.509,145,0.145,60
32822,27531,5291,15469,52,43000,623,1000,0.623,540,0.54,163,0.163,60
33464,28010,5454,15990,53,44000,642,1000,0.642,521,0.521,163,0.163,60
34108,28503,5605,16497,54,45000,644,1000,0.644,507,0.507,151,0.151,60
34708,28925,5783,17075,55,46000,600,1000,0.6,578,0.578,178,0.178,60
35329,29391,5938,17609,56,47000,621,1000,0.621,534,0.534,155,0.155,60
35951,29842,6109,18158,57,48000,622,1000,0.622,549,0.549,171,0.171,60
36588,30314,6274,18686,58,49000,637,1000,0.637,528,0.528,165,0.165,60
37197,30747,6450,19253,59,50000,609,1000,0.609,567,0.567,176,0.176,60
37805,31191,6614,19809,60,51000,608,1000,0.608,556,0.556,164,0.164,60
38436,31679,6757,20321,61,52000,631,1000,0.631,512,0.512,143,0.143,60
39015,32083,6932,20917,62,53000,579,1000,0.579,596,0.596,175,0.175,60
39617,32517,7100,21483,63,54000,602,1000,0.602,566,0.566,168,0.168,60
40228,32973,7255,22027,64,55000,611,1000,0.611,544,0.544,155,0.155,60
40840,33418,7422,22582,65,56000,612,1000,0.612,555,0.555,167,0.167,60
41431,33845,7586,23155,66,57000,591,1000,0.591,573,0.573,164,0.164,60
42023,34287,7736,23713,67,58000,592,1000,0.592,558,0.558,150,0.15,60
42621,34734,7887,24266,68,59000,598,1000,0.598,553,0.553,151,0.151,60
43198,35133,8065,24867,69,60000,577,1000,0.577,601,0.601,178,0.178,60
43769,35543,8226,25457,70,61000,571,1000,0.571,590,0.59,161,0.161,60
44382,36019,8363,25981,71,62000,613,1000,0.613,524,0.524,137,0.137,60
44970,36454,8516,26546,72,63000,588,1000,0.588,565,0.565,153,0.153,60
45547,36868,8679,27132,73,64000,577,1000,0.577,586,0.586,163,0.163,60
46104,37266,8838,27734,74,65000,557,1000,0.557,602,0.602,159,0.159,60
46687,37695,8992,28305,75,66000,583,1000,0.583,571,0.571,154,0.154,60
47258,38090,9168,28910,76,67000,571,1000,0.571,605,0.605,176,0.176,60
47833,38497,9336,29503,77,68000,575,1000,0.575,593,0.593,168,0.168,60
48400,38884,9516,30116,78,69000,567,1000,0.567,613,0.613,180,0.18,60
48971,39284,9687,30716,79,70000,571,1000,0.571,600,0.6,171,0.171,60
49525,39669,9856,31331,80,71000,554,1000,0.554,615,0.615,169,0.169,60
50066,40038,10028,31962,81,72000,541,1000,0.541,631,0.631,172,0.172,60
50609,40385,10224,32615,82,73000,543,1000,0.543,653,0.653,196,0.196,60
51190,40810,10380,33190,83,74000,581,1000,0.581,575,0.575,156,0.156,60
51723,41164,10559,33836,84,75000,533,1000,0.533,646,0.646,179,0.179,60
52271,41546,10725,34454,85,76000,548,1000,0.548,618,0.618,166,0.166,60
52809,41924,10885,35076,86,77000,538,1000,0.538,622,0.622,160,0.16,60
53370,42322,11048,35678,87,78000,561,1000,0.561,602,0.602,163,0.163,60
53909,42704,11205,36296,88,79000,539,1000,0.539,618,0.618,157,0.157,60
54447,43057,11390,36943,89,80000,538,1000,0.538,647,0.647,185,0.185,60
54994,43419,11575,37581,90,81000,547,1000,0.547,638,0.638,185,0.185,60
55521,43751,11770,38249,91,82000,527,1000,0.527,668,0.668,195,0.195,60
56077,44137,11940,38863,92,83000,556,1000,0.556,614,0.614,170,0.17,60
56602,44503,12099,39497,93,84000,525,1000,0.525,634,0.634,159,0.159,60
57132,44881,12251,40119,94,85000,530,1000,0.53,622,0.622,152,0.152,60
57645,45219,12426,40781,95,86000,513,1000,0.513,662,0.662,175,0.175,60
58175,45591,12584,41409,96,87000,530,1000,0.53,628,0.628,158,0.158,60
58680,45915,12765,42085,97,88000,505,1000,0.505,676,0.676,181,0.181,60
59218,46283,12935,42717,98,89000,538,1000,0.538,632,0.632,170,0.17,60
59759,46664,13095,43336,99,90000,541,1000,0.541,619,0.619,160,0.16,60
60277,47018,13259,43982,100,91000,518,1000,0.518,646,0.646,164,0.164,60
60776,47352,13424,44648,101,92000,499,1000,0.499,666,0.666,165,0.165,60
61314,47729,13585,45271,102,93000,538,1000,0.538,623,0.623,161,0.161,60
61840,48090,13750,45910,103,94000,526,1000,0.526,639,0.639,165,0.165,60
62340,48423,13917,46577,104,95000,500,1000,0.5,667,0.667,167,0.167,60
62868,48791,14077,47209,105,96000,528,1000,0.528,632,0.632,160,0.16,60
63374,49138,14236,47862,106,97000,506,1000,0.506,653,0.653,159,0.159,60
63895,49491,14404,48509,107,98000,521,1000,0.521,647,0.647,168,0.168,60
64380,49795,14585,49205,108,99000,485,1000,0.485,696,0.696,181,0.181,60
64907,50152,14755,49848,109,100000,527,1000,0.527,643,0.643,170,0.17,60
65384,50442,14942,50558,110,101000,477,1000,0.477,710,0.71,187,0.187,60
65892,50785,15107,51215,111,102000,508,1000,0.508,657,0.657,165,0.165,60
66385,51117,15268,51883,112,103000,493,1000,0.493,668,0.668,161,0.161,60
66876,51422,15454,52578,113,104000,491,1000,0.491,695,0.695,186,0.186,60
67364,51724,15640,53276,114,105000,488,1000,0.488,698,0.698,186,0.186,60
67840,52026,15814,53974,115,106000,476,1000,0.476,698,0.698,174,0.174,60
68342,52365,15977,54635,116,107000,502,1000,0.502,661,0.661,163,0.163,60
68801,52650,16151,55350,117,108000,459,1000,0.459,715,0.715,174,0.174,60
69295,52966,16329,56034,118,109000,494,1000,0.494,684,0.684,178,0.178,60
69789,53302,16487,56698,119,110000,494,1000,0.494,664,0.664,158,0.158,60
70252,53592,16660,57408,120,111000,463,1000,0.463,710,0.71,173,0.173,60
70719,53885,16834,58115,121,112000,467,1000,0.467,707,0.707,174,0.174,60
71213,54199,17014,58801,122,113000,494,1000,0.494,686,0.686,180,0.18,60
71716,54538,17178,59462,123,114000,503,1000,0.503,661,0.661,164,0.164,60
71869,54638,17231,59660,124,114298,153,298,0.5134228187919463,198,0.6644295302013423,53,0.17785234899328858,60
100,100,0,0,1,100,NA,NA,NA,NA,NA,NA,NA,61
200,200,0,0,2,200,100,100,1,0,0,0,0,61
298,296,2,4,3,300,98,100,0.98,4,0.04,2,0.02,61
395,392,3,8,4,400,97,100,0.97,4,0.04,1,0.01,61
494,490,4,10,5,500,99,100,0.99,2,0.02,1,0.01,61
592,587,5,13,6,600,98,100,0.98,3,0.03,1,0.01,61
690,684,6,16,7,700,98,100,0.98,3,0.03,1,0.01,61
787,778,9,22,8,800,97,100,0.97,6,0.06,3,0.03,61
883,870,13,30,9,900,96,100,0.96,8,0.08,4,0.04,61
981,966,15,34,10,1000,98,100,0.98,4,0.04,2,0.02,61
1939,1889,50,111,11,2000,958,1000,0.958,77,0.077,35,0.035,61
2863,2756,107,244,12,3000,924,1000,0.924,133,0.133,57,0.057,61
3775,3600,175,400,13,4000,912,1000,0.912,156,0.156,68,0.068,61
4675,4435,240,565,14,5000,900,1000,0.9,165,0.165,65,0.065,61
5556,5239,317,761,15,6000,881,1000,0.881,196,0.196,77,0.077,61
6434,6037,397,963,16,7000,878,1000,0.878,202,0.202,80,0.08,61
7306,6834,472,1166,17,8000,872,1000,0.872,203,0.203,75,0.075,61
8153,7582,571,1418,18,9000,847,1000,0.847,252,0.252,99,0.099,61
9000,8341,659,1659,19,10000,847,1000,0.847,241,0.241,88,0.088,61
9840,9090,750,1910,20,11000,840,1000,0.84,251,0.251,91,0.091,61
10648,9791,857,2209,21,12000,808,1000,0.808,299,0.299,107,0.107,61
11457,10480,977,2520,22,13000,809,1000,0.809,311,0.311,120,0.12,61
12240,11129,1111,2871,23,14000,783,1000,0.783,351,0.351,134,0.134,61
13023,11777,1246,3223,24,15000,783,1000,0.783,352,0.352,135,0.135,61
13802,12444,1358,3556,25,16000,779,1000,0.779,333,0.333,112,0.112,61
14563,13086,1477,3914,26,17000,761,1000,0.761,358,0.358,119,0.119,61
15329,13725,1604,4275,27,18000,766,1000,0.766,361,0.361,127,0.127,61
16091,14366,1725,4634,28,19000,762,1000,0.762,359,0.359,121,0.121,61
16831,14972,1859,5028,29,20000,740,1000,0.74,394,0.394,134,0.134,61
17569,15572,1997,5428,30,21000,738,1000,0.738,400,0.4,138,0.138,61
18319,16197,2122,5803,31,22000,750,1000,0.75,375,0.375,125,0.125,61
19031,16763,2268,6237,32,23000,712,1000,0.712,434,0.434,146,0.146,61
19762,17351,2411,6649,33,24000,731,1000,0.731,412,0.412,143,0.143,61
20513,17983,2530,7017,34,25000,751,1000,0.751,368,0.368,119,0.119,61
21205,18516,2689,7484,35,26000,692,1000,0.692,467,0.467,159,0.159,61
21921,19101,2820,7899,36,27000,716,1000,0.716,415,0.415,131,0.131,61
22636,19683,2953,8317,37,28000,715,1000,0.715,418,0.418,133,0.133,61
23335,20236,3099,8764,38,29000,699,1000,0.699,447,0.447,146,0.146,61
24042,20805,3237,9195,39,30000,707,1000,0.707,431,0.431,138,0.138,61
24725,21336,3389,9664,40,31000,683,1000,0.683,469,0.469,152,0.152,61
25428,21889,3539,10111,41,32000,703,1000,0.703,447,0.447,150,0.15,61
26113,22434,3679,10566,42,33000,685,1000,0.685,455,0.455,140,0.14,61
26768,22925,3843,11075,43,34000,655,1000,0.655,509,0.509,164,0.164,61
27442,23438,4004,11562,44,35000,674,1000,0.674,487,0.487,161,0.161,61
28117,23946,4171,12054,45,36000,675,1000,0.675,492,0.492,167,0.167,61
28768,24429,4339,12571,46,37000,651,1000,0.651,517,0.517,168,0.168,61
29434,24939,4495,13061,47,38000,666,1000,0.666,490,0.49,156,0.156,61
30081,25423,4658,13577,48,39000,647,1000,0.647,516,0.516,163,0.163,61
30735,25920,4815,14080,49,40000,654,1000,0.654,503,0.503,157,0.157,61
31362,26374,4988,14626,50,41000,627,1000,0.627,546,0.546,173,0.173,61
32013,26871,5142,15129,51,42000,651,1000,0.651,503,0.503,154,0.154,61
32690,27419,5271,15581,52,43000,677,1000,0.677,452,0.452,129,0.129,61
33303,27856,5447,16144,53,44000,613,1000,0.613,563,0.563,176,0.176,61
33945,28362,5583,16638,54,45000,642,1000,0.642,494,0.494,136,0.136,61
34579,28828,5751,17172,55,46000,634,1000,0.634,534,0.534,168,0.168,61
35200,29293,5907,17707,56,47000,621,1000,0.621,535,0.535,156,0.156,61
35819,29753,6066,18247,57,48000,619,1000,0.619,540,0.54,159,0.159,61
36435,30217,6218,18783,58,49000,616,1000,0.616,536,0.536,152,0.152,61
37050,30676,6374,19324,59,50000,615,1000,0.615,541,0.541,156,0.156,61
37668,31135,6533,19865,60,51000,618,1000,0.618,541,0.541,159,0.159,61
38295,31605,6690,20395,61,52000,627,1000,0.627,530,0.53,157,0.157,61
38905,32032,6873,20968,62,53000,610,1000,0.61,573,0.573,183,0.183,61
39522,32472,7050,21528,63,54000,617,1000,0.617,560,0.56,177,0.177,61
40133,32925,7208,22075,64,55000,611,1000,0.611,547,0.547,158,0.158,61
40728,33350,7378,22650,65,56000,595,1000,0.595,575,0.575,170,0.17,61
41351,33817,7534,23183,66,57000,623,1000,0.623,533,0.533,156,0.156,61
41949,34244,7705,23756,67,58000,598,1000,0.598,573,0.573,171,0.171,61
42553,34700,7853,24300,68,59000,604,1000,0.604,544,0.544,148,0.148,61
43155,35149,8006,24851,69,60000,602,1000,0.602,551,0.551,153,0.153,61
43745,35566,8179,25434,70,61000,590,1000,0.59,583,0.583,173,0.173,61
44344,36003,8341,25997,71,62000,599,1000,0.599,563,0.563,162,0.162,61
44947,36449,8498,26551,72,63000,603,1000,0.603,554,0.554,157,0.157,61
45513,36829,8684,27171,73,64000,566,1000,0.566,620,0.62,186,0.186,61
46077,37235,8842,27765,74,65000,564,1000,0.564,594,0.594,158,0.158,61
46642,37633,9009,28367,75,66000,565,1000,0.565,602,0.602,167,0.167,61
47203,38016,9187,28984,76,67000,561,1000,0.561,617,0.617,178,0.178,61
47782,38427,9355,29573,77,68000,579,1000,0.579,589,0.589,168,0.168,61
48344,38829,9515,30171,78,69000,562,1000,0.562,598,0.598,160,0.16,61
48923,39255,9668,30745,79,70000,579,1000,0.579,574,0.574,153,0.153,61
49488,39655,9833,31345,80,71000,565,1000,0.565,600,0.6,165,0.165,61
50040,40028,10012,31972,81,72000,552,1000,0.552,627,0.627,179,0.179,61
50620,40428,10192,32572,82,73000,580,1000,0.58,600,0.6,180,0.18,61
51177,40829,10348,33171,83,74000,557,1000,0.557,599,0.599,156,0.156,61
51729,41224,10505,33776,84,75000,552,1000,0.552,605,0.605,157,0.157,61
52258,41568,10690,34432,85,76000,529,1000,0.529,656,0.656,185,0.185,61
52766,41903,10863,35097,86,77000,508,1000,0.508,665,0.665,173,0.173,61
53306,42261,11045,35739,87,78000,540,1000,0.54,642,0.642,182,0.182,61
53881,42668,11213,36332,88,79000,575,1000,0.575,593,0.593,168,0.168,61
54451,43073,11378,36927,89,80000,570,1000,0.57,595,0.595,165,0.165,61
54997,43453,11544,37547,90,81000,546,1000,0.546,620,0.62,166,0.166,61
55502,43795,11707,38205,91,82000,505,1000,0.505,658,0.658,163,0.163,61
56058,44173,11885,38827,92,83000,556,1000,0.556,622,0.622,178,0.178,61
56607,44541,12066,39459,93,84000,549,1000,0.549,632,0.632,181,0.181,61
57130,44894,12236,40106,94,85000,523,1000,0.523,647,0.647,170,0.17,61
57668,45279,12389,40721,95,86000,538,1000,0.538,615,0.615,153,0.153,61
58187,45634,12553,41366,96,87000,519,1000,0.519,645,0.645,164,0.164,61
58709,45981,12728,42019,97,88000,522,1000,0.522,653,0.653,175,0.175,61
59225,46331,12894,42669,98,89000,516,1000,0.516,650,0.65,166,0.166,61
59735,46684,13051,43316,99,90000,510,1000,0.51,647,0.647,157,0.157,61
60244,47022,13222,43978,100,91000,509,1000,0.509,662,0.662,171,0.171,61
60781,47401,13380,44599,101,92000,537,1000,0.537,621,0.621,158,0.158,61
61271,47705,13566,45295,102,93000,490,1000,0.49,696,0.696,186,0.186,61
61791,48070,13721,45930,103,94000,520,1000,0.52,635,0.635,155,0.155,61
62326,48430,13896,46570,104,95000,535,1000,0.535,640,0.64,175,0.175,61
62834,48759,14075,47241,105,96000,508,1000,0.508,671,0.671,179,0.179,61
63358,49117,14241,47883,106,97000,524,1000,0.524,642,0.642,166,0.166,61
63838,49426,14412,48574,107,98000,480,1000,0.48,691,0.691,171,0.171,61
64362,49774,14588,49226,108,99000,524,1000,0.524,652,0.652,176,0.176,61
64875,50118,14757,49882,109,100000,513,1000,0.513,656,0.656,169,0.169,61
65352,50417,14935,50583,110,101000,477,1000,0.477,701,0.701,178,0.178,61
65861,50754,15107,51246,111,102000,509,1000,0.509,663,0.663,172,0.172,61
66345,51087,15258,51913,112,103000,484,1000,0.484,667,0.667,151,0.151,61
66834,51392,15442,52608,113,104000,489,1000,0.489,695,0.695,184,0.184,61
67319,51708,15611,53292,114,105000,485,1000,0.485,684,0.684,169,0.169,61
67808,52010,15798,53990,115,106000,489,1000,0.489,698,0.698,187,0.187,61
68298,52307,15991,54693,116,107000,490,1000,0.49,703,0.703,193,0.193,61
68794,52632,16162,55368,117,108000,496,1000,0.496,675,0.675,171,0.171,61
69307,53009,16298,55991,118,109000,513,1000,0.513,623,0.623,136,0.136,61
69801,53319,16482,56681,119,110000,494,1000,0.494,690,0.69,184,0.184,61
70287,53631,16656,57369,120,111000,486,1000,0.486,688,0.688,174,0.174,61
70779,53952,16827,58048,121,112000,492,1000,0.492,679,0.679,171,0.171,61
71264,54277,16987,58723,122,113000,485,1000,0.485,675,0.675,160,0.16,61
71732,54555,17177,59445,123,114000,468,1000,0.468,722,0.722,190,0.19,61
71869,54638,17231,59660,124,114298,137,298,0.4597315436241611,215,0.7214765100671141,54,0.18120805369127516,61
99,98,1,2,1,100,NA,NA,NA,NA,NA,NA,NA,62
199,198,1,2,2,200,100,100,1,0,0,0,0,62
298,296,2,4,3,300,99,100,0.99,2,0.02,1,0.01,62
397,394,3,6,4,400,99,100,0.99,2,0.02,1,0.01,62
495,490,5,10,5,500,98,100,0.98,4,0.04,2,0.02,62
593,587,6,13,6,600,98,100,0.98,3,0.03,1,0.01,62
691,683,8,17,7,700,98,100,0.98,4,0.04,2,0.02,62
790,781,9,19,8,800,99,100,0.99,2,0.02,1,0.01,62
886,874,12,26,9,900,96,100,0.96,7,0.07,3,0.03,62
983,968,15,32,10,1000,97,100,0.97,6,0.06,3,0.03,62
1954,1913,41,87,11,2000,971,1000,0.971,55,0.055,26,0.026,62
2880,2783,97,217,12,3000,926,1000,0.926,130,0.13,56,0.056,62
3794,3632,162,368,13,4000,914,1000,0.914,151,0.151,65,0.065,62
4688,4463,225,537,14,5000,894,1000,0.894,169,0.169,63,0.063,62
5598,5311,287,689,15,6000,910,1000,0.91,152,0.152,62,0.062,62
6485,6123,362,877,16,7000,887,1000,0.887,188,0.188,75,0.075,62
7351,6910,441,1090,17,8000,866,1000,0.866,213,0.213,79,0.079,62
8207,7671,536,1329,18,9000,856,1000,0.856,239,0.239,95,0.095,62
9040,8408,632,1592,19,10000,833,1000,0.833,263,0.263,96,0.096,62
9859,9124,735,1876,20,11000,819,1000,0.819,284,0.284,103,0.103,62
10681,9843,838,2157,21,12000,822,1000,0.822,281,0.281,103,0.103,62
11462,10489,973,2511,22,13000,781,1000,0.781,354,0.354,135,0.135,62
12243,11147,1096,2853,23,14000,781,1000,0.781,342,0.342,123,0.123,62
13060,11865,1195,3135,24,15000,817,1000,0.817,282,0.282,99,0.099,62
13853,12543,1310,3457,25,16000,793,1000,0.793,322,0.322,115,0.115,62
14623,13196,1427,3804,26,17000,770,1000,0.77,347,0.347,117,0.117,62
15373,13818,1555,4182,27,18000,750,1000,0.75,378,0.378,128,0.128,62
16135,14441,1694,4559,28,19000,762,1000,0.762,377,0.377,139,0.139,62
16897,15082,1815,4918,29,20000,762,1000,0.762,359,0.359,121,0.121,62
17617,15649,1968,5351,30,21000,720,1000,0.72,433,0.433,153,0.153,62
18365,16266,2099,5734,31,22000,748,1000,0.748,383,0.383,131,0.131,62
19118,16900,2218,6100,32,23000,753,1000,0.753,366,0.366,119,0.119,62
19824,17449,2375,6551,33,24000,706,1000,0.706,451,0.451,157,0.157,62
20547,18024,2523,6976,34,25000,723,1000,0.723,425,0.425,148,0.148,62
21267,18598,2669,7402,35,26000,720,1000,0.72,426,0.426,146,0.146,62
21974,19160,2814,7840,36,27000,707,1000,0.707,438,0.438,145,0.145,62
22679,19741,2938,8259,37,28000,705,1000,0.705,419,0.419,124,0.124,62
23359,20258,3101,8742,38,29000,680,1000,0.68,483,0.483,163,0.163,62
24045,20801,3244,9199,39,30000,686,1000,0.686,457,0.457,143,0.143,62
24746,21358,3388,9642,40,31000,701,1000,0.701,443,0.443,144,0.144,62
25433,21900,3533,10100,41,32000,687,1000,0.687,458,0.458,145,0.145,62
26109,22435,3674,10565,42,33000,676,1000,0.676,465,0.465,141,0.141,62
26772,22935,3837,11065,43,34000,663,1000,0.663,500,0.5,163,0.163,62
27474,23494,3980,11506,44,35000,702,1000,0.702,441,0.441,143,0.143,62
28141,23999,4142,12001,45,36000,667,1000,0.667,495,0.495,162,0.162,62
28784,24481,4303,12519,46,37000,643,1000,0.643,518,0.518,161,0.161,62
29459,25008,4451,12992,47,38000,675,1000,0.675,473,0.473,148,0.148,62
30112,25512,4600,13488,48,39000,653,1000,0.653,496,0.496,149,0.149,62
30757,26017,4740,13983,49,40000,645,1000,0.645,495,0.495,140,0.14,62
31430,26547,4883,14453,50,41000,673,1000,0.673,470,0.47,143,0.143,62
32048,27006,5042,14994,51,42000,618,1000,0.618,541,0.541,159,0.159,62
32661,27433,5228,15567,52,43000,613,1000,0.613,573,0.573,186,0.186,62
33260,27859,5401,16141,53,44000,599,1000,0.599,574,0.574,173,0.173,62
33936,28389,5547,16611,54,45000,676,1000,0.676,470,0.47,146,0.146,62
34584,28882,5702,17118,55,46000,648,1000,0.648,507,0.507,155,0.155,62
35176,29314,5862,17686,56,47000,592,1000,0.592,568,0.568,160,0.16,62
35798,29778,6020,18222,57,48000,622,1000,0.622,536,0.536,158,0.158,62
36418,30226,6192,18774,58,49000,620,1000,0.62,552,0.552,172,0.172,62
37045,30699,6346,19301,59,50000,627,1000,0.627,527,0.527,154,0.154,62
37635,31114,6521,19886,60,51000,590,1000,0.59,585,0.585,175,0.175,62
38232,31527,6705,20473,61,52000,597,1000,0.597,587,0.587,184,0.184,62
38831,31961,6870,21039,62,53000,599,1000,0.599,566,0.566,165,0.165,62
39445,32432,7013,21568,63,54000,614,1000,0.614,529,0.529,143,0.143,62
40056,32873,7183,22127,64,55000,611,1000,0.611,559,0.559,170,0.17,62
40665,33319,7346,22681,65,56000,609,1000,0.609,554,0.554,163,0.163,62
41263,33740,7523,23260,66,57000,598,1000,0.598,579,0.579,177,0.177,62
41863,34170,7693,23830,67,58000,600,1000,0.6,570,0.57,170,0.17,62
42466,34605,7861,24395,68,59000,603,1000,0.603,565,0.565,168,0.168,62
43079,35068,8011,24932,69,60000,613,1000,0.613,537,0.537,150,0.15,62
43692,35536,8156,25464,70,61000,613,1000,0.613,532,0.532,145,0.145,62
44283,35953,8330,26047,71,62000,591,1000,0.591,583,0.583,174,0.174,62
44864,36367,8497,26633,72,63000,581,1000,0.581,586,0.586,167,0.167,62
45438,36771,8667,27229,73,64000,574,1000,0.574,596,0.596,170,0.17,62
46011,37175,8836,27825,74,65000,573,1000,0.573,596,0.596,169,0.169,62
46595,37606,8989,28394,75,66000,584,1000,0.584,569,0.569,153,0.153,62
47163,38004,9159,28996,76,67000,568,1000,0.568,602,0.602,170,0.17,62
47709,38379,9330,29621,77,68000,546,1000,0.546,625,0.625,171,0.171,62
48278,38788,9490,30212,78,69000,569,1000,0.569,591,0.591,160,0.16,62
48836,39178,9658,30822,79,70000,558,1000,0.558,610,0.61,168,0.168,62
49419,39591,9828,31409,80,71000,583,1000,0.583,587,0.587,170,0.17,62
49984,39995,9989,32005,81,72000,565,1000,0.565,596,0.596,161,0.161,62
50543,40370,10173,32630,82,73000,559,1000,0.559,625,0.625,184,0.184,62
51105,40767,10338,33233,83,74000,562,1000,0.562,603,0.603,165,0.165,62
51667,41173,10494,33827,84,75000,562,1000,0.562,594,0.594,156,0.156,62
52224,41560,10664,34440,85,76000,557,1000,0.557,613,0.613,170,0.17,62
52784,41962,10822,35038,86,77000,560,1000,0.56,598,0.598,158,0.158,62
53317,42287,11030,35713,87,78000,533,1000,0.533,675,0.675,208,0.208,62
53867,42666,11201,36334,88,79000,550,1000,0.55,621,0.621,171,0.171,62
54424,43073,11351,36927,89,80000,557,1000,0.557,593,0.593,150,0.15,62
54941,43400,11541,37600,90,81000,517,1000,0.517,673,0.673,190,0.19,62
55449,43732,11717,38268,91,82000,508,1000,0.508,668,0.668,176,0.176,62
55980,44082,11898,38918,92,83000,531,1000,0.531,650,0.65,181,0.181,62
56537,44468,12069,39532,93,84000,557,1000,0.557,614,0.614,171,0.171,62
57069,44840,12229,40160,94,85000,532,1000,0.532,628,0.628,160,0.16,62
57583,45187,12396,40813,95,86000,514,1000,0.514,653,0.653,167,0.167,62
58107,45539,12568,41461,96,87000,524,1000,0.524,648,0.648,172,0.172,62
58625,45900,12725,42100,97,88000,518,1000,0.518,639,0.639,157,0.157,62
59157,46272,12885,42728,98,89000,532,1000,0.532,628,0.628,160,0.16,62
59696,46634,13062,43366,99,90000,539,1000,0.539,638,0.638,177,0.177,62
60231,47001,13230,43999,100,91000,535,1000,0.535,633,0.633,168,0.168,62
60784,47380,13404,44620,101,92000,553,1000,0.553,621,0.621,174,0.174,62
61290,47723,13567,45277,102,93000,506,1000,0.506,657,0.657,163,0.163,62
61790,48054,13736,45946,103,94000,500,1000,0.5,669,0.669,169,0.169,62
62307,48391,13916,46609,104,95000,517,1000,0.517,663,0.663,180,0.18,62
62828,48734,14094,47266,105,96000,521,1000,0.521,657,0.657,178,0.178,62
63330,49065,14265,47935,106,97000,502,1000,0.502,669,0.669,171,0.171,62
63852,49407,14445,48593,107,98000,522,1000,0.522,658,0.658,180,0.18,62
64336,49700,14636,49300,108,99000,484,1000,0.484,707,0.707,191,0.191,62
64859,50044,14815,49956,109,100000,523,1000,0.523,656,0.656,179,0.179,62
65357,50372,14985,50628,110,101000,498,1000,0.498,672,0.672,170,0.17,62
65851,50693,15158,51307,111,102000,494,1000,0.494,679,0.679,173,0.173,62
66366,51056,15310,51944,112,103000,515,1000,0.515,637,0.637,152,0.152,62
66861,51383,15478,52617,113,104000,495,1000,0.495,673,0.673,168,0.168,62
67322,51674,15648,53326,114,105000,461,1000,0.461,709,0.709,170,0.17,62
67845,52045,15800,53955,115,106000,523,1000,0.523,629,0.629,152,0.152,62
68357,52399,15958,54601,116,107000,512,1000,0.512,646,0.646,158,0.158,62
68853,52715,16138,55285,117,108000,496,1000,0.496,684,0.684,180,0.18,62
69361,53056,16305,55944,118,109000,508,1000,0.508,659,0.659,167,0.167,62
69834,53350,16484,56650,119,110000,473,1000,0.473,706,0.706,179,0.179,62
70299,53638,16661,57362,120,111000,465,1000,0.465,712,0.712,177,0.177,62
70773,53947,16826,58053,121,112000,474,1000,0.474,691,0.691,165,0.165,62
71243,54238,17005,58762,122,113000,470,1000,0.47,709,0.709,179,0.179,62
71717,54535,17182,59465,123,114000,474,1000,0.474,703,0.703,177,0.177,62
71869,54638,17231,59660,124,114298,152,298,0.5100671140939598,195,0.6543624161073825,49,0.1644295302013423,62
100,100,0,0,1,100,NA,NA,NA,NA,NA,NA,NA,63
200,200,0,0,2,200,100,100,1,0,0,0,0,63
300,300,0,0,3,300,100,100,1,0,0,0,0,63
397,394,3,6,4,400,97,100,0.97,6,0.06,3,0.03,63
494,488,6,12,5,500,97,100,0.97,6,0.06,3,0.03,63
591,582,9,18,6,600,97,100,0.97,6,0.06,3,0.03,63
689,679,10,21,7,700,98,100,0.98,3,0.03,1,0.01,63
786,773,13,27,8,800,97,100,0.97,6,0.06,3,0.03,63
882,865,17,35,9,900,96,100,0.96,8,0.08,4,0.04,63
981,963,18,37,10,1000,99,100,0.99,2,0.02,1,0.01,63
1935,1882,53,118,11,2000,954,1000,0.954,81,0.081,35,0.035,63
2860,2752,108,248,12,3000,925,1000,0.925,130,0.13,55,0.055,63
3764,3597,167,403,13,4000,904,1000,0.904,155,0.155,59,0.059,63
4671,4440,231,560,14,5000,907,1000,0.907,157,0.157,64,0.064,63
5537,5215,322,785,15,6000,866,1000,0.866,225,0.225,91,0.091,63
6401,5992,409,1008,16,7000,864,1000,0.864,223,0.223,87,0.087,63
7265,6774,491,1226,17,8000,864,1000,0.864,218,0.218,82,0.082,63
8109,7520,589,1480,18,9000,844,1000,0.844,254,0.254,98,0.098,63
8955,8276,679,1724,19,10000,846,1000,0.846,244,0.244,90,0.09,63
9780,8994,786,2006,20,11000,825,1000,0.825,282,0.282,107,0.107,63
10612,9728,884,2272,21,12000,832,1000,0.832,266,0.266,98,0.098,63
11417,10421,996,2579,22,13000,805,1000,0.805,307,0.307,112,0.112,63
12218,11106,1112,2894,23,14000,801,1000,0.801,315,0.315,116,0.116,63
12999,11768,1231,3232,24,15000,781,1000,0.781,338,0.338,119,0.119,63
13772,12412,1360,3588,25,16000,773,1000,0.773,356,0.356,129,0.129,63
14539,13067,1472,3933,26,17000,767,1000,0.767,345,0.345,112,0.112,63
15333,13757,1576,4243,27,18000,794,1000,0.794,310,0.31,104,0.104,63
16114,14414,1700,4586,28,19000,781,1000,0.781,343,0.343,124,0.124,63
16858,15017,1841,4983,29,20000,744,1000,0.744,397,0.397,141,0.141,63
17585,15586,1999,5414,30,21000,727,1000,0.727,431,0.431,158,0.158,63
18330,16203,2127,5797,31,22000,745,1000,0.745,383,0.383,128,0.128,63
19041,16760,2281,6240,32,23000,711,1000,0.711,443,0.443,154,0.154,63
19760,17335,2425,6665,33,24000,719,1000,0.719,425,0.425,144,0.144,63
20477,17926,2551,7074,34,25000,717,1000,0.717,409,0.409,126,0.126,63
21181,18472,2709,7528,35,26000,704,1000,0.704,454,0.454,158,0.158,63
21898,19047,2851,7953,36,27000,717,1000,0.717,425,0.425,142,0.142,63
22600,19601,2999,8399,37,28000,702,1000,0.702,446,0.446,148,0.148,63
23311,20167,3144,8833,38,29000,711,1000,0.711,434,0.434,145,0.145,63
23985,20684,3301,9316,39,30000,674,1000,0.674,483,0.483,157,0.157,63
24692,21246,3446,9754,40,31000,707,1000,0.707,438,0.438,145,0.145,63
25407,21824,3583,10176,41,32000,715,1000,0.715,422,0.422,137,0.137,63
26098,22362,3736,10638,42,33000,691,1000,0.691,462,0.462,153,0.153,63
26825,22973,3852,11027,43,34000,727,1000,0.727,389,0.389,116,0.116,63
27502,23489,4013,11511,44,35000,677,1000,0.677,484,0.484,161,0.161,63
28164,24000,4164,12000,45,36000,662,1000,0.662,489,0.489,151,0.151,63
28807,24481,4326,12519,46,37000,643,1000,0.643,519,0.519,162,0.162,63
29485,24988,4497,13012,47,38000,678,1000,0.678,493,0.493,171,0.171,63
30143,25473,4670,13527,48,39000,658,1000,0.658,515,0.515,173,0.173,63
30790,25971,4819,14029,49,40000,647,1000,0.647,502,0.502,149,0.149,63
31434,26476,4958,14524,50,41000,644,1000,0.644,495,0.495,139,0.139,63
32085,26989,5096,15011,51,42000,651,1000,0.651,487,0.487,138,0.138,63
32736,27481,5255,15519,52,43000,651,1000,0.651,508,0.508,159,0.159,63
33389,27964,5425,16036,53,44000,653,1000,0.653,517,0.517,170,0.17,63
34027,28447,5580,16553,54,45000,638,1000,0.638,517,0.517,155,0.155,63
34679,28955,5724,17045,55,46000,652,1000,0.652,492,0.492,144,0.144,63
35321,29454,5867,17546,56,47000,642,1000,0.642,501,0.501,143,0.143,63
35933,29886,6047,18114,57,48000,612,1000,0.612,568,0.568,180,0.18,63
36522,30284,6238,18716,58,49000,589,1000,0.589,602,0.602,191,0.191,63
37159,30759,6400,19241,59,50000,637,1000,0.637,525,0.525,162,0.162,63
37775,31209,6566,19791,60,51000,616,1000,0.616,550,0.55,166,0.166,63
38416,31696,6720,20304,61,52000,641,1000,0.641,513,0.513,154,0.154,63
39051,32166,6885,20834,62,53000,635,1000,0.635,530,0.53,165,0.165,63
39696,32665,7031,21335,63,54000,645,1000,0.645,501,0.501,146,0.146,63
40346,33161,7185,21839,64,55000,650,1000,0.65,504,0.504,154,0.154,63
40928,33569,7359,22431,65,56000,582,1000,0.582,592,0.592,174,0.174,63
41504,33985,7519,23015,66,57000,576,1000,0.576,584,0.584,160,0.16,63
42105,34423,7682,23577,67,58000,601,1000,0.601,562,0.562,163,0.163,63
42688,34835,7853,24165,68,59000,583,1000,0.583,588,0.588,171,0.171,63
43263,35253,8010,24747,69,60000,575,1000,0.575,582,0.582,157,0.157,63
43869,35715,8154,25285,70,61000,606,1000,0.606,538,0.538,144,0.144,63
44449,36118,8331,25882,71,62000,580,1000,0.58,597,0.597,177,0.177,63
45020,36523,8497,26477,72,63000,571,1000,0.571,595,0.595,166,0.166,63
45632,36974,8658,27026,73,64000,612,1000,0.612,549,0.549,161,0.161,63
46187,37357,8830,27643,74,65000,555,1000,0.555,617,0.617,172,0.172,63
46754,37748,9006,28252,75,66000,567,1000,0.567,609,0.609,176,0.176,63
47327,38176,9151,28824,76,67000,573,1000,0.573,572,0.572,145,0.145,63
47913,38602,9311,29398,77,68000,586,1000,0.586,574,0.574,160,0.16,63
48474,38961,9513,30039,78,69000,561,1000,0.561,641,0.641,202,0.202,63
49057,39376,9681,30624,79,70000,583,1000,0.583,585,0.585,168,0.168,63
49591,39730,9861,31270,80,71000,534,1000,0.534,646,0.646,180,0.18,63
50130,40097,10033,31903,81,72000,539,1000,0.539,633,0.633,172,0.172,63
50688,40475,10213,32525,82,73000,558,1000,0.558,622,0.622,180,0.18,63
51255,40873,10382,33127,83,74000,567,1000,0.567,602,0.602,169,0.169,63
51802,41244,10558,33756,84,75000,547,1000,0.547,629,0.629,176,0.176,63
52329,41598,10731,34402,85,76000,527,1000,0.527,646,0.646,173,0.173,63
52847,41951,10896,35049,86,77000,518,1000,0.518,647,0.647,165,0.165,63
53395,42327,11068,35673,87,78000,548,1000,0.548,624,0.624,172,0.172,63
53908,42669,11239,36331,88,79000,513,1000,0.513,658,0.658,171,0.171,63
54434,43023,11411,36977,89,80000,526,1000,0.526,646,0.646,172,0.172,63
54966,43361,11605,37639,90,81000,532,1000,0.532,662,0.662,194,0.194,63
55506,43736,11770,38264,91,82000,540,1000,0.54,625,0.625,165,0.165,63
56051,44129,11922,38871,92,83000,545,1000,0.545,607,0.607,152,0.152,63
56582,44483,12099,39517,93,84000,531,1000,0.531,646,0.646,177,0.177,63
57111,44845,12266,40155,94,85000,529,1000,0.529,638,0.638,167,0.167,63
57648,45212,12436,40788,95,86000,537,1000,0.537,633,0.633,170,0.17,63
58159,45548,12611,41452,96,87000,511,1000,0.511,664,0.664,175,0.175,63
58675,45910,12765,42090,97,88000,516,1000,0.516,638,0.638,154,0.154,63
59196,46253,12943,42747,98,89000,521,1000,0.521,657,0.657,178,0.178,63
59732,46620,13112,43380,99,90000,536,1000,0.536,633,0.633,169,0.169,63
60267,46996,13271,44004,100,91000,535,1000,0.535,624,0.624,159,0.159,63
60782,47360,13422,44640,101,92000,515,1000,0.515,636,0.636,151,0.151,63
61287,47696,13591,45304,102,93000,505,1000,0.505,664,0.664,169,0.169,63
61825,48074,13751,45926,103,94000,538,1000,0.538,622,0.622,160,0.16,63
62372,48458,13914,46542,104,95000,547,1000,0.547,616,0.616,163,0.163,63
62896,48820,14076,47180,105,96000,524,1000,0.524,638,0.638,162,0.162,63
63401,49167,14234,47833,106,97000,505,1000,0.505,653,0.653,158,0.158,63
63899,49495,14404,48505,107,98000,498,1000,0.498,672,0.672,170,0.17,63
64385,49799,14586,49201,108,99000,486,1000,0.486,696,0.696,182,0.182,63
64888,50121,14767,49879,109,100000,503,1000,0.503,678,0.678,181,0.181,63
65375,50432,14943,50568,110,101000,487,1000,0.487,689,0.689,176,0.176,63
65895,50786,15109,51214,111,102000,520,1000,0.52,646,0.646,166,0.166,63
66402,51130,15272,51870,112,103000,507,1000,0.507,656,0.656,163,0.163,63
66897,51454,15443,52546,113,104000,495,1000,0.495,676,0.676,171,0.171,63
67392,51781,15611,53219,114,105000,495,1000,0.495,673,0.673,168,0.168,63
67869,52071,15798,53929,115,106000,477,1000,0.477,710,0.71,187,0.187,63
68352,52366,15986,54634,116,107000,483,1000,0.483,705,0.705,188,0.188,63
68858,52698,16160,55302,117,108000,506,1000,0.506,668,0.668,174,0.174,63
69313,52964,16349,56036,118,109000,455,1000,0.455,734,0.734,189,0.189,63
69803,53294,16509,56706,119,110000,490,1000,0.49,670,0.67,160,0.16,63
70306,53640,16666,57360,120,111000,503,1000,0.503,654,0.654,157,0.157,63
70809,53985,16824,58015,121,112000,503,1000,0.503,655,0.655,158,0.158,63
71273,54270,17003,58730,122,113000,464,1000,0.464,715,0.715,179,0.179,63
71740,54574,17166,59426,123,114000,467,1000,0.467,696,0.696,163,0.163,63
71869,54638,17231,59660,124,114298,129,298,0.43288590604026844,234,0.785234899328859,65,0.2181208053691275,63
100,100,0,0,1,100,NA,NA,NA,NA,NA,NA,NA,64
199,198,1,2,2,200,99,100,0.99,2,0.02,1,0.01,64
298,296,2,4,3,300,99,100,0.99,2,0.02,1,0.01,64
396,392,4,8,4,400,98,100,0.98,4,0.04,2,0.02,64
494,488,6,12,5,500,98,100,0.98,4,0.04,2,0.02,64
591,582,9,18,6,600,97,100,0.97,6,0.06,3,0.03,64
689,679,10,21,7,700,98,100,0.98,3,0.03,1,0.01,64
789,779,10,21,8,800,100,100,1,0,0,0,0,64
886,874,12,26,9,900,97,100,0.97,5,0.05,2,0.02,64
980,963,17,37,10,1000,94,100,0.94,11,0.11,5,0.05,64
1931,1877,54,123,11,2000,951,1000,0.951,86,0.086,37,0.037,64
2880,2790,90,210,12,3000,949,1000,0.949,87,0.087,36,0.036,64
3800,3658,142,342,13,4000,920,1000,0.92,132,0.132,52,0.052,64
4706,4496,210,504,14,5000,906,1000,0.906,162,0.162,68,0.068,64
5576,5290,286,710,15,6000,870,1000,0.87,206,0.206,76,0.076,64
6449,6079,370,921,16,7000,873,1000,0.873,211,0.211,84,0.084,64
7321,6871,450,1129,17,8000,872,1000,0.872,208,0.208,80,0.08,64
8161,7596,565,1404,18,9000,840,1000,0.84,275,0.275,115,0.115,64
9006,8349,657,1651,19,10000,845,1000,0.845,247,0.247,92,0.092,64
9843,9085,758,1915,20,11000,837,1000,0.837,264,0.264,101,0.101,64
10668,9801,867,2199,21,12000,825,1000,0.825,284,0.284,109,0.109,64
11506,10547,959,2453,22,13000,838,1000,0.838,254,0.254,92,0.092,64
12316,11246,1070,2754,23,14000,810,1000,0.81,301,0.301,111,0.111,64
13105,11916,1189,3084,24,15000,789,1000,0.789,330,0.33,119,0.119,64
13895,12580,1315,3420,25,16000,790,1000,0.79,336,0.336,126,0.126,64
14689,13249,1440,3751,26,17000,794,1000,0.794,331,0.331,125,0.125,64
15443,13869,1574,4131,27,18000,754,1000,0.754,380,0.38,134,0.134,64
16204,14507,1697,4493,28,19000,761,1000,0.761,362,0.362,123,0.123,64
16956,15126,1830,4874,29,20000,752,1000,0.752,381,0.381,133,0.133,64
17685,15718,1967,5282,30,21000,729,1000,0.729,408,0.408,137,0.137,64
18407,16296,2111,5704,31,22000,722,1000,0.722,422,0.422,144,0.144,64
19154,16905,2249,6095,32,23000,747,1000,0.747,391,0.391,138,0.138,64
19869,17487,2382,6513,33,24000,715,1000,0.715,418,0.418,133,0.133,64
20617,18102,2515,6898,34,25000,748,1000,0.748,385,0.385,133,0.133,64
21339,18680,2659,7320,35,26000,722,1000,0.722,422,0.422,144,0.144,64
22059,19249,2810,7751,36,27000,720,1000,0.72,431,0.431,151,0.151,64
22768,19809,2959,8191,37,28000,709,1000,0.709,440,0.44,149,0.149,64
23480,20383,3097,8617,38,29000,712,1000,0.712,426,0.426,138,0.138,64
24201,20980,3221,9020,39,30000,721,1000,0.721,403,0.403,124,0.124,64
24903,21554,3349,9446,40,31000,702,1000,0.702,426,0.426,128,0.128,64
25593,22088,3505,9912,41,32000,690,1000,0.69,466,0.466,156,0.156,64
26277,22626,3651,10374,42,33000,684,1000,0.684,462,0.462,146,0.146,64
26980,23192,3788,10808,43,34000,703,1000,0.703,434,0.434,137,0.137,64
27690,23769,3921,11231,44,35000,710,1000,0.71,423,0.423,133,0.133,64
28356,24274,4082,11726,45,36000,666,1000,0.666,495,0.495,161,0.161,64
29015,24783,4232,12217,46,37000,659,1000,0.659,491,0.491,150,0.15,64
29666,25248,4418,12752,47,38000,651,1000,0.651,535,0.535,186,0.186,64
30325,25741,4584,13259,48,39000,659,1000,0.659,507,0.507,166,0.166,64
30974,26237,4737,13763,49,40000,649,1000,0.649,504,0.504,153,0.153,64
31626,26736,4890,14264,50,41000,652,1000,0.652,501,0.501,153,0.153,64
32271,27214,5057,14786,51,42000,645,1000,0.645,522,0.522,167,0.167,64
32922,27709,5213,15291,52,43000,651,1000,0.651,505,0.505,156,0.156,64
33548,28172,5376,15828,53,44000,626,1000,0.626,537,0.537,163,0.163,64
34189,28646,5543,16354,54,45000,641,1000,0.641,526,0.526,167,0.167,64
34799,29071,5728,16929,55,46000,610,1000,0.61,575,0.575,185,0.185,64
35420,29528,5892,17472,56,47000,621,1000,0.621,543,0.543,164,0.164,64
36026,29963,6063,18037,57,48000,606,1000,0.606,565,0.565,171,0.171,64
36638,30417,6221,18583,58,49000,612,1000,0.612,546,0.546,158,0.158,64
37258,30870,6388,19130,59,50000,620,1000,0.62,547,0.547,167,0.167,64
37894,31359,6535,19641,60,51000,636,1000,0.636,511,0.511,147,0.147,64
38482,31773,6709,20227,61,52000,588,1000,0.588,586,0.586,174,0.174,64
39077,32202,6875,20798,62,53000,595,1000,0.595,571,0.571,166,0.166,64
39669,32620,7049,21380,63,54000,592,1000,0.592,582,0.582,174,0.174,64
40255,33034,7221,21966,64,55000,586,1000,0.586,586,0.586,172,0.172,64
40863,33476,7387,22524,65,56000,608,1000,0.608,558,0.558,166,0.166,64
41457,33934,7523,23066,66,57000,594,1000,0.594,542,0.542,136,0.136,64
42028,34343,7685,23657,67,58000,571,1000,0.571,591,0.591,162,0.162,64
42615,34767,7848,24233,68,59000,587,1000,0.587,576,0.576,163,0.163,64
43197,35188,8009,24812,69,60000,582,1000,0.582,579,0.579,161,0.161,64
43788,35616,8172,25384,70,61000,591,1000,0.591,572,0.572,163,0.163,64
44371,36025,8346,25975,71,62000,583,1000,0.583,591,0.591,174,0.174,64
44948,36435,8513,26565,72,63000,577,1000,0.577,590,0.59,167,0.167,64
45552,36883,8669,27117,73,64000,604,1000,0.604,552,0.552,156,0.156,64
46089,37253,8836,27747,74,65000,537,1000,0.537,630,0.63,167,0.167,64
46664,37657,9007,28343,75,66000,575,1000,0.575,596,0.596,171,0.171,64
47221,38056,9165,28944,76,67000,557,1000,0.557,601,0.601,158,0.158,64
47777,38441,9336,29559,77,68000,556,1000,0.556,615,0.615,171,0.171,64
48334,38812,9522,30188,78,69000,557,1000,0.557,629,0.629,186,0.186,64
48917,39228,9689,30772,79,70000,583,1000,0.583,584,0.584,167,0.167,64
49475,39609,9866,31391,80,71000,558,1000,0.558,619,0.619,177,0.177,64
50018,39970,10048,32030,81,72000,543,1000,0.543,639,0.639,182,0.182,64
50581,40363,10218,32637,82,73000,563,1000,0.563,607,0.607,170,0.17,64
51149,40770,10379,33230,83,74000,568,1000,0.568,593,0.593,161,0.161,64
51726,41187,10539,33813,84,75000,577,1000,0.577,583,0.583,160,0.16,64
52280,41576,10704,34424,85,76000,554,1000,0.554,611,0.611,165,0.165,64
52793,41919,10874,35081,86,77000,513,1000,0.513,657,0.657,170,0.17,64
53333,42310,11023,35690,87,78000,540,1000,0.54,609,0.609,149,0.149,64
53873,42683,11190,36317,88,79000,540,1000,0.54,627,0.627,167,0.167,64
54416,43074,11342,36926,89,80000,543,1000,0.543,609,0.609,152,0.152,64
54944,43412,11532,37588,90,81000,528,1000,0.528,662,0.662,190,0.19,64
55441,43739,11702,38261,91,82000,497,1000,0.497,673,0.673,170,0.17,64
55973,44104,11869,38896,92,83000,532,1000,0.532,635,0.635,167,0.167,64
56496,44446,12050,39554,93,84000,523,1000,0.523,658,0.658,181,0.181,64
57013,44786,12227,40214,94,85000,517,1000,0.517,660,0.66,177,0.177,64
57554,45155,12399,40845,95,86000,541,1000,0.541,631,0.631,172,0.172,64
58112,45555,12557,41445,96,87000,558,1000,0.558,600,0.6,158,0.158,64
58641,45921,12720,42079,97,88000,529,1000,0.529,634,0.634,163,0.163,64
59139,46228,12911,42772,98,89000,498,1000,0.498,693,0.693,191,0.191,64
59671,46603,13068,43397,99,90000,532,1000,0.532,625,0.625,157,0.157,64
60170,46927,13243,44073,100,91000,499,1000,0.499,676,0.676,175,0.175,64
60686,47250,13436,44750,101,92000,516,1000,0.516,677,0.677,193,0.193,64
61232,47635,13597,45365,102,93000,546,1000,0.546,615,0.615,161,0.161,64
61754,48001,13753,45999,103,94000,522,1000,0.522,634,0.634,156,0.156,64
62290,48358,13932,46642,104,95000,536,1000,0.536,643,0.643,179,0.179,64
62812,48723,14089,47277,105,96000,522,1000,0.522,635,0.635,157,0.157,64
63312,49080,14232,47920,106,97000,500,1000,0.5,643,0.643,143,0.143,64
63825,49419,14406,48581,107,98000,513,1000,0.513,661,0.661,174,0.174,64
64311,49730,14581,49270,108,99000,486,1000,0.486,689,0.689,175,0.175,64
64813,50073,14740,49927,109,100000,502,1000,0.502,657,0.657,159,0.159,64
65313,50413,14900,50587,110,101000,500,1000,0.5,660,0.66,160,0.16,64
65842,50767,15075,51233,111,102000,529,1000,0.529,646,0.646,175,0.175,64
66323,51069,15254,51931,112,103000,481,1000,0.481,698,0.698,179,0.179,64
66845,51424,15421,52576,113,104000,522,1000,0.522,645,0.645,167,0.167,64
67333,51737,15596,53263,114,105000,488,1000,0.488,687,0.687,175,0.175,64
67836,52062,15774,53938,115,106000,503,1000,0.503,675,0.675,178,0.178,64
68320,52383,15937,54617,116,107000,484,1000,0.484,679,0.679,163,0.163,64
68794,52673,16121,55327,117,108000,474,1000,0.474,710,0.71,184,0.184,64
69274,52977,16297,56023,118,109000,480,1000,0.48,696,0.696,176,0.176,64
69760,53288,16472,56712,119,110000,486,1000,0.486,689,0.689,175,0.175,64
70269,53637,16632,57363,120,111000,509,1000,0.509,651,0.651,160,0.16,64
70722,53894,16828,58106,121,112000,453,1000,0.453,743,0.743,196,0.196,64
71230,54223,17007,58777,122,113000,508,1000,0.508,671,0.671,179,0.179,64
71712,54530,17182,59470,123,114000,482,1000,0.482,693,0.693,175,0.175,64
71869,54638,17231,59660,124,114298,157,298,0.5268456375838926,190,0.6375838926174496,49,0.1644295302013423,64
100,100,0,0,1,100,NA,NA,NA,NA,NA,NA,NA,65
199,198,1,2,2,200,99,100,0.99,2,0.02,1,0.01,65
299,298,1,2,3,300,100,100,1,0,0,0,0,65
395,390,5,10,4,400,96,100,0.96,8,0.08,4,0.04,65
492,485,7,15,5,500,97,100,0.97,5,0.05,2,0.02,65
592,585,7,15,6,600,100,100,1,0,0,0,0,65
691,683,8,17,7,700,99,100,0.99,2,0.02,1,0.01,65
790,781,9,19,8,800,99,100,0.99,2,0.02,1,0.01,65
885,871,14,29,9,900,95,100,0.95,10,0.1,5,0.05,65
982,965,17,35,10,1000,97,100,0.97,6,0.06,3,0.03,65
1935,1884,51,116,11,2000,953,1000,0.953,81,0.081,34,0.034,65
2859,2758,101,242,12,3000,924,1000,0.924,126,0.126,50,0.05,65
3783,3631,152,369,13,4000,924,1000,0.924,127,0.127,51,0.051,65
4684,4468,216,532,14,5000,901,1000,0.901,163,0.163,64,0.064,65
5587,5312,275,688,15,6000,903,1000,0.903,156,0.156,59,0.059,65
6459,6102,357,898,16,7000,872,1000,0.872,210,0.21,82,0.082,65
7319,6875,444,1125,17,8000,860,1000,0.86,227,0.227,87,0.087,65
8178,7641,537,1359,18,9000,859,1000,0.859,234,0.234,93,0.093,65
9027,8399,628,1601,19,10000,849,1000,0.849,242,0.242,91,0.091,65
9858,9128,730,1872,20,11000,831,1000,0.831,271,0.271,102,0.102,65
10674,9838,836,2162,21,12000,816,1000,0.816,290,0.29,106,0.106,65
11480,10535,945,2465,22,13000,806,1000,0.806,303,0.303,109,0.109,65
12290,11237,1053,2763,23,14000,810,1000,0.81,298,0.298,108,0.108,65
13098,11927,1171,3073,24,15000,808,1000,0.808,310,0.31,118,0.118,65
13880,12584,1296,3416,25,16000,782,1000,0.782,343,0.343,125,0.125,65
14637,13215,1422,3785,26,17000,757,1000,0.757,369,0.369,126,0.126,65
15423,13883,1540,4117,27,18000,786,1000,0.786,332,0.332,118,0.118,65
16154,14472,1682,4528,28,19000,731,1000,0.731,411,0.411,142,0.142,65
16887,15057,1830,4943,29,20000,733,1000,0.733,415,0.415,148,0.148,65
17654,15710,1944,5290,30,21000,767,1000,0.767,347,0.347,114,0.114,65
18400,16325,2075,5675,31,22000,746,1000,0.746,385,0.385,131,0.131,65
19112,16896,2216,6104,32,23000,712,1000,0.712,429,0.429,141,0.141,65
19873,17533,2340,6467,33,24000,761,1000,0.761,363,0.363,124,0.124,65
20592,18105,2487,6895,34,25000,719,1000,0.719,428,0.428,147,0.147,65
21316,18688,2628,7312,35,26000,724,1000,0.724,417,0.417,141,0.141,65
22027,19263,2764,7737,36,27000,711,1000,0.711,425,0.425,136,0.136,65
22740,19848,2892,8152,37,28000,713,1000,0.713,415,0.415,128,0.128,65
23450,20429,3021,8571,38,29000,710,1000,0.71,419,0.419,129,0.129,65
24167,21012,3155,8988,39,30000,717,1000,0.717,417,0.417,134,0.134,65
24875,21580,3295,9420,40,31000,708,1000,0.708,432,0.432,140,0.14,65
25570,22121,3449,9879,41,32000,695,1000,0.695,459,0.459,154,0.154,65
26246,22640,3606,10360,42,33000,676,1000,0.676,481,0.481,157,0.157,65
26905,23161,3744,10839,43,34000,659,1000,0.659,479,0.479,138,0.138,65
27576,23663,3913,11337,44,35000,671,1000,0.671,498,0.498,169,0.169,65
28236,24159,4077,11841,45,36000,660,1000,0.66,504,0.504,164,0.164,65
28896,24664,4232,12336,46,37000,660,1000,0.66,495,0.495,155,0.155,65
29546,25150,4396,12850,47,38000,650,1000,0.65,514,0.514,164,0.164,65
30202,25648,4554,13352,48,39000,656,1000,0.656,502,0.502,158,0.158,65
30864,26153,4711,13847,49,40000,662,1000,0.662,495,0.495,157,0.157,65
31514,26649,4865,14351,50,41000,650,1000,0.65,504,0.504,154,0.154,65
32167,27149,5018,14851,51,42000,653,1000,0.653,500,0.5,153,0.153,65
32825,27652,5173,15348,52,43000,658,1000,0.658,497,0.497,155,0.155,65
33477,28128,5349,15872,53,44000,652,1000,0.652,524,0.524,176,0.176,65
34109,28573,5536,16427,54,45000,632,1000,0.632,555,0.555,187,0.187,65
34763,29075,5688,16925,55,46000,654,1000,0.654,498,0.498,152,0.152,65
35397,29559,5838,17441,56,47000,634,1000,0.634,516,0.516,150,0.15,65
36026,30042,5984,17958,57,48000,629,1000,0.629,517,0.517,146,0.146,65
36644,30495,6149,18505,58,49000,618,1000,0.618,547,0.547,165,0.165,65
37272,30956,6316,19044,59,50000,628,1000,0.628,539,0.539,167,0.167,65
37876,31402,6474,19598,60,51000,604,1000,0.604,554,0.554,158,0.158,65
38498,31866,6632,20134,61,52000,622,1000,0.622,536,0.536,158,0.158,65
39119,32325,6794,20675,62,53000,621,1000,0.621,541,0.541,162,0.162,65
39714,32748,6966,21252,63,54000,595,1000,0.595,577,0.577,172,0.172,65
40325,33207,7118,21793,64,55000,611,1000,0.611,541,0.541,152,0.152,65
40928,33650,7278,22350,65,56000,603,1000,0.603,557,0.557,160,0.16,65
41526,34056,7470,22944,66,57000,598,1000,0.598,594,0.594,192,0.192,65
42106,34450,7656,23550,67,58000,580,1000,0.58,606,0.606,186,0.186,65
42696,34864,7832,24136,68,59000,590,1000,0.59,586,0.586,176,0.176,65
43303,35318,7985,24682,69,60000,607,1000,0.607,546,0.546,153,0.153,65
43893,35744,8149,25256,70,61000,590,1000,0.59,574,0.574,164,0.164,65
44474,36175,8299,25825,71,62000,581,1000,0.581,569,0.569,150,0.15,65
45062,36592,8470,26408,72,63000,588,1000,0.588,583,0.583,171,0.171,65
45637,36991,8646,27009,73,64000,575,1000,0.575,601,0.601,176,0.176,65
46211,37385,8826,27615,74,65000,574,1000,0.574,606,0.606,180,0.18,65
46784,37788,8996,28212,75,66000,573,1000,0.573,597,0.597,170,0.17,65
47358,38202,9156,28798,76,67000,574,1000,0.574,586,0.586,160,0.16,65
47927,38605,9322,29395,77,68000,569,1000,0.569,597,0.597,166,0.166,65
48493,38994,9499,30006,78,69000,566,1000,0.566,611,0.611,177,0.177,65
49037,39379,9658,30621,79,70000,544,1000,0.544,615,0.615,159,0.159,65
49605,39772,9833,31228,80,71000,568,1000,0.568,607,0.607,175,0.175,65
50147,40142,10005,31858,81,72000,542,1000,0.542,630,0.63,172,0.172,65
50710,40536,10174,32464,82,73000,563,1000,0.563,606,0.606,169,0.169,65
51266,40914,10352,33086,83,74000,556,1000,0.556,622,0.622,178,0.178,65
51831,41314,10517,33686,84,75000,565,1000,0.565,600,0.6,165,0.165,65
52406,41734,10672,34266,85,76000,575,1000,0.575,580,0.58,155,0.155,65
52927,42072,10855,34928,86,77000,521,1000,0.521,662,0.662,183,0.183,65
53462,42431,11031,35569,87,78000,535,1000,0.535,641,0.641,176,0.176,65
54001,42792,11209,36208,88,79000,539,1000,0.539,639,0.639,178,0.178,65
54540,43171,11369,36829,89,80000,539,1000,0.539,621,0.621,160,0.16,65
55071,43536,11535,37464,90,81000,531,1000,0.531,635,0.635,166,0.166,65
55623,43934,11689,38066,91,82000,552,1000,0.552,602,0.602,154,0.154,65
56138,44281,11857,38719,92,83000,515,1000,0.515,653,0.653,168,0.168,65
56635,44589,12046,39411,93,84000,497,1000,0.497,692,0.692,189,0.189,65
57205,44997,12208,40003,94,85000,570,1000,0.57,592,0.592,162,0.162,65
57712,45324,12388,40676,95,86000,507,1000,0.507,673,0.673,180,0.18,65
58235,45667,12568,41333,96,87000,523,1000,0.523,657,0.657,180,0.18,65
58756,46024,12732,41976,97,88000,521,1000,0.521,643,0.643,164,0.164,65
59273,46373,12900,42627,98,89000,517,1000,0.517,651,0.651,168,0.168,65
59794,46714,13080,43286,99,90000,521,1000,0.521,659,0.659,180,0.18,65
60323,47074,13249,43926,100,91000,529,1000,0.529,640,0.64,169,0.169,65
60838,47417,13421,44583,101,92000,515,1000,0.515,657,0.657,172,0.172,65
61331,47737,13594,45263,102,93000,493,1000,0.493,680,0.68,173,0.173,65
61837,48063,13774,45937,103,94000,506,1000,0.506,674,0.674,180,0.18,65
62340,48412,13928,46588,104,95000,503,1000,0.503,651,0.651,154,0.154,65
62829,48725,14104,47275,105,96000,489,1000,0.489,687,0.687,176,0.176,65
63356,49076,14280,47924,106,97000,527,1000,0.527,649,0.649,176,0.176,65
63848,49386,14462,48614,107,98000,492,1000,0.492,690,0.69,182,0.182,65
64349,49706,14643,49294,108,99000,501,1000,0.501,680,0.68,181,0.181,65
64864,50055,14809,49945,109,100000,515,1000,0.515,651,0.651,166,0.166,65
65376,50400,14976,50600,110,101000,512,1000,0.512,655,0.655,167,0.167,65
65889,50750,15139,51250,111,102000,513,1000,0.513,650,0.65,163,0.163,65
66369,51041,15328,51959,112,103000,480,1000,0.48,709,0.709,189,0.189,65
66869,51384,15485,52616,113,104000,500,1000,0.5,657,0.657,157,0.157,65
67372,51718,15654,53282,114,105000,503,1000,0.503,666,0.666,169,0.169,65
67879,52054,15825,53946,115,106000,507,1000,0.507,664,0.664,171,0.171,65
68341,52347,15994,54653,116,107000,462,1000,0.462,707,0.707,169,0.169,65
68848,52690,16158,55310,117,108000,507,1000,0.507,657,0.657,164,0.164,65
69340,53028,16312,55972,118,109000,492,1000,0.492,662,0.662,154,0.154,65
69811,53310,16501,56690,119,110000,471,1000,0.471,718,0.718,189,0.189,65
70329,53678,16651,57322,120,111000,518,1000,0.518,632,0.632,150,0.15,65
70794,53970,16824,58030,121,112000,465,1000,0.465,708,0.708,173,0.173,65
71239,54234,17005,58766,122,113000,445,1000,0.445,736,0.736,181,0.181,65
71729,54549,17180,59451,123,114000,490,1000,0.49,685,0.685,175,0.175,65
71869,54638,17231,59660,124,114298,140,298,0.4697986577181208,209,0.7013422818791947,51,0.17114093959731544,65
100,100,0,0,1,100,NA,NA,NA,NA,NA,NA,NA,66
199,198,1,2,2,200,99,100,0.99,2,0.02,1,0.01,66
298,296,2,4,3,300,99,100,0.99,2,0.02,1,0.01,66
395,391,4,9,4,400,97,100,0.97,5,0.05,2,0.02,66
491,483,8,17,5,500,96,100,0.96,8,0.08,4,0.04,66
590,581,9,19,6,600,99,100,0.99,2,0.02,1,0.01,66
687,677,10,23,7,700,97,100,0.97,4,0.04,1,0.01,66
787,777,10,23,8,800,100,100,1,0,0,0,0,66
881,866,15,34,9,900,94,100,0.94,11,0.11,5,0.05,66
976,956,20,44,10,1000,95,100,0.95,10,0.1,5,0.05,66
1931,1875,56,125,11,2000,955,1000,0.955,81,0.081,36,0.036,66
2868,2762,106,238,12,3000,937,1000,0.937,113,0.113,50,0.05,66
3784,3621,163,379,13,4000,916,1000,0.916,141,0.141,57,0.057,66
4692,4469,223,531,14,5000,908,1000,0.908,152,0.152,60,0.06,66
5599,5318,281,682,15,6000,907,1000,0.907,151,0.151,58,0.058,66
6488,6137,351,863,16,7000,889,1000,0.889,181,0.181,70,0.07,66
7352,6918,434,1082,17,8000,864,1000,0.864,219,0.219,83,0.083,66
8196,7664,532,1336,18,9000,844,1000,0.844,254,0.254,98,0.098,66
9029,8402,627,1598,19,10000,833,1000,0.833,262,0.262,95,0.095,66
9838,9097,741,1903,20,11000,809,1000,0.809,305,0.305,114,0.114,66
10641,9790,851,2210,21,12000,803,1000,0.803,307,0.307,110,0.11,66
11463,10507,956,2493,22,13000,822,1000,0.822,283,0.283,105,0.105,66
12273,11210,1063,2790,23,14000,810,1000,0.81,297,0.297,107,0.107,66
13081,11899,1182,3101,24,15000,808,1000,0.808,311,0.311,119,0.119,66
13866,12556,1310,3444,25,16000,785,1000,0.785,343,0.343,128,0.128,66
14637,13201,1436,3799,26,17000,771,1000,0.771,355,0.355,126,0.126,66
15419,13855,1564,4145,27,18000,782,1000,0.782,346,0.346,128,0.128,66
16196,14510,1686,4490,28,19000,777,1000,0.777,345,0.345,122,0.122,66
16953,15126,1827,4874,29,20000,757,1000,0.757,384,0.384,141,0.141,66
17692,15725,1967,5275,30,21000,739,1000,0.739,401,0.401,140,0.14,66
18416,16311,2105,5689,31,22000,724,1000,0.724,414,0.414,138,0.138,66
19159,16909,2250,6091,32,23000,743,1000,0.743,402,0.402,145,0.145,66
19879,17482,2397,6518,33,24000,720,1000,0.72,427,0.427,147,0.147,66
20573,18023,2550,6977,34,25000,694,1000,0.694,459,0.459,153,0.153,66
21316,18643,2673,7357,35,26000,743,1000,0.743,380,0.38,123,0.123,66
22021,19215,2806,7785,36,27000,705,1000,0.705,428,0.428,133,0.133,66
22713,19756,2957,8244,37,28000,692,1000,0.692,459,0.459,151,0.151,66
23398,20276,3122,8724,38,29000,685,1000,0.685,480,0.48,165,0.165,66
24092,20823,3269,9177,39,30000,694,1000,0.694,453,0.453,147,0.147,66
24783,21349,3434,9651,40,31000,691,1000,0.691,474,0.474,165,0.165,66
25472,21883,3589,10117,41,32000,689,1000,0.689,466,0.466,155,0.155,66
26162,22425,3737,10575,42,33000,690,1000,0.69,458,0.458,148,0.148,66
26833,22929,3904,11071,43,34000,671,1000,0.671,496,0.496,167,0.167,66
27502,23444,4058,11556,44,35000,669,1000,0.669,485,0.485,154,0.154,66
28175,23961,4214,12039,45,36000,673,1000,0.673,483,0.483,156,0.156,66
28837,24453,4384,12547,46,37000,662,1000,0.662,508,0.508,170,0.17,66
29500,24969,4531,13031,47,38000,663,1000,0.663,484,0.484,147,0.147,66
30160,25474,4686,13526,48,39000,660,1000,0.66,495,0.495,155,0.155,66
30832,25995,4837,14005,49,40000,672,1000,0.672,479,0.479,151,0.151,66
31495,26515,4980,14485,50,41000,663,1000,0.663,480,0.48,143,0.143,66
32136,26979,5157,15021,51,42000,641,1000,0.641,536,0.536,177,0.177,66
32794,27472,5322,15528,52,43000,658,1000,0.658,507,0.507,165,0.165,66
33402,27909,5493,16091,53,44000,608,1000,0.608,563,0.563,171,0.171,66
34056,28407,5649,16593,54,45000,654,1000,0.654,502,0.502,156,0.156,66
34682,28872,5810,17128,55,46000,626,1000,0.626,535,0.535,161,0.161,66
35331,29369,5962,17631,56,47000,649,1000,0.649,503,0.503,152,0.152,66
35942,29803,6139,18197,57,48000,611,1000,0.611,566,0.566,177,0.177,66
36539,30244,6295,18756,58,49000,597,1000,0.597,559,0.559,156,0.156,66
37185,30731,6454,19269,59,50000,646,1000,0.646,513,0.513,159,0.159,66
37804,31191,6613,19809,60,51000,619,1000,0.619,540,0.54,159,0.159,66
38417,31646,6771,20354,61,52000,613,1000,0.613,545,0.545,158,0.158,66
38994,32053,6941,20947,62,53000,577,1000,0.577,593,0.593,170,0.17,66
39583,32484,7099,21516,63,54000,589,1000,0.589,569,0.569,158,0.158,66
40170,32889,7281,22111,64,55000,587,1000,0.587,595,0.595,182,0.182,66
40763,33315,7448,22685,65,56000,593,1000,0.593,574,0.574,167,0.167,66
41356,33745,7611,23255,66,57000,593,1000,0.593,570,0.57,163,0.163,66
41937,34159,7778,23841,67,58000,581,1000,0.581,586,0.586,167,0.167,66
42538,34610,7928,24390,68,59000,601,1000,0.601,549,0.549,150,0.15,66
43146,35068,8078,24932,69,60000,608,1000,0.608,542,0.542,150,0.15,66
43742,35504,8238,25496,70,61000,596,1000,0.596,564,0.564,160,0.16,66
44325,35930,8395,26070,71,62000,583,1000,0.583,574,0.574,157,0.157,66
44884,36307,8577,26693,72,63000,559,1000,0.559,623,0.623,182,0.182,66
45454,36703,8751,27297,73,64000,570,1000,0.57,604,0.604,174,0.174,66
46016,37080,8936,27920,74,65000,562,1000,0.562,623,0.623,185,0.185,66
46593,37491,9102,28509,75,66000,577,1000,0.577,589,0.589,166,0.166,66
47167,37901,9266,29099,76,67000,574,1000,0.574,590,0.59,164,0.164,66
47728,38294,9434,29706,77,68000,561,1000,0.561,607,0.607,168,0.168,66
48296,38675,9621,30325,78,69000,568,1000,0.568,619,0.619,187,0.187,66
48832,39039,9793,30961,79,70000,536,1000,0.536,636,0.636,172,0.172,66
49398,39445,9953,31555,80,71000,566,1000,0.566,594,0.594,160,0.16,66
49968,39863,10105,32137,81,72000,570,1000,0.57,582,0.582,152,0.152,66
50516,40254,10262,32746,82,73000,548,1000,0.548,609,0.609,157,0.157,66
51087,40649,10438,33351,83,74000,571,1000,0.571,605,0.605,176,0.176,66
51619,41004,10615,33996,84,75000,532,1000,0.532,645,0.645,177,0.177,66
52164,41405,10759,34595,85,76000,545,1000,0.545,599,0.599,144,0.144,66
52723,41815,10908,35185,86,77000,559,1000,0.559,590,0.59,149,0.149,66
53241,42135,11106,35865,87,78000,518,1000,0.518,680,0.68,198,0.198,66
53786,42496,11290,36504,88,79000,545,1000,0.545,639,0.639,184,0.184,66
54336,42879,11457,37121,89,80000,550,1000,0.55,617,0.617,167,0.167,66
54866,43228,11638,37772,90,81000,530,1000,0.53,651,0.651,181,0.181,66
55431,43640,11791,38360,91,82000,565,1000,0.565,588,0.588,153,0.153,66
55987,44039,11948,38961,92,83000,556,1000,0.556,601,0.601,157,0.157,66
56497,44370,12127,39630,93,84000,510,1000,0.51,669,0.669,179,0.179,66
57012,44731,12281,40269,94,85000,515,1000,0.515,639,0.639,154,0.154,66
57562,45142,12420,40858,95,86000,550,1000,0.55,589,0.589,139,0.139,66
58073,45459,12614,41541,96,87000,511,1000,0.511,683,0.683,194,0.194,66
58611,45819,12792,42181,97,88000,538,1000,0.538,640,0.64,178,0.178,66
59164,46205,12959,42795,98,89000,553,1000,0.553,614,0.614,167,0.167,66
59674,46546,13128,43454,99,90000,510,1000,0.51,659,0.659,169,0.169,66
60209,46921,13288,44079,100,91000,535,1000,0.535,625,0.625,160,0.16,66
60722,47272,13450,44728,101,92000,513,1000,0.513,649,0.649,162,0.162,66
61236,47624,13612,45376,102,93000,514,1000,0.514,648,0.648,162,0.162,66
61736,47956,13780,46044,103,94000,500,1000,0.5,668,0.668,168,0.168,66
62229,48258,13971,46742,104,95000,493,1000,0.493,698,0.698,191,0.191,66
62744,48618,14126,47382,105,96000,515,1000,0.515,640,0.64,155,0.155,66
63249,48941,14308,48059,106,97000,505,1000,0.505,677,0.677,182,0.182,66
63747,49250,14497,48750,107,98000,498,1000,0.498,691,0.691,189,0.189,66
64259,49585,14674,49415,108,99000,512,1000,0.512,665,0.665,177,0.177,66
64763,49941,14822,50059,109,100000,504,1000,0.504,644,0.644,148,0.148,66
65261,50284,14977,50716,110,101000,498,1000,0.498,657,0.657,155,0.155,66
65755,50600,15155,51400,111,102000,494,1000,0.494,684,0.684,178,0.178,66
66256,50929,15327,52071,112,103000,501,1000,0.501,671,0.671,172,0.172,66
66741,51255,15486,52745,113,104000,485,1000,0.485,674,0.674,159,0.159,66
67271,51633,15638,53367,114,105000,530,1000,0.53,622,0.622,152,0.152,66
67781,51968,15813,54032,115,106000,510,1000,0.51,665,0.665,175,0.175,66
68293,52314,15979,54686,116,107000,512,1000,0.512,654,0.654,166,0.166,66
68777,52642,16135,55358,117,108000,484,1000,0.484,672,0.672,156,0.156,66
69270,52966,16304,56034,118,109000,493,1000,0.493,676,0.676,169,0.169,66
69737,53259,16478,56741,119,110000,467,1000,0.467,707,0.707,174,0.174,66
70234,53584,16650,57416,120,111000,497,1000,0.497,675,0.675,172,0.172,66
70732,53923,16809,58077,121,112000,498,1000,0.498,661,0.661,159,0.159,66
71225,54239,16986,58761,122,113000,493,1000,0.493,684,0.684,177,0.177,66
71725,54553,17172,59447,123,114000,500,1000,0.5,686,0.686,186,0.186,66
71869,54638,17231,59660,124,114298,144,298,0.48322147651006714,213,0.714765100671141,59,0.19798657718120805,66
100,100,0,0,1,100,NA,NA,NA,NA,NA,NA,NA,67
200,200,0,0,2,200,100,100,1,0,0,0,0,67
300,300,0,0,3,300,100,100,1,0,0,0,0,67
398,396,2,4,4,400,98,100,0.98,4,0.04,2,0.02,67
495,490,5,10,5,500,97,100,0.97,6,0.06,3,0.03,67
593,586,7,14,6,600,98,100,0.98,4,0.04,2,0.02,67
691,682,9,18,7,700,98,100,0.98,4,0.04,2,0.02,67
789,779,10,21,8,800,98,100,0.98,3,0.03,1,0.01,67
887,875,12,25,9,900,98,100,0.98,4,0.04,2,0.02,67
983,968,15,32,10,1000,96,100,0.96,7,0.07,3,0.03,67
1944,1904,40,96,11,2000,961,1000,0.961,64,0.064,25,0.025,67
2880,2786,94,214,12,3000,936,1000,0.936,118,0.118,54,0.054,67
3792,3631,161,369,13,4000,912,1000,0.912,155,0.155,67,0.067,67
4692,4460,232,540,14,5000,900,1000,0.9,171,0.171,71,0.071,67
5572,5256,316,744,15,6000,880,1000,0.88,204,0.204,84,0.084,67
6456,6067,389,933,16,7000,884,1000,0.884,189,0.189,73,0.073,67
7305,6827,478,1173,17,8000,849,1000,0.849,240,0.24,89,0.089,67
8146,7562,584,1438,18,9000,841,1000,0.841,265,0.265,106,0.106,67
8978,8284,694,1716,19,10000,832,1000,0.832,278,0.278,110,0.11,67
9816,9024,792,1976,20,11000,838,1000,0.838,260,0.26,98,0.098,67
10617,9702,915,2298,21,12000,801,1000,0.801,322,0.322,123,0.123,67
11428,10401,1027,2599,22,13000,811,1000,0.811,301,0.301,112,0.112,67
12226,11088,1138,2912,23,14000,798,1000,0.798,313,0.313,111,0.111,67
13030,11785,1245,3215,24,15000,804,1000,0.804,303,0.303,107,0.107,67
13788,12409,1379,3591,25,16000,758,1000,0.758,376,0.376,134,0.134,67
14538,13019,1519,3981,26,17000,750,1000,0.75,390,0.39,140,0.14,67
15328,13702,1626,4298,27,18000,790,1000,0.79,317,0.317,107,0.107,67
16092,14342,1750,4658,28,19000,764,1000,0.764,360,0.36,124,0.124,67
16849,14966,1883,5034,29,20000,757,1000,0.757,376,0.376,133,0.133,67
17632,15644,1988,5356,30,21000,783,1000,0.783,322,0.322,105,0.105,67
18388,16260,2128,5740,31,22000,756,1000,0.756,384,0.384,140,0.14,67
19148,16906,2242,6094,32,23000,760,1000,0.76,354,0.354,114,0.114,67
19879,17513,2366,6487,33,24000,731,1000,0.731,393,0.393,124,0.124,67
20619,18137,2482,6863,34,25000,740,1000,0.74,376,0.376,116,0.116,67
21334,18705,2629,7295,35,26000,715,1000,0.715,432,0.432,147,0.147,67
22068,19299,2769,7701,36,27000,734,1000,0.734,406,0.406,140,0.14,67
22761,19848,2913,8152,37,28000,693,1000,0.693,451,0.451,144,0.144,67
23485,20432,3053,8568,38,29000,724,1000,0.724,416,0.416,140,0.14,67
24191,20996,3195,9004,39,30000,706,1000,0.706,436,0.436,142,0.142,67
24889,21565,3324,9435,40,31000,698,1000,0.698,431,0.431,129,0.129,67
25610,22158,3452,9842,41,32000,721,1000,0.721,407,0.407,128,0.128,67
26318,22727,3591,10273,42,33000,708,1000,0.708,431,0.431,139,0.139,67
26976,23215,3761,10785,43,34000,658,1000,0.658,512,0.512,170,0.17,67
27641,23718,3923,11282,44,35000,665,1000,0.665,497,0.497,162,0.162,67
28301,24199,4102,11801,45,36000,660,1000,0.66,519,0.519,179,0.179,67
28968,24706,4262,12294,46,37000,667,1000,0.667,493,0.493,160,0.16,67
29654,25237,4417,12763,47,38000,686,1000,0.686,469,0.469,155,0.155,67
30312,25735,4577,13265,48,39000,658,1000,0.658,502,0.502,160,0.16,67
30977,26258,4719,13742,49,40000,665,1000,0.665,477,0.477,142,0.142,67
31625,26759,4866,14241,50,41000,648,1000,0.648,499,0.499,147,0.147,67
32258,27232,5026,14768,51,42000,633,1000,0.633,527,0.527,160,0.16,67
32900,27712,5188,15288,52,43000,642,1000,0.642,520,0.52,162,0.162,67
33505,28144,5361,15856,53,44000,605,1000,0.605,568,0.568,173,0.173,67
34117,28574,5543,16426,54,45000,612,1000,0.612,570,0.57,182,0.182,67
34751,29055,5696,16945,55,46000,634,1000,0.634,519,0.519,153,0.153,67
35385,29542,5843,17458,56,47000,634,1000,0.634,513,0.513,147,0.147,67
36002,29998,6004,18002,57,48000,617,1000,0.617,544,0.544,161,0.161,67
36616,30449,6167,18551,58,49000,614,1000,0.614,549,0.549,163,0.163,67
37233,30898,6335,19102,59,50000,617,1000,0.617,551,0.551,168,0.168,67
37865,31384,6481,19616,60,51000,632,1000,0.632,514,0.514,146,0.146,67
38497,31871,6626,20129,61,52000,632,1000,0.632,513,0.513,145,0.145,67
39113,32340,6773,20660,62,53000,616,1000,0.616,531,0.531,147,0.147,67
39714,32783,6931,21217,63,54000,601,1000,0.601,557,0.557,158,0.158,67
40331,33247,7084,21753,64,55000,617,1000,0.617,536,0.536,153,0.153,67
40958,33735,7223,22265,65,56000,627,1000,0.627,512,0.512,139,0.139,67
41558,34166,7392,22834,66,57000,600,1000,0.6,569,0.569,169,0.169,67
42134,34549,7585,23451,67,58000,576,1000,0.576,617,0.617,193,0.193,67
42734,34983,7751,24017,68,59000,600,1000,0.6,566,0.566,166,0.166,67
43312,35387,7925,24613,69,60000,578,1000,0.578,596,0.596,174,0.174,67
43892,35800,8092,25200,70,61000,580,1000,0.58,587,0.587,167,0.167,67
44458,36197,8261,25803,71,62000,566,1000,0.566,603,0.603,169,0.169,67
45028,36604,8424,26396,72,63000,570,1000,0.57,593,0.593,163,0.163,67
45587,36968,8619,27032,73,64000,559,1000,0.559,636,0.636,195,0.195,67
46163,37371,8792,27629,74,65000,576,1000,0.576,597,0.597,173,0.173,67
46735,37771,8964,28229,75,66000,572,1000,0.572,600,0.6,172,0.172,67
47304,38161,9143,28839,76,67000,569,1000,0.569,610,0.61,179,0.179,67
47850,38539,9311,29461,77,68000,546,1000,0.546,622,0.622,168,0.168,67
48444,38984,9460,30016,78,69000,594,1000,0.594,555,0.555,149,0.149,67
49008,39369,9639,30631,79,70000,564,1000,0.564,615,0.615,179,0.179,67
49554,39740,9814,31260,80,71000,546,1000,0.546,629,0.629,175,0.175,67
50114,40146,9968,31854,81,72000,560,1000,0.56,594,0.594,154,0.154,67
50662,40530,10132,32470,82,73000,548,1000,0.548,616,0.616,164,0.164,67
51196,40892,10304,33108,83,74000,534,1000,0.534,638,0.638,172,0.172,67
51732,41250,10482,33750,84,75000,536,1000,0.536,642,0.642,178,0.178,67
52251,41596,10655,34404,85,76000,519,1000,0.519,654,0.654,173,0.173,67
52797,41973,10824,35027,86,77000,546,1000,0.546,623,0.623,169,0.169,67
53341,42354,10987,35646,87,78000,544,1000,0.544,619,0.619,163,0.163,67
53901,42760,11141,36240,88,79000,560,1000,0.56,594,0.594,154,0.154,67
54435,43121,11314,36879,89,80000,534,1000,0.534,639,0.639,173,0.173,67
54956,43461,11495,37539,90,81000,521,1000,0.521,660,0.66,181,0.181,67
55484,43812,11672,38188,91,82000,528,1000,0.528,649,0.649,177,0.177,67
56035,44206,11829,38794,92,83000,551,1000,0.551,606,0.606,157,0.157,67
56546,44544,12002,39456,93,84000,511,1000,0.511,662,0.662,173,0.173,67
57094,44930,12164,40070,94,85000,548,1000,0.548,614,0.614,162,0.162,67
57620,45297,12323,40703,95,86000,526,1000,0.526,633,0.633,159,0.159,67
58143,45650,12493,41350,96,87000,523,1000,0.523,647,0.647,170,0.17,67
58673,46002,12671,41998,97,88000,530,1000,0.53,648,0.648,178,0.178,67
59180,46335,12845,42665,98,89000,507,1000,0.507,667,0.667,174,0.174,67
59712,46707,13005,43293,99,90000,532,1000,0.532,628,0.628,160,0.16,67
60223,47033,13190,43967,100,91000,511,1000,0.511,674,0.674,185,0.185,67
60722,47341,13381,44659,101,92000,499,1000,0.499,692,0.692,191,0.191,67
61233,47686,13547,45314,102,93000,511,1000,0.511,655,0.655,166,0.166,67
61756,48054,13702,45946,103,94000,523,1000,0.523,632,0.632,155,0.155,67
62271,48385,13886,46615,104,95000,515,1000,0.515,669,0.669,184,0.184,67
62759,48695,14064,47305,105,96000,488,1000,0.488,690,0.69,178,0.178,67
63279,49039,14240,47961,106,97000,520,1000,0.52,656,0.656,176,0.176,67
63772,49341,14431,48659,107,98000,493,1000,0.493,698,0.698,191,0.191,67
64279,49665,14614,49335,108,99000,507,1000,0.507,676,0.676,183,0.183,67
64788,50016,14772,49984,109,100000,509,1000,0.509,649,0.649,158,0.158,67
65289,50335,14954,50665,110,101000,501,1000,0.501,681,0.681,182,0.182,67
65802,50673,15129,51327,111,102000,513,1000,0.513,662,0.662,175,0.175,67
66306,51009,15297,51991,112,103000,504,1000,0.504,664,0.664,168,0.168,67
66785,51311,15474,52689,113,104000,479,1000,0.479,698,0.698,177,0.177,67
67294,51638,15656,53362,114,105000,509,1000,0.509,673,0.673,182,0.182,67
67759,51918,15841,54082,115,106000,465,1000,0.465,720,0.72,185,0.185,67
68242,52243,15999,54757,116,107000,483,1000,0.483,675,0.675,158,0.158,67
68740,52563,16177,55437,117,108000,498,1000,0.498,680,0.68,178,0.178,67
69227,52874,16353,56126,118,109000,487,1000,0.487,689,0.689,176,0.176,67
69707,53175,16532,56825,119,110000,480,1000,0.48,699,0.699,179,0.179,67
70233,53548,16685,57452,120,111000,526,1000,0.526,627,0.627,153,0.153,67
70755,53917,16838,58083,121,112000,522,1000,0.522,631,0.631,153,0.153,67
71252,54242,17010,58758,122,113000,497,1000,0.497,675,0.675,172,0.172,67
71726,54544,17182,59456,123,114000,474,1000,0.474,698,0.698,172,0.172,67
71869,54638,17231,59660,124,114298,143,298,0.4798657718120805,204,0.6845637583892618,49,0.1644295302013423,67
99,98,1,2,1,100,NA,NA,NA,NA,NA,NA,NA,68
199,198,1,2,2,200,100,100,1,0,0,0,0,68
297,294,3,6,3,300,98,100,0.98,4,0.04,2,0.02,68
394,388,6,12,4,400,97,100,0.97,6,0.06,3,0.03,68
493,486,7,14,5,500,99,100,0.99,2,0.02,1,0.01,68
592,584,8,16,6,600,99,100,0.99,2,0.02,1,0.01,68
690,680,10,20,7,700,98,100,0.98,4,0.04,2,0.02,68
785,772,13,28,8,800,95,100,0.95,8,0.08,3,0.03,68
884,870,14,30,9,900,99,100,0.99,2,0.02,1,0.01,68
984,970,14,30,10,1000,100,100,1,0,0,0,0,68
1947,1902,45,98,11,2000,963,1000,0.963,68,0.068,31,0.031,68
2887,2793,94,207,12,3000,940,1000,0.94,109,0.109,49,0.049,68
3809,3661,148,339,13,4000,922,1000,0.922,132,0.132,54,0.054,68
4711,4502,209,498,14,5000,902,1000,0.902,159,0.159,61,0.061,68
5587,5295,292,705,15,6000,876,1000,0.876,207,0.207,83,0.083,68
6456,6076,380,924,16,7000,869,1000,0.869,219,0.219,88,0.088,68
7324,6852,472,1148,17,8000,868,1000,0.868,224,0.224,92,0.092,68
8187,7638,549,1362,18,9000,863,1000,0.863,214,0.214,77,0.077,68
9032,8383,649,1617,19,10000,845,1000,0.845,255,0.255,100,0.1,68
9883,9146,737,1854,20,11000,851,1000,0.851,237,0.237,88,0.088,68
10684,9824,860,2176,21,12000,801,1000,0.801,322,0.322,123,0.123,68
11482,10509,973,2491,22,13000,798,1000,0.798,315,0.315,113,0.113,68
12294,11214,1080,2786,23,14000,812,1000,0.812,295,0.295,107,0.107,68
13110,11920,1190,3080,24,15000,816,1000,0.816,294,0.294,110,0.11,68
13862,12543,1319,3457,25,16000,752,1000,0.752,377,0.377,129,0.129,68
14630,13171,1459,3829,26,17000,768,1000,0.768,372,0.372,140,0.14,68
15393,13793,1600,4207,27,18000,763,1000,0.763,378,0.378,141,0.141,68
16177,14453,1724,4547,28,19000,784,1000,0.784,340,0.34,124,0.124,68
16958,15126,1832,4874,29,20000,781,1000,0.781,327,0.327,108,0.108,68
17712,15748,1964,5252,30,21000,754,1000,0.754,378,0.378,132,0.132,68
18468,16375,2093,5625,31,22000,756,1000,0.756,373,0.373,129,0.129,68
19186,16945,2241,6055,32,23000,718,1000,0.718,430,0.43,148,0.148,68
19908,17520,2388,6480,33,24000,722,1000,0.722,425,0.425,147,0.147,68
20635,18108,2527,6892,34,25000,727,1000,0.727,412,0.412,139,0.139,68
21331,18657,2674,7343,35,26000,696,1000,0.696,451,0.451,147,0.147,68
22049,19230,2819,7770,36,27000,718,1000,0.718,427,0.427,145,0.145,68
22761,19789,2972,8211,37,28000,712,1000,0.712,441,0.441,153,0.153,68
23489,20387,3102,8613,38,29000,728,1000,0.728,402,0.402,130,0.13,68
24224,21000,3224,9000,39,30000,735,1000,0.735,387,0.387,122,0.122,68
24921,21554,3367,9446,40,31000,697,1000,0.697,446,0.446,143,0.143,68
25602,22086,3516,9914,41,32000,681,1000,0.681,468,0.468,149,0.149,68
26272,22598,3674,10402,42,33000,670,1000,0.67,488,0.488,158,0.158,68
26929,23097,3832,10903,43,34000,657,1000,0.657,501,0.501,158,0.158,68
27611,23630,3981,11370,44,35000,682,1000,0.682,467,0.467,149,0.149,68
28261,24103,4158,11897,45,36000,650,1000,0.65,527,0.527,177,0.177,68
28914,24598,4316,12402,46,37000,653,1000,0.653,505,0.505,158,0.158,68
29577,25126,4451,12874,47,38000,663,1000,0.663,472,0.472,135,0.135,68
30242,25649,4593,13351,48,39000,665,1000,0.665,477,0.477,142,0.142,68
30911,26172,4739,13828,49,40000,669,1000,0.669,477,0.477,146,0.146,68
31577,26694,4883,14306,50,41000,666,1000,0.666,478,0.478,144,0.144,68
32212,27160,5052,14840,51,42000,635,1000,0.635,534,0.534,169,0.169,68
32838,27613,5225,15387,52,43000,626,1000,0.626,547,0.547,173,0.173,68
33499,28121,5378,15879,53,44000,661,1000,0.661,492,0.492,153,0.153,68
34149,28610,5539,16390,54,45000,650,1000,0.65,511,0.511,161,0.161,68
34766,29055,5711,16945,55,46000,617,1000,0.617,555,0.555,172,0.172,68
35391,29509,5882,17491,56,47000,625,1000,0.625,546,0.546,171,0.171,68
36007,29953,6054,18047,57,48000,616,1000,0.616,556,0.556,172,0.172,68
36629,30424,6205,18576,58,49000,622,1000,0.622,529,0.529,151,0.151,68
37272,30921,6351,19079,59,50000,643,1000,0.643,503,0.503,146,0.146,68
37902,31408,6494,19592,60,51000,630,1000,0.63,513,0.513,143,0.143,68
38510,31858,6652,20142,61,52000,608,1000,0.608,550,0.55,158,0.158,68
39102,32276,6826,20724,62,53000,592,1000,0.592,582,0.582,174,0.174,68
39697,32707,6990,21293,63,54000,595,1000,0.595,569,0.569,164,0.164,68
40306,33132,7174,21868,64,55000,609,1000,0.609,575,0.575,184,0.184,68
40893,33551,7342,22449,65,56000,587,1000,0.587,581,0.581,168,0.168,68
41503,33975,7528,23025,66,57000,610,1000,0.61,576,0.576,186,0.186,68
42068,34361,7707,23639,67,58000,565,1000,0.565,614,0.614,179,0.179,68
42672,34803,7869,24197,68,59000,604,1000,0.604,558,0.558,162,0.162,68
43265,35248,8017,24752,69,60000,593,1000,0.593,555,0.555,148,0.148,68
43867,35682,8185,25318,70,61000,602,1000,0.602,566,0.566,168,0.168,68
44450,36096,8354,25904,71,62000,583,1000,0.583,586,0.586,169,0.169,68
45026,36504,8522,26496,72,63000,576,1000,0.576,592,0.592,168,0.168,68
45602,36929,8673,27071,73,64000,576,1000,0.576,575,0.575,151,0.151,68
46186,37346,8840,27654,74,65000,584,1000,0.584,583,0.583,167,0.167,68
46775,37759,9016,28241,75,66000,589,1000,0.589,587,0.587,176,0.176,68
47332,38143,9189,28857,76,67000,557,1000,0.557,616,0.616,173,0.173,68
47905,38567,9338,29433,77,68000,573,1000,0.573,576,0.576,149,0.149,68
48485,38999,9486,30001,78,69000,580,1000,0.58,568,0.568,148,0.148,68
49039,39383,9656,30617,79,70000,554,1000,0.554,616,0.616,170,0.17,68
49597,39751,9846,31249,80,71000,558,1000,0.558,632,0.632,190,0.19,68
50148,40140,10008,31860,81,72000,551,1000,0.551,611,0.611,162,0.162,68
50711,40548,10163,32452,82,73000,563,1000,0.563,592,0.592,155,0.155,68
51290,40969,10321,33031,83,74000,579,1000,0.579,579,0.579,158,0.158,68
51848,41364,10484,33636,84,75000,558,1000,0.558,605,0.605,163,0.163,68
52387,41723,10664,34277,85,76000,539,1000,0.539,641,0.641,180,0.18,68
52930,42103,10827,34897,86,77000,543,1000,0.543,620,0.62,163,0.163,68
53476,42481,10995,35519,87,78000,546,1000,0.546,622,0.622,168,0.168,68
54017,42846,11171,36154,88,79000,541,1000,0.541,635,0.635,176,0.176,68
54556,43216,11340,36784,89,80000,539,1000,0.539,630,0.63,169,0.169,68
55112,43612,11500,37388,90,81000,556,1000,0.556,604,0.604,160,0.16,68
55675,44014,11661,37986,91,82000,563,1000,0.563,598,0.598,161,0.161,68
56197,44357,11840,38643,92,83000,522,1000,0.522,657,0.657,179,0.179,68
56729,44709,12020,39291,93,84000,532,1000,0.532,648,0.648,180,0.18,68
57249,45056,12193,39944,94,85000,520,1000,0.52,653,0.653,173,0.173,68
57758,45402,12356,40598,95,86000,509,1000,0.509,654,0.654,163,0.163,68
58279,45755,12524,41245,96,87000,521,1000,0.521,647,0.647,168,0.168,68
58821,46128,12693,41872,97,88000,542,1000,0.542,627,0.627,169,0.169,68
59327,46465,12862,42535,98,89000,506,1000,0.506,663,0.663,169,0.169,68
59847,46807,13040,43193,99,90000,520,1000,0.52,658,0.658,178,0.178,68
60382,47169,13213,43831,100,91000,535,1000,0.535,638,0.638,173,0.173,68
60883,47491,13392,44509,101,92000,501,1000,0.501,678,0.678,179,0.179,68
61389,47825,13564,45175,102,93000,506,1000,0.506,666,0.666,172,0.172,68
61944,48222,13722,45778,103,94000,555,1000,0.555,603,0.603,158,0.158,68
62461,48562,13899,46438,104,95000,517,1000,0.517,660,0.66,177,0.177,68
62956,48886,14070,47114,105,96000,495,1000,0.495,676,0.676,171,0.171,68
63429,49175,14254,47825,106,97000,473,1000,0.473,711,0.711,184,0.184,68
63896,49448,14448,48552,107,98000,467,1000,0.467,727,0.727,194,0.194,68
64398,49789,14609,49211,108,99000,502,1000,0.502,659,0.659,161,0.161,68
64874,50097,14777,49903,109,100000,476,1000,0.476,692,0.692,168,0.168,68
65395,50462,14933,50538,110,101000,521,1000,0.521,635,0.635,156,0.156,68
65884,50769,15115,51231,111,102000,489,1000,0.489,693,0.693,182,0.182,68
66405,51106,15299,51894,112,103000,521,1000,0.521,663,0.663,184,0.184,68
66914,51434,15480,52566,113,104000,509,1000,0.509,672,0.672,181,0.181,68
67387,51740,15647,53260,114,105000,473,1000,0.473,694,0.694,167,0.167,68
67861,52036,15825,53964,115,106000,474,1000,0.474,704,0.704,178,0.178,68
68372,52380,15992,54620,116,107000,511,1000,0.511,656,0.656,167,0.167,68
68855,52710,16145,55290,117,108000,483,1000,0.483,670,0.67,153,0.153,68
69339,53015,16324,55985,118,109000,484,1000,0.484,695,0.695,179,0.179,68
69829,53350,16479,56650,119,110000,490,1000,0.49,665,0.665,155,0.155,68
70286,53613,16673,57387,120,111000,457,1000,0.457,737,0.737,194,0.194,68
70770,53917,16853,58083,121,112000,484,1000,0.484,696,0.696,180,0.18,68
71276,54266,17010,58734,122,113000,506,1000,0.506,651,0.651,157,0.157,68
71727,54543,17184,59457,123,114000,451,1000,0.451,723,0.723,174,0.174,68
71869,54638,17231,59660,124,114298,142,298,0.47651006711409394,203,0.6812080536912751,47,0.15771812080536912,68
100,100,0,0,1,100,NA,NA,NA,NA,NA,NA,NA,69
200,200,0,0,2,200,100,100,1,0,0,0,0,69
300,300,0,0,3,300,100,100,1,0,0,0,0,69
400,400,0,0,4,400,100,100,1,0,0,0,0,69
500,500,0,0,5,500,100,100,1,0,0,0,0,69
599,598,1,2,6,600,99,100,0.99,2,0.02,1,0.01,69
691,683,8,17,7,700,92,100,0.92,15,0.15,7,0.07,69
788,777,11,23,8,800,97,100,0.97,6,0.06,3,0.03,69
885,872,13,28,9,900,97,100,0.97,5,0.05,2,0.02,69
979,960,19,40,10,1000,94,100,0.94,12,0.12,6,0.06,69
1937,1885,52,115,11,2000,958,1000,0.958,75,0.075,33,0.033,69
2866,2762,104,238,12,3000,929,1000,0.929,123,0.123,52,0.052,69
3781,3618,163,382,13,4000,915,1000,0.915,144,0.144,59,0.059,69
4681,4453,228,547,14,5000,900,1000,0.9,165,0.165,65,0.065,69
5561,5257,304,743,15,6000,880,1000,0.88,196,0.196,76,0.076,69
6432,6052,380,948,16,7000,871,1000,0.871,205,0.205,76,0.076,69
7282,6801,481,1199,17,8000,850,1000,0.85,251,0.251,101,0.101,69
8115,7537,578,1463,18,9000,833,1000,0.833,264,0.264,97,0.097,69
8954,8286,668,1714,19,10000,839,1000,0.839,251,0.251,90,0.09,69
9775,8983,792,2017,20,11000,821,1000,0.821,303,0.303,124,0.124,69
10612,9731,881,2269,21,12000,837,1000,0.837,252,0.252,89,0.089,69
11432,10438,994,2562,22,13000,820,1000,0.82,293,0.293,113,0.113,69
12270,11177,1093,2823,23,14000,838,1000,0.838,261,0.261,99,0.099,69
13061,11845,1216,3155,24,15000,791,1000,0.791,332,0.332,123,0.123,69
13865,12528,1337,3472,25,16000,804,1000,0.804,317,0.317,121,0.121,69
14667,13223,1444,3777,26,17000,802,1000,0.802,305,0.305,107,0.107,69
15425,13845,1580,4155,27,18000,758,1000,0.758,378,0.378,136,0.136,69
16191,14483,1708,4517,28,19000,766,1000,0.766,362,0.362,128,0.128,69
16933,15079,1854,4921,29,20000,742,1000,0.742,404,0.404,146,0.146,69
17694,15713,1981,5287,30,21000,761,1000,0.761,366,0.366,127,0.127,69
18421,16289,2132,5711,31,22000,727,1000,0.727,424,0.424,151,0.151,69
19141,16848,2293,6152,32,23000,720,1000,0.72,441,0.441,161,0.161,69
19865,17437,2428,6563,33,24000,724,1000,0.724,411,0.411,135,0.135,69
20602,18043,2559,6957,34,25000,737,1000,0.737,394,0.394,131,0.131,69
21311,18620,2691,7380,35,26000,709,1000,0.709,423,0.423,132,0.132,69
22031,19208,2823,7792,36,27000,720,1000,0.72,412,0.412,132,0.132,69
22742,19773,2969,8227,37,28000,711,1000,0.711,435,0.435,146,0.146,69
23428,20311,3117,8689,38,29000,686,1000,0.686,462,0.462,148,0.148,69
24112,20848,3264,9152,39,30000,684,1000,0.684,463,0.463,147,0.147,69
24815,21420,3395,9580,40,31000,703,1000,0.703,428,0.428,131,0.131,69
25513,21971,3542,10029,41,32000,698,1000,0.698,449,0.449,147,0.147,69
26205,22517,3688,10483,42,33000,692,1000,0.692,454,0.454,146,0.146,69
26897,23052,3845,10948,43,34000,692,1000,0.692,465,0.465,157,0.157,69
27580,23602,3978,11398,44,35000,683,1000,0.683,450,0.45,133,0.133,69
28247,24122,4125,11878,45,36000,667,1000,0.667,480,0.48,147,0.147,69
28917,24637,4280,12363,46,37000,670,1000,0.67,485,0.485,155,0.155,69
29583,25152,4431,12848,47,38000,666,1000,0.666,485,0.485,151,0.151,69
30224,25623,4601,13377,48,39000,641,1000,0.641,529,0.529,170,0.17,69
30885,26126,4759,13874,49,40000,661,1000,0.661,497,0.497,158,0.158,69
31555,26642,4913,14358,50,41000,670,1000,0.67,484,0.484,154,0.154,69
32180,27090,5090,14910,51,42000,625,1000,0.625,552,0.552,177,0.177,69
32825,27593,5232,15407,52,43000,645,1000,0.645,497,0.497,142,0.142,69
33444,28036,5408,15964,53,44000,619,1000,0.619,557,0.557,176,0.176,69
34092,28533,5559,16467,54,45000,648,1000,0.648,503,0.503,151,0.151,69
34749,29036,5713,16964,55,46000,657,1000,0.657,497,0.497,154,0.154,69
35381,29506,5875,17494,56,47000,632,1000,0.632,530,0.53,162,0.162,69
35988,29928,6060,18072,57,48000,607,1000,0.607,578,0.578,185,0.185,69
36603,30385,6218,18615,58,49000,615,1000,0.615,543,0.543,158,0.158,69
37239,30845,6394,19155,59,50000,636,1000,0.636,540,0.54,176,0.176,69
37867,31291,6576,19709,60,51000,628,1000,0.628,554,0.554,182,0.182,69
38483,31740,6743,20260,61,52000,616,1000,0.616,551,0.551,167,0.167,69
39091,32189,6902,20811,62,53000,608,1000,0.608,551,0.551,159,0.159,69
39683,32626,7057,21374,63,54000,592,1000,0.592,563,0.563,155,0.155,69
40274,33062,7212,21938,64,55000,591,1000,0.591,564,0.564,155,0.155,69
40830,33425,7405,22575,65,56000,556,1000,0.556,637,0.637,193,0.193,69
41415,33835,7580,23165,66,57000,585,1000,0.585,590,0.59,175,0.175,69
42029,34311,7718,23689,67,58000,614,1000,0.614,524,0.524,138,0.138,69
42625,34739,7886,24261,68,59000,596,1000,0.596,572,0.572,168,0.168,69
43214,35181,8033,24819,69,60000,589,1000,0.589,558,0.558,147,0.147,69
43772,35552,8220,25448,70,61000,558,1000,0.558,629,0.629,187,0.187,69
44356,35980,8376,26020,71,62000,584,1000,0.584,572,0.572,156,0.156,69
44958,36436,8522,26564,72,63000,602,1000,0.602,544,0.544,146,0.146,69
45541,36866,8675,27134,73,64000,583,1000,0.583,570,0.57,153,0.153,69
46124,37284,8840,27716,74,65000,583,1000,0.583,582,0.582,165,0.165,69
46670,37648,9022,28352,75,66000,546,1000,0.546,636,0.636,182,0.182,69
47230,38024,9206,28976,76,67000,560,1000,0.56,624,0.624,184,0.184,69
47789,38432,9357,29568,77,68000,559,1000,0.559,592,0.592,151,0.151,69
48364,38850,9514,30150,78,69000,575,1000,0.575,582,0.582,157,0.157,69
48960,39285,9675,30715,79,70000,596,1000,0.596,565,0.565,161,0.161,69
49509,39649,9860,31351,80,71000,549,1000,0.549,636,0.636,185,0.185,69
50088,40071,10017,31929,81,72000,579,1000,0.579,578,0.578,157,0.157,69
50646,40463,10183,32537,82,73000,558,1000,0.558,608,0.608,166,0.166,69
51200,40851,10349,33149,83,74000,554,1000,0.554,612,0.612,166,0.166,69
51763,41246,10517,33754,84,75000,563,1000,0.563,605,0.605,168,0.168,69
52319,41631,10688,34369,85,76000,556,1000,0.556,615,0.615,171,0.171,69
52847,41994,10853,35006,86,77000,528,1000,0.528,637,0.637,165,0.165,69
53393,42369,11024,35631,87,78000,546,1000,0.546,625,0.625,171,0.171,69
53910,42691,11219,36309,88,79000,517,1000,0.517,678,0.678,195,0.195,69
54450,43067,11383,36933,89,80000,540,1000,0.54,624,0.624,164,0.164,69
54980,43429,11551,37571,90,81000,530,1000,0.53,638,0.638,168,0.168,69
55527,43813,11714,38187,91,82000,547,1000,0.547,616,0.616,163,0.163,69
56068,44176,11892,38824,92,83000,541,1000,0.541,637,0.637,178,0.178,69
56612,44564,12048,39436,93,84000,544,1000,0.544,612,0.612,156,0.156,69
57159,44941,12218,40059,94,85000,547,1000,0.547,623,0.623,170,0.17,69
57710,45331,12379,40669,95,86000,551,1000,0.551,610,0.61,161,0.161,69
58248,45701,12547,41299,96,87000,538,1000,0.538,630,0.63,168,0.168,69
58772,46060,12712,41940,97,88000,524,1000,0.524,641,0.641,165,0.165,69
59300,46439,12861,42561,98,89000,528,1000,0.528,621,0.621,149,0.149,69
59831,46804,13027,43196,99,90000,531,1000,0.531,635,0.635,166,0.166,69
60338,47135,13203,43865,100,91000,507,1000,0.507,669,0.669,176,0.176,69
60858,47488,13370,44512,101,92000,520,1000,0.52,647,0.647,167,0.167,69
61392,47855,13537,45145,102,93000,534,1000,0.534,633,0.633,167,0.167,69
61921,48206,13715,45794,103,94000,529,1000,0.529,649,0.649,178,0.178,69
62405,48514,13891,46486,104,95000,484,1000,0.484,692,0.692,176,0.176,69
62895,48823,14072,47177,105,96000,490,1000,0.49,691,0.691,181,0.181,69
63391,49149,14242,47851,106,97000,496,1000,0.496,674,0.674,170,0.17,69
63889,49455,14434,48545,107,98000,498,1000,0.498,694,0.694,192,0.192,69
64404,49822,14582,49178,108,99000,515,1000,0.515,633,0.633,148,0.148,69
64923,50175,14748,49825,109,100000,519,1000,0.519,647,0.647,166,0.166,69
65418,50504,14914,50496,110,101000,495,1000,0.495,671,0.671,166,0.166,69
65940,50866,15074,51134,111,102000,522,1000,0.522,638,0.638,160,0.16,69
66444,51199,15245,51801,112,103000,504,1000,0.504,667,0.667,171,0.171,69
66940,51527,15413,52473,113,104000,496,1000,0.496,672,0.672,168,0.168,69
67446,51864,15582,53136,114,105000,506,1000,0.506,663,0.663,169,0.169,69
67923,52163,15760,53837,115,106000,477,1000,0.477,701,0.701,178,0.178,69
68395,52436,15959,54564,116,107000,472,1000,0.472,727,0.727,199,0.199,69
68904,52790,16114,55210,117,108000,509,1000,0.509,646,0.646,155,0.155,69
69386,53098,16288,55902,118,109000,482,1000,0.482,692,0.692,174,0.174,69
69881,53413,16468,56587,119,110000,495,1000,0.495,685,0.685,180,0.18,69
70337,53693,16644,57307,120,111000,456,1000,0.456,720,0.72,176,0.176,69
70794,53972,16822,58028,121,112000,457,1000,0.457,721,0.721,178,0.178,69
71261,54263,16998,58737,122,113000,467,1000,0.467,709,0.709,176,0.176,69
71736,54568,17168,59432,123,114000,475,1000,0.475,695,0.695,170,0.17,69
71869,54638,17231,59660,124,114298,133,298,0.4463087248322148,228,0.7651006711409396,63,0.21140939597315436,69
99,98,1,2,1,100,NA,NA,NA,NA,NA,NA,NA,70
199,198,1,2,2,200,100,100,1,0,0,0,0,70
298,296,2,4,3,300,99,100,0.99,2,0.02,1,0.01,70
396,393,3,7,4,400,98,100,0.98,3,0.03,1,0.01,70
495,491,4,9,5,500,99,100,0.99,2,0.02,1,0.01,70
592,585,7,15,6,600,97,100,0.97,6,0.06,3,0.03,70
689,680,9,20,7,700,97,100,0.97,5,0.05,2,0.02,70
787,776,11,24,8,800,98,100,0.98,4,0.04,2,0.02,70
881,865,16,35,9,900,94,100,0.94,11,0.11,5,0.05,70
976,956,20,44,10,1000,95,100,0.95,9,0.09,4,0.04,70
1930,1878,52,122,11,2000,954,1000,0.954,78,0.078,32,0.032,70
2851,2741,110,259,12,3000,921,1000,0.921,137,0.137,58,0.058,70
3781,3620,161,380,13,4000,930,1000,0.93,121,0.121,51,0.051,70
4674,4436,238,564,14,5000,893,1000,0.893,184,0.184,77,0.077,70
5568,5268,300,732,15,6000,894,1000,0.894,168,0.168,62,0.062,70
6439,6057,382,943,16,7000,871,1000,0.871,211,0.211,82,0.082,70
7308,6852,456,1148,17,8000,869,1000,0.869,205,0.205,74,0.074,70
8144,7592,552,1408,18,9000,836,1000,0.836,260,0.26,96,0.096,70
9006,8371,635,1629,19,10000,862,1000,0.862,221,0.221,83,0.083,70
9842,9103,739,1897,20,11000,836,1000,0.836,268,0.268,104,0.104,70
10655,9801,854,2199,21,12000,813,1000,0.813,302,0.302,115,0.115,70
11469,10500,969,2500,22,13000,814,1000,0.814,301,0.301,115,0.115,70
12257,11160,1097,2840,23,14000,788,1000,0.788,340,0.34,128,0.128,70
13048,11830,1218,3170,24,15000,791,1000,0.791,330,0.33,121,0.121,70
13833,12499,1334,3501,25,16000,785,1000,0.785,331,0.331,116,0.116,70
14594,13133,1461,3867,26,17000,761,1000,0.761,366,0.366,127,0.127,70
15338,13741,1597,4259,27,18000,744,1000,0.744,392,0.392,136,0.136,70
16109,14412,1697,4588,28,19000,771,1000,0.771,329,0.329,100,0.1,70
16875,15058,1817,4942,29,20000,766,1000,0.766,354,0.354,120,0.12,70
17627,15680,1947,5320,30,21000,752,1000,0.752,378,0.378,130,0.13,70
18405,16350,2055,5650,31,22000,778,1000,0.778,330,0.33,108,0.108,70
19136,16932,2204,6068,32,23000,731,1000,0.731,418,0.418,149,0.149,70
19886,17546,2340,6454,33,24000,750,1000,0.75,386,0.386,136,0.136,70
20620,18142,2478,6858,34,25000,734,1000,0.734,404,0.404,138,0.138,70
21340,18730,2610,7270,35,26000,720,1000,0.72,412,0.412,132,0.132,70
22057,19301,2756,7699,36,27000,717,1000,0.717,429,0.429,146,0.146,70
22789,19909,2880,8091,37,28000,732,1000,0.732,392,0.392,124,0.124,70
23502,20486,3016,8514,38,29000,713,1000,0.713,423,0.423,136,0.136,70
24219,21054,3165,8946,39,30000,717,1000,0.717,432,0.432,149,0.149,70
24900,21577,3323,9423,40,31000,681,1000,0.681,477,0.477,158,0.158,70
25598,22143,3455,9857,41,32000,698,1000,0.698,434,0.434,132,0.132,70
26279,22661,3618,10339,42,33000,681,1000,0.681,482,0.482,163,0.163,70
26970,23213,3757,10787,43,34000,691,1000,0.691,448,0.448,139,0.139,70
27646,23746,3900,11254,44,35000,676,1000,0.676,467,0.467,143,0.143,70
28315,24276,4039,11724,45,36000,669,1000,0.669,470,0.47,139,0.139,70
28999,24798,4201,12202,46,37000,684,1000,0.684,478,0.478,162,0.162,70
29648,25287,4361,12713,47,38000,649,1000,0.649,511,0.511,160,0.16,70
30296,25774,4522,13226,48,39000,648,1000,0.648,513,0.513,161,0.161,70
30943,26261,4682,13739,49,40000,647,1000,0.647,513,0.513,160,0.16,70
31579,26724,4855,14276,50,41000,636,1000,0.636,537,0.537,173,0.173,70
32235,27215,5020,14785,51,42000,656,1000,0.656,509,0.509,165,0.165,70
32908,27735,5173,15265,52,43000,673,1000,0.673,480,0.48,153,0.153,70
33543,28207,5336,15793,53,44000,635,1000,0.635,528,0.528,163,0.163,70
34159,28658,5501,16342,54,45000,616,1000,0.616,549,0.549,165,0.165,70
34803,29144,5659,16856,55,46000,644,1000,0.644,514,0.514,158,0.158,70
35426,29596,5830,17404,56,47000,623,1000,0.623,548,0.548,171,0.171,70
36025,30037,5988,17963,57,48000,599,1000,0.599,559,0.559,158,0.158,70
36658,30512,6146,18488,58,49000,633,1000,0.633,525,0.525,158,0.158,70
37281,30988,6293,19012,59,50000,623,1000,0.623,524,0.524,147,0.147,70
37939,31504,6435,19496,60,51000,658,1000,0.658,484,0.484,142,0.142,70
38556,31972,6584,20028,61,52000,617,1000,0.617,532,0.532,149,0.149,70
39156,32418,6738,20582,62,53000,600,1000,0.6,554,0.554,154,0.154,70
39771,32866,6905,21134,63,54000,615,1000,0.615,552,0.552,167,0.167,70
40381,33313,7068,21687,64,55000,610,1000,0.61,553,0.553,163,0.163,70
40960,33681,7279,22319,65,56000,579,1000,0.579,632,0.632,211,0.211,70
41582,34146,7436,22854,66,57000,622,1000,0.622,535,0.535,157,0.157,70
42155,34540,7615,23460,67,58000,573,1000,0.573,606,0.606,179,0.179,70
42734,34937,7797,24063,68,59000,579,1000,0.579,603,0.603,182,0.182,70
43282,35310,7972,24690,69,60000,548,1000,0.548,627,0.627,175,0.175,70
43864,35724,8140,25276,70,61000,582,1000,0.582,586,0.586,168,0.168,70
44452,36138,8314,25862,71,62000,588,1000,0.588,586,0.586,174,0.174,70
45009,36527,8482,26473,72,63000,557,1000,0.557,611,0.611,168,0.168,70
45589,36953,8636,27047,73,64000,580,1000,0.58,574,0.574,154,0.154,70
46152,37350,8802,27650,74,65000,563,1000,0.563,603,0.603,166,0.166,70
46698,37715,8983,28285,75,66000,546,1000,0.546,635,0.635,181,0.181,70
47288,38148,9140,28852,76,67000,590,1000,0.59,567,0.567,157,0.157,70
47868,38560,9308,29440,77,68000,580,1000,0.58,588,0.588,168,0.168,70
48431,38955,9476,30045,78,69000,563,1000,0.563,605,0.605,168,0.168,70
48975,39314,9661,30686,79,70000,544,1000,0.544,641,0.641,185,0.185,70
49589,39773,9816,31227,80,71000,614,1000,0.614,541,0.541,155,0.155,70
50183,40211,9972,31789,81,72000,594,1000,0.594,562,0.562,156,0.156,70
50704,40552,10152,32448,82,73000,521,1000,0.521,659,0.659,180,0.18,70
51267,40958,10309,33042,83,74000,563,1000,0.563,594,0.594,157,0.157,70
51817,41351,10466,33649,84,75000,550,1000,0.55,607,0.607,157,0.157,70
52335,41684,10651,34316,85,76000,518,1000,0.518,667,0.667,185,0.185,70
52867,42046,10821,34954,86,77000,532,1000,0.532,638,0.638,170,0.17,70
53425,42444,10981,35556,87,78000,558,1000,0.558,602,0.602,160,0.16,70
53963,42811,11152,36189,88,79000,538,1000,0.538,633,0.633,171,0.171,70
54511,43196,11315,36804,89,80000,548,1000,0.548,615,0.615,163,0.163,70
55018,43537,11481,37463,90,81000,507,1000,0.507,659,0.659,166,0.166,70
55558,43913,11645,38087,91,82000,540,1000,0.54,624,0.624,164,0.164,70
56119,44315,11804,38685,92,83000,561,1000,0.561,598,0.598,159,0.159,70
56658,44658,12000,39342,93,84000,539,1000,0.539,657,0.657,196,0.196,70
57203,45030,12173,39970,94,85000,545,1000,0.545,628,0.628,173,0.173,70
57725,45383,12342,40617,95,86000,522,1000,0.522,647,0.647,169,0.169,70
58241,45729,12512,41271,96,87000,516,1000,0.516,654,0.654,170,0.17,70
58782,46107,12675,41893,97,88000,541,1000,0.541,622,0.622,163,0.163,70
59293,46439,12854,42561,98,89000,511,1000,0.511,668,0.668,179,0.179,70
59802,46780,13022,43220,99,90000,509,1000,0.509,659,0.659,168,0.168,70
60330,47150,13180,43850,100,91000,528,1000,0.528,630,0.63,158,0.158,70
60867,47510,13357,44490,101,92000,537,1000,0.537,640,0.64,177,0.177,70
61383,47858,13525,45142,102,93000,516,1000,0.516,652,0.652,168,0.168,70
61877,48166,13711,45834,103,94000,494,1000,0.494,692,0.692,186,0.186,70
62392,48519,13873,46481,104,95000,515,1000,0.515,647,0.647,162,0.162,70
62897,48854,14043,47146,105,96000,505,1000,0.505,665,0.665,170,0.17,70
63389,49164,14225,47836,106,97000,492,1000,0.492,690,0.69,182,0.182,70
63893,49485,14408,48515,107,98000,504,1000,0.504,679,0.679,183,0.183,70
64379,49808,14571,49192,108,99000,486,1000,0.486,677,0.677,163,0.163,70
64870,50126,14744,49874,109,100000,491,1000,0.491,682,0.682,173,0.173,70
65387,50466,14921,50534,110,101000,517,1000,0.517,660,0.66,177,0.177,70
65887,50774,15113,51226,111,102000,500,1000,0.5,692,0.692,192,0.192,70
66389,51103,15286,51897,112,103000,502,1000,0.502,671,0.671,173,0.173,70
66892,51432,15460,52568,113,104000,503,1000,0.503,671,0.671,174,0.174,70
67390,51756,15634,53244,114,105000,498,1000,0.498,676,0.676,174,0.174,70
67876,52046,15830,53954,115,106000,486,1000,0.486,710,0.71,196,0.196,70
68368,52379,15989,54621,116,107000,492,1000,0.492,667,0.667,159,0.159,70
68875,52727,16148,55273,117,108000,507,1000,0.507,652,0.652,159,0.159,70
69359,53045,16314,55955,118,109000,484,1000,0.484,682,0.682,166,0.166,70
69828,53334,16494,56666,119,110000,469,1000,0.469,711,0.711,180,0.18,70
70302,53633,16669,57367,120,111000,474,1000,0.474,701,0.701,175,0.175,70
70774,53941,16833,58059,121,112000,472,1000,0.472,692,0.692,164,0.164,70
71254,54250,17004,58750,122,113000,480,1000,0.48,691,0.691,171,0.171,70
71733,54557,17176,59443,123,114000,479,1000,0.479,693,0.693,172,0.172,70
71869,54638,17231,59660,124,114298,136,298,0.4563758389261745,217,0.7281879194630873,55,0.18456375838926176,70
100,100,0,0,1,100,NA,NA,NA,NA,NA,NA,NA,71
199,198,1,2,2,200,99,100,0.99,2,0.02,1,0.01,71
299,298,1,2,3,300,100,100,1,0,0,0,0,71
398,397,1,3,4,400,99,100,0.99,1,0.01,0,0,71
497,495,2,5,5,500,99,100,0.99,2,0.02,1,0.01,71
596,593,3,7,6,600,99,100,0.99,2,0.02,1,0.01,71
694,689,5,11,7,700,98,100,0.98,4,0.04,2,0.02,71
792,786,6,14,8,800,98,100,0.98,3,0.03,1,0.01,71
888,879,9,21,9,900,96,100,0.96,7,0.07,3,0.03,71
983,970,13,30,10,1000,95,100,0.95,9,0.09,4,0.04,71
1939,1898,41,102,11,2000,956,1000,0.956,72,0.072,28,0.028,71
2878,2788,90,212,12,3000,939,1000,0.939,110,0.11,49,0.049,71
3779,3622,157,378,13,4000,901,1000,0.901,166,0.166,67,0.067,71
4685,4461,224,539,14,5000,906,1000,0.906,161,0.161,67,0.067,71
5583,5300,283,700,15,6000,898,1000,0.898,161,0.161,59,0.059,71
6457,6078,379,922,16,7000,874,1000,0.874,222,0.222,96,0.096,71
7315,6858,457,1142,17,8000,858,1000,0.858,220,0.22,78,0.078,71
8133,7572,561,1428,18,9000,818,1000,0.818,286,0.286,104,0.104,71
8974,8326,648,1674,19,10000,841,1000,0.841,246,0.246,87,0.087,71
9802,9053,749,1947,20,11000,828,1000,0.828,273,0.273,101,0.101,71
10623,9779,844,2221,21,12000,821,1000,0.821,274,0.274,95,0.095,71
11452,10498,954,2502,22,13000,829,1000,0.829,281,0.281,110,0.11,71
12257,11174,1083,2826,23,14000,805,1000,0.805,324,0.324,129,0.129,71
13058,11861,1197,3139,24,15000,801,1000,0.801,313,0.313,114,0.114,71
13828,12498,1330,3502,25,16000,770,1000,0.77,363,0.363,133,0.133,71
14614,13162,1452,3838,26,17000,786,1000,0.786,336,0.336,122,0.122,71
15402,13832,1570,4168,27,18000,788,1000,0.788,330,0.33,118,0.118,71
16174,14494,1680,4506,28,19000,772,1000,0.772,338,0.338,110,0.11,71
16956,15166,1790,4834,29,20000,782,1000,0.782,328,0.328,110,0.11,71
17692,15769,1923,5231,30,21000,736,1000,0.736,397,0.397,133,0.133,71
18414,16347,2067,5653,31,22000,722,1000,0.722,422,0.422,144,0.144,71
19142,16936,2206,6064,32,23000,728,1000,0.728,411,0.411,139,0.139,71
19875,17538,2337,6462,33,24000,733,1000,0.733,398,0.398,131,0.131,71
20580,18090,2490,6910,34,25000,705,1000,0.705,448,0.448,153,0.153,71
21287,18650,2637,7350,35,26000,707,1000,0.707,440,0.44,147,0.147,71
22007,19232,2775,7768,36,27000,720,1000,0.72,418,0.418,138,0.138,71
22713,19790,2923,8210,37,28000,706,1000,0.706,442,0.442,148,0.148,71
23433,20367,3066,8633,38,29000,720,1000,0.72,423,0.423,143,0.143,71
24124,20905,3219,9095,39,30000,691,1000,0.691,462,0.462,153,0.153,71
24823,21461,3362,9539,40,31000,699,1000,0.699,444,0.444,143,0.143,71
25509,21999,3510,10001,41,32000,686,1000,0.686,462,0.462,148,0.148,71
26183,22501,3682,10499,42,33000,674,1000,0.674,498,0.498,172,0.172,71
26845,23005,3840,10995,43,34000,662,1000,0.662,496,0.496,158,0.158,71
27534,23551,3983,11449,44,35000,689,1000,0.689,454,0.454,143,0.143,71
28195,24059,4136,11941,45,36000,661,1000,0.661,492,0.492,153,0.153,71
28857,24563,4294,12437,46,37000,662,1000,0.662,496,0.496,158,0.158,71
29545,25112,4433,12888,47,38000,688,1000,0.688,451,0.451,139,0.139,71
30202,25606,4596,13394,48,39000,657,1000,0.657,506,0.506,163,0.163,71
30847,26074,4773,13926,49,40000,645,1000,0.645,532,0.532,177,0.177,71
31487,26535,4952,14465,50,41000,640,1000,0.64,539,0.539,179,0.179,71
32120,27005,5115,14995,51,42000,633,1000,0.633,530,0.53,163,0.163,71
32756,27495,5261,15505,52,43000,636,1000,0.636,510,0.51,146,0.146,71
33389,27958,5431,16042,53,44000,633,1000,0.633,537,0.537,170,0.17,71
34001,28398,5603,16602,54,45000,612,1000,0.612,560,0.56,172,0.172,71
34649,28880,5769,17120,55,46000,648,1000,0.648,518,0.518,166,0.166,71
35297,29361,5936,17639,56,47000,648,1000,0.648,519,0.519,167,0.167,71
35931,29843,6088,18157,57,48000,634,1000,0.634,518,0.518,152,0.152,71
36545,30300,6245,18700,58,49000,614,1000,0.614,543,0.543,157,0.157,71
37161,30752,6409,19248,59,50000,616,1000,0.616,548,0.548,164,0.164,71
37801,31239,6562,19761,60,51000,640,1000,0.64,513,0.513,153,0.153,71
38416,31702,6714,20298,61,52000,615,1000,0.615,537,0.537,152,0.152,71
39030,32175,6855,20825,62,53000,614,1000,0.614,527,0.527,141,0.141,71
39647,32630,7017,21370,63,54000,617,1000,0.617,545,0.545,162,0.162,71
40279,33107,7172,21893,64,55000,632,1000,0.632,523,0.523,155,0.155,71
40862,33501,7361,22499,65,56000,583,1000,0.583,606,0.606,189,0.189,71
41473,33960,7513,23040,66,57000,611,1000,0.611,541,0.541,152,0.152,71
42059,34386,7673,23614,67,58000,586,1000,0.586,574,0.574,160,0.16,71
42651,34819,7832,24181,68,59000,592,1000,0.592,567,0.567,159,0.159,71
43241,35240,8001,24760,69,60000,590,1000,0.59,579,0.579,169,0.169,71
43842,35685,8157,25315,70,61000,601,1000,0.601,555,0.555,156,0.156,71
44415,36083,8332,25917,71,62000,573,1000,0.573,602,0.602,175,0.175,71
44997,36508,8489,26492,72,63000,582,1000,0.582,575,0.575,157,0.157,71
45577,36912,8665,27088,73,64000,580,1000,0.58,596,0.596,176,0.176,71
46160,37326,8834,27674,74,65000,583,1000,0.583,586,0.586,169,0.169,71
46747,37764,8983,28236,75,66000,587,1000,0.587,562,0.562,149,0.149,71
47334,38191,9143,28809,76,67000,587,1000,0.587,573,0.573,160,0.16,71
47907,38587,9320,29413,77,68000,573,1000,0.573,604,0.604,177,0.177,71
48450,38948,9502,30052,78,69000,543,1000,0.543,639,0.639,182,0.182,71
49025,39348,9677,30652,79,70000,575,1000,0.575,600,0.6,175,0.175,71
49576,39729,9847,31271,80,71000,551,1000,0.551,619,0.619,170,0.17,71
50109,40081,10028,31919,81,72000,533,1000,0.533,648,0.648,181,0.181,71
50671,40478,10193,32522,82,73000,562,1000,0.562,603,0.603,165,0.165,71
51212,40860,10352,33140,83,74000,541,1000,0.541,618,0.618,159,0.159,71
51773,41268,10505,33732,84,75000,561,1000,0.561,592,0.592,153,0.153,71
52332,41657,10675,34343,85,76000,559,1000,0.559,611,0.611,170,0.17,71
52892,42048,10844,34952,86,77000,560,1000,0.56,609,0.609,169,0.169,71
53436,42410,11026,35590,87,78000,544,1000,0.544,638,0.638,182,0.182,71
53960,42768,11192,36232,88,79000,524,1000,0.524,642,0.642,166,0.166,71
54499,43120,11379,36880,89,80000,539,1000,0.539,648,0.648,187,0.187,71
55042,43502,11540,37498,90,81000,543,1000,0.543,618,0.618,161,0.161,71
55563,43842,11721,38158,91,82000,521,1000,0.521,660,0.66,181,0.181,71
56089,44192,11897,38808,92,83000,526,1000,0.526,650,0.65,176,0.176,71
56629,44553,12076,39447,93,84000,540,1000,0.54,639,0.639,179,0.179,71
57144,44898,12246,40102,94,85000,515,1000,0.515,655,0.655,170,0.17,71
57676,45275,12401,40725,95,86000,532,1000,0.532,623,0.623,155,0.155,71
58191,45612,12579,41388,96,87000,515,1000,0.515,663,0.663,178,0.178,71
58734,45994,12740,42006,97,88000,543,1000,0.543,618,0.618,161,0.161,71
59275,46354,12921,42646,98,89000,541,1000,0.541,640,0.64,181,0.181,71
59791,46713,13078,43287,99,90000,516,1000,0.516,641,0.641,157,0.157,71
60298,47038,13260,43962,100,91000,507,1000,0.507,675,0.675,182,0.182,71
60829,47398,13431,44602,101,92000,531,1000,0.531,640,0.64,171,0.171,71
61359,47756,13603,45244,102,93000,530,1000,0.53,642,0.642,172,0.172,71
61870,48097,13773,45903,103,94000,511,1000,0.511,659,0.659,170,0.17,71
62381,48427,13954,46573,104,95000,511,1000,0.511,670,0.67,181,0.181,71
62867,48736,14131,47264,105,96000,486,1000,0.486,691,0.691,177,0.177,71
63384,49094,14290,47906,106,97000,517,1000,0.517,642,0.642,159,0.159,71
63894,49447,14447,48553,107,98000,510,1000,0.51,647,0.647,157,0.157,71
64393,49759,14634,49241,108,99000,499,1000,0.499,688,0.688,187,0.187,71
64894,50103,14791,49897,109,100000,501,1000,0.501,656,0.656,157,0.157,71
65386,50436,14950,50564,110,101000,492,1000,0.492,667,0.667,159,0.159,71
65886,50772,15114,51228,111,102000,500,1000,0.5,664,0.664,164,0.164,71
66376,51092,15284,51908,112,103000,490,1000,0.49,680,0.68,170,0.17,71
66872,51414,15458,52586,113,104000,496,1000,0.496,678,0.678,174,0.174,71
67349,51714,15635,53286,114,105000,477,1000,0.477,700,0.7,177,0.177,71
67878,52087,15791,53913,115,106000,529,1000,0.529,627,0.627,156,0.156,71
68378,52413,15965,54587,116,107000,500,1000,0.5,674,0.674,174,0.174,71
68875,52753,16122,55247,117,108000,497,1000,0.497,660,0.66,157,0.157,71
69309,52999,16310,56001,118,109000,434,1000,0.434,754,0.754,188,0.188,71
69776,53285,16491,56715,119,110000,467,1000,0.467,714,0.714,181,0.181,71
70278,53614,16664,57386,120,111000,502,1000,0.502,671,0.671,173,0.173,71
70760,53932,16828,58068,121,112000,482,1000,0.482,682,0.682,164,0.164,71
71241,54247,16994,58753,122,113000,481,1000,0.481,685,0.685,166,0.166,71
71732,54557,17175,59443,123,114000,491,1000,0.491,690,0.69,181,0.181,71
71869,54638,17231,59660,124,114298,137,298,0.4597315436241611,217,0.7281879194630873,56,0.18791946308724833,71
100,100,0,0,1,100,NA,NA,NA,NA,NA,NA,NA,72
197,194,3,6,2,200,97,100,0.97,6,0.06,3,0.03,72
295,290,5,10,3,300,98,100,0.98,4,0.04,2,0.02,72
393,387,6,13,4,400,98,100,0.98,3,0.03,1,0.01,72
493,487,6,13,5,500,100,100,1,0,0,0,0,72
592,585,7,15,6,600,99,100,0.99,2,0.02,1,0.01,72
692,685,7,15,7,700,100,100,1,0,0,0,0,72
790,781,9,19,8,800,98,100,0.98,4,0.04,2,0.02,72
887,876,11,24,9,900,97,100,0.97,5,0.05,2,0.02,72
983,968,15,32,10,1000,96,100,0.96,8,0.08,4,0.04,72
1936,1884,52,116,11,2000,953,1000,0.953,84,0.084,37,0.037,72
2876,2780,96,220,12,3000,940,1000,0.94,104,0.104,44,0.044,72
3795,3645,150,355,13,4000,919,1000,0.919,135,0.135,54,0.054,72
4696,4481,215,519,14,5000,901,1000,0.901,164,0.164,65,0.065,72
5577,5284,293,716,15,6000,881,1000,0.881,197,0.197,78,0.078,72
6448,6075,373,925,16,7000,871,1000,0.871,209,0.209,80,0.08,72
7315,6858,457,1142,17,8000,867,1000,0.867,217,0.217,84,0.084,72
8151,7597,554,1403,18,9000,836,1000,0.836,261,0.261,97,0.097,72
8988,8341,647,1659,19,10000,837,1000,0.837,256,0.256,93,0.093,72
9810,9057,753,1943,20,11000,822,1000,0.822,284,0.284,106,0.106,72
10611,9750,861,2250,21,12000,801,1000,0.801,307,0.307,108,0.108,72
11401,10417,984,2583,22,13000,790,1000,0.79,333,0.333,123,0.123,72
12192,11089,1103,2911,23,14000,791,1000,0.791,328,0.328,119,0.119,72
12998,11795,1203,3205,24,15000,806,1000,0.806,294,0.294,100,0.1,72
13782,12458,1324,3542,25,16000,784,1000,0.784,337,0.337,121,0.121,72
14553,13103,1450,3897,26,17000,771,1000,0.771,355,0.355,126,0.126,72
15316,13738,1578,4262,27,18000,763,1000,0.763,365,0.365,128,0.128,72
16051,14331,1720,4669,28,19000,735,1000,0.735,407,0.407,142,0.142,72
16813,14963,1850,5037,29,20000,762,1000,0.762,368,0.368,130,0.13,72
17577,15594,1983,5406,30,21000,764,1000,0.764,369,0.369,133,0.133,72
18328,16225,2103,5775,31,22000,751,1000,0.751,369,0.369,120,0.12,72
19058,16810,2248,6190,32,23000,730,1000,0.73,415,0.415,145,0.145,72
19787,17379,2408,6621,33,24000,729,1000,0.729,431,0.431,160,0.16,72
20510,17971,2539,7029,34,25000,723,1000,0.723,408,0.408,131,0.131,72
21247,18562,2685,7438,35,26000,737,1000,0.737,409,0.409,146,0.146,72
21968,19137,2831,7863,36,27000,721,1000,0.721,425,0.425,146,0.146,72
22674,19694,2980,8306,37,28000,706,1000,0.706,443,0.443,149,0.149,72
23380,20250,3130,8750,38,29000,706,1000,0.706,444,0.444,150,0.15,72
24075,20788,3287,9212,39,30000,695,1000,0.695,462,0.462,157,0.157,72
24777,21348,3429,9652,40,31000,702,1000,0.702,440,0.44,142,0.142,72
25483,21889,3594,10111,41,32000,706,1000,0.706,459,0.459,165,0.165,72
26199,22486,3713,10514,42,33000,716,1000,0.716,403,0.403,119,0.119,72
26889,23027,3862,10973,43,34000,690,1000,0.69,459,0.459,149,0.149,72
27563,23563,4000,11437,44,35000,674,1000,0.674,464,0.464,138,0.138,72
28252,24107,4145,11893,45,36000,689,1000,0.689,456,0.456,145,0.145,72
28912,24606,4306,12394,46,37000,660,1000,0.66,501,0.501,161,0.161,72
29576,25124,4452,12876,47,38000,664,1000,0.664,482,0.482,146,0.146,72
30239,25643,4596,13357,48,39000,663,1000,0.663,481,0.481,144,0.144,72
30905,26157,4748,13843,49,40000,666,1000,0.666,486,0.486,152,0.152,72
31554,26653,4901,14347,50,41000,649,1000,0.649,504,0.504,153,0.153,72
32199,27138,5061,14862,51,42000,645,1000,0.645,515,0.515,160,0.16,72
32865,27649,5216,15351,52,43000,666,1000,0.666,489,0.489,155,0.155,72
33529,28166,5363,15834,53,44000,664,1000,0.664,483,0.483,147,0.147,72
34151,28613,5538,16387,54,45000,622,1000,0.622,553,0.553,175,0.175,72
34789,29101,5688,16899,55,46000,638,1000,0.638,512,0.512,150,0.15,72
35425,29591,5834,17409,56,47000,636,1000,0.636,510,0.51,146,0.146,72
36049,30051,5998,17949,57,48000,624,1000,0.624,540,0.54,164,0.164,72
36669,30509,6160,18491,58,49000,620,1000,0.62,542,0.542,162,0.162,72
37292,30978,6314,19022,59,50000,623,1000,0.623,531,0.531,154,0.154,72
37911,31440,6471,19560,60,51000,619,1000,0.619,538,0.538,157,0.157,72
38530,31882,6648,20118,61,52000,619,1000,0.619,558,0.558,177,0.177,72
39154,32342,6812,20658,62,53000,624,1000,0.624,540,0.54,164,0.164,72
39718,32728,6990,21272,63,54000,564,1000,0.564,614,0.614,178,0.178,72
40326,33174,7152,21826,64,55000,608,1000,0.608,554,0.554,162,0.162,72
40918,33586,7332,22414,65,56000,592,1000,0.592,588,0.588,180,0.18,72
41504,34002,7502,22998,66,57000,586,1000,0.586,584,0.584,170,0.17,72
42078,34392,7686,23608,67,58000,574,1000,0.574,610,0.61,184,0.184,72
42672,34837,7835,24163,68,59000,594,1000,0.594,555,0.555,149,0.149,72
43279,35297,7982,24703,69,60000,607,1000,0.607,540,0.54,147,0.147,72
43892,35745,8147,25255,70,61000,613,1000,0.613,552,0.552,165,0.165,72
44498,36177,8321,25823,71,62000,606,1000,0.606,568,0.568,174,0.174,72
45086,36605,8481,26395,72,63000,588,1000,0.588,572,0.572,160,0.16,72
45644,37000,8644,27000,73,64000,558,1000,0.558,605,0.605,163,0.163,72
46246,37445,8801,27555,74,65000,602,1000,0.602,555,0.555,157,0.157,72
46835,37868,8967,28132,75,66000,589,1000,0.589,577,0.577,166,0.166,72
47419,38278,9141,28722,76,67000,584,1000,0.584,590,0.59,174,0.174,72
47982,38661,9321,29339,77,68000,563,1000,0.563,617,0.617,180,0.18,72
48581,39110,9471,29890,78,69000,599,1000,0.599,551,0.551,150,0.15,72
49134,39495,9639,30505,79,70000,553,1000,0.553,615,0.615,168,0.168,72
49670,39850,9820,31150,80,71000,536,1000,0.536,645,0.645,181,0.181,72
50238,40267,9971,31733,81,72000,568,1000,0.568,583,0.583,151,0.151,72
50794,40659,10135,32341,82,73000,556,1000,0.556,608,0.608,164,0.164,72
51350,41037,10313,32963,83,74000,556,1000,0.556,622,0.622,178,0.178,72
51921,41462,10459,33538,84,75000,571,1000,0.571,575,0.575,146,0.146,72
52480,41850,10630,34150,85,76000,559,1000,0.559,612,0.612,171,0.171,72
53022,42235,10787,34765,86,77000,542,1000,0.542,615,0.615,157,0.157,72
53572,42610,10962,35390,87,78000,550,1000,0.55,625,0.625,175,0.175,72
54092,42947,11145,36053,88,79000,520,1000,0.52,663,0.663,183,0.183,72
54622,43298,11324,36702,89,80000,530,1000,0.53,649,0.649,179,0.179,72
55181,43693,11488,37307,90,81000,559,1000,0.559,605,0.605,164,0.164,72
55717,44055,11662,37945,91,82000,536,1000,0.536,638,0.638,174,0.174,72
56277,44469,11808,38531,92,83000,560,1000,0.56,586,0.586,146,0.146,72
56799,44805,11994,39195,93,84000,522,1000,0.522,664,0.664,186,0.186,72
57302,45131,12171,39869,94,85000,503,1000,0.503,674,0.674,177,0.177,72
57833,45511,12322,40489,95,86000,531,1000,0.531,620,0.62,151,0.151,72
58334,45829,12505,41171,96,87000,501,1000,0.501,682,0.682,183,0.183,72
58852,46192,12660,41808,97,88000,518,1000,0.518,637,0.637,155,0.155,72
59363,46541,12822,42459,98,89000,511,1000,0.511,651,0.651,162,0.162,72
59894,46896,12998,43104,99,90000,531,1000,0.531,645,0.645,176,0.176,72
60398,47229,13169,43771,100,91000,504,1000,0.504,667,0.667,171,0.171,72
60915,47579,13336,44421,101,92000,517,1000,0.517,650,0.65,167,0.167,72
61426,47902,13524,45098,102,93000,511,1000,0.511,677,0.677,188,0.188,72
61929,48222,13707,45778,103,94000,503,1000,0.503,680,0.68,183,0.183,72
62464,48612,13852,46388,104,95000,535,1000,0.535,610,0.61,145,0.145,72
62968,48946,14022,47054,105,96000,504,1000,0.504,666,0.666,170,0.17,72
63448,49253,14195,47747,106,97000,480,1000,0.48,693,0.693,173,0.173,72
63986,49621,14365,48379,107,98000,538,1000,0.538,632,0.632,170,0.17,72
64504,49970,14534,49030,108,99000,518,1000,0.518,651,0.651,169,0.169,72
64983,50258,14725,49742,109,100000,479,1000,0.479,712,0.712,191,0.191,72
65449,50539,14910,50461,110,101000,466,1000,0.466,719,0.719,185,0.185,72
65944,50862,15082,51138,111,102000,495,1000,0.495,677,0.677,172,0.172,72
66432,51172,15260,51828,112,103000,488,1000,0.488,690,0.69,178,0.178,72
66910,51474,15436,52526,113,104000,478,1000,0.478,698,0.698,176,0.176,72
67404,51796,15608,53204,114,105000,494,1000,0.494,678,0.678,172,0.172,72
67902,52120,15782,53880,115,106000,498,1000,0.498,676,0.676,174,0.174,72
68372,52410,15962,54590,116,107000,470,1000,0.47,710,0.71,180,0.18,72
68852,52724,16128,55276,117,108000,480,1000,0.48,686,0.686,166,0.166,72
69346,53064,16282,55936,118,109000,494,1000,0.494,660,0.66,154,0.154,72
69829,53364,16465,56636,119,110000,483,1000,0.483,700,0.7,183,0.183,72
70285,53626,16659,57374,120,111000,456,1000,0.456,738,0.738,194,0.194,72
70778,53940,16838,58060,121,112000,493,1000,0.493,686,0.686,179,0.179,72
71240,54233,17007,58767,122,113000,462,1000,0.462,707,0.707,169,0.169,72
71709,54514,17195,59486,123,114000,469,1000,0.469,719,0.719,188,0.188,72
71869,54638,17231,59660,124,114298,160,298,0.5369127516778524,174,0.5838926174496645,36,0.12080536912751678,72
100,100,0,0,1,100,NA,NA,NA,NA,NA,NA,NA,73
200,200,0,0,2,200,100,100,1,0,0,0,0,73
299,298,1,2,3,300,99,100,0.99,2,0.02,1,0.01,73
398,396,2,4,4,400,99,100,0.99,2,0.02,1,0.01,73
498,496,2,4,5,500,100,100,1,0,0,0,0,73
598,596,2,4,6,600,100,100,1,0,0,0,0,73
697,694,3,6,7,700,99,100,0.99,2,0.02,1,0.01,73
794,788,6,12,8,800,97,100,0.97,6,0.06,3,0.03,73
894,888,6,12,9,900,100,100,1,0,0,0,0,73
989,979,10,21,10,1000,95,100,0.95,9,0.09,4,0.04,73
1935,1882,53,118,11,2000,946,1000,0.946,97,0.097,43,0.043,73
2871,2763,108,237,12,3000,936,1000,0.936,119,0.119,55,0.055,73
3800,3642,158,358,13,4000,929,1000,0.929,121,0.121,50,0.05,73
4686,4449,237,551,14,5000,886,1000,0.886,193,0.193,79,0.079,73
5576,5271,305,729,15,6000,890,1000,0.89,178,0.178,68,0.068,73
6450,6059,391,941,16,7000,874,1000,0.874,212,0.212,86,0.086,73
7311,6837,474,1163,17,8000,861,1000,0.861,222,0.222,83,0.083,73
8169,7613,556,1387,18,9000,858,1000,0.858,224,0.224,82,0.082,73
8981,8320,661,1680,19,10000,812,1000,0.812,293,0.293,105,0.105,73
9796,9031,765,1969,20,11000,815,1000,0.815,289,0.289,104,0.104,73
10611,9746,865,2254,21,12000,815,1000,0.815,285,0.285,100,0.1,73
11423,10456,967,2544,22,13000,812,1000,0.812,290,0.29,102,0.102,73
12220,11142,1078,2858,23,14000,797,1000,0.797,314,0.314,111,0.111,73
13034,11851,1183,3149,24,15000,814,1000,0.814,291,0.291,105,0.105,73
13807,12495,1312,3505,25,16000,773,1000,0.773,356,0.356,129,0.129,73
14586,13151,1435,3849,26,17000,779,1000,0.779,344,0.344,123,0.123,73
15374,13836,1538,4164,27,18000,788,1000,0.788,315,0.315,103,0.103,73
16127,14455,1672,4545,28,19000,753,1000,0.753,381,0.381,134,0.134,73
16882,15079,1803,4921,29,20000,755,1000,0.755,376,0.376,131,0.131,73
17609,15675,1934,5325,30,21000,727,1000,0.727,404,0.404,131,0.131,73
18367,16293,2074,5707,31,22000,758,1000,0.758,382,0.382,140,0.14,73
19120,16922,2198,6078,32,23000,753,1000,0.753,371,0.371,124,0.124,73
19830,17471,2359,6529,33,24000,710,1000,0.71,451,0.451,161,0.161,73
20570,18077,2493,6923,34,25000,740,1000,0.74,394,0.394,134,0.134,73
21276,18628,2648,7372,35,26000,706,1000,0.706,449,0.449,155,0.155,73
22009,19232,2777,7768,36,27000,733,1000,0.733,396,0.396,129,0.129,73
22720,19809,2911,8191,37,28000,711,1000,0.711,423,0.423,134,0.134,73
23416,20355,3061,8645,38,29000,696,1000,0.696,454,0.454,150,0.15,73
24145,20953,3192,9047,39,30000,729,1000,0.729,402,0.402,131,0.131,73
24847,21511,3336,9489,40,31000,702,1000,0.702,442,0.442,144,0.144,73
25540,22052,3488,9948,41,32000,693,1000,0.693,459,0.459,152,0.152,73
26222,22583,3639,10417,42,33000,682,1000,0.682,469,0.469,151,0.151,73
26915,23129,3786,10871,43,34000,693,1000,0.693,454,0.454,147,0.147,73
27586,23648,3938,11352,44,35000,671,1000,0.671,481,0.481,152,0.152,73
28259,24167,4092,11833,45,36000,673,1000,0.673,481,0.481,154,0.154,73
28931,24678,4253,12322,46,37000,672,1000,0.672,489,0.489,161,0.161,73
29579,25161,4418,12839,47,38000,648,1000,0.648,517,0.517,165,0.165,73
30255,25695,4560,13305,48,39000,676,1000,0.676,466,0.466,142,0.142,73
30901,26184,4717,13816,49,40000,646,1000,0.646,511,0.511,157,0.157,73
31536,26663,4873,14337,50,41000,635,1000,0.635,521,0.521,156,0.156,73
32176,27138,5038,14862,51,42000,640,1000,0.64,525,0.525,165,0.165,73
32823,27620,5203,15380,52,43000,647,1000,0.647,518,0.518,165,0.165,73
33464,28089,5375,15911,53,44000,641,1000,0.641,531,0.531,172,0.172,73
34098,28571,5527,16429,54,45000,634,1000,0.634,518,0.518,152,0.152,73
34718,29008,5710,16992,55,46000,620,1000,0.62,563,0.563,183,0.183,73
35338,29464,5874,17536,56,47000,620,1000,0.62,544,0.544,164,0.164,73
35977,29937,6040,18063,57,48000,639,1000,0.639,527,0.527,166,0.166,73
36613,30426,6187,18574,58,49000,636,1000,0.636,511,0.511,147,0.147,73
37217,30858,6359,19142,59,50000,604,1000,0.604,568,0.568,172,0.172,73
37850,31354,6496,19646,60,51000,633,1000,0.633,504,0.504,137,0.137,73
38438,31761,6677,20239,61,52000,588,1000,0.588,593,0.593,181,0.181,73
39048,32220,6828,20780,62,53000,610,1000,0.61,541,0.541,151,0.151,73
39667,32676,6991,21324,63,54000,619,1000,0.619,544,0.544,163,0.163,73
40278,33135,7143,21865,64,55000,611,1000,0.611,541,0.541,152,0.152,73
40866,33542,7324,22458,65,56000,588,1000,0.588,593,0.593,181,0.181,73
41462,33966,7496,23034,66,57000,596,1000,0.596,576,0.576,172,0.172,73
42058,34395,7663,23605,67,58000,596,1000,0.596,571,0.571,167,0.167,73
42663,34842,7821,24158,68,59000,605,1000,0.605,553,0.553,158,0.158,73
43246,35258,7988,24742,69,60000,583,1000,0.583,584,0.584,167,0.167,73
43840,35685,8155,25315,70,61000,594,1000,0.594,573,0.573,167,0.167,73
44432,36110,8322,25890,71,62000,592,1000,0.592,575,0.575,167,0.167,73
44992,36492,8500,26508,72,63000,560,1000,0.56,618,0.618,178,0.178,73
45582,36921,8661,27079,73,64000,590,1000,0.59,571,0.571,161,0.161,73
46141,37314,8827,27686,74,65000,559,1000,0.559,607,0.607,166,0.166,73
46700,37694,9006,28306,75,66000,559,1000,0.559,620,0.62,179,0.179,73
47264,38093,9171,28907,76,67000,564,1000,0.564,601,0.601,165,0.165,73
47805,38452,9353,29548,77,68000,541,1000,0.541,641,0.641,182,0.182,73
48372,38851,9521,30149,78,69000,567,1000,0.567,601,0.601,168,0.168,73
48953,39275,9678,30725,79,70000,581,1000,0.581,576,0.576,157,0.157,73
49503,39646,9857,31354,80,71000,550,1000,0.55,629,0.629,179,0.179,73
50033,40003,10030,31997,81,72000,530,1000,0.53,643,0.643,173,0.173,73
50584,40386,10198,32614,82,73000,551,1000,0.551,617,0.617,168,0.168,73
51148,40789,10359,33211,83,74000,564,1000,0.564,597,0.597,161,0.161,73
51676,41116,10560,33884,84,75000,528,1000,0.528,673,0.673,201,0.201,73
52210,41475,10735,34525,85,76000,534,1000,0.534,641,0.641,175,0.175,73
52744,41830,10914,35170,86,77000,534,1000,0.534,645,0.645,179,0.179,73
53300,42222,11078,35778,87,78000,556,1000,0.556,608,0.608,164,0.164,73
53846,42607,11239,36393,88,79000,546,1000,0.546,615,0.615,161,0.161,73
54387,42974,11413,37026,89,80000,541,1000,0.541,633,0.633,174,0.174,73
54922,43336,11586,37664,90,81000,535,1000,0.535,638,0.638,173,0.173,73
55470,43718,11752,38282,91,82000,548,1000,0.548,618,0.618,166,0.166,73
55999,44093,11906,38907,92,83000,529,1000,0.529,625,0.625,154,0.154,73
56549,44482,12067,39518,93,84000,550,1000,0.55,611,0.611,161,0.161,73
57085,44845,12240,40155,94,85000,536,1000,0.536,637,0.637,173,0.173,73
57607,45187,12420,40813,95,86000,522,1000,0.522,658,0.658,180,0.18,73
58128,45551,12577,41449,96,87000,521,1000,0.521,636,0.636,157,0.157,73
58679,45933,12746,42067,97,88000,551,1000,0.551,618,0.618,169,0.169,73
59202,46293,12909,42707,98,89000,523,1000,0.523,640,0.64,163,0.163,73
59726,46633,13093,43367,99,90000,524,1000,0.524,660,0.66,184,0.184,73
60229,46940,13289,44060,100,91000,503,1000,0.503,693,0.693,196,0.196,73
60736,47282,13454,44718,101,92000,507,1000,0.507,658,0.658,165,0.165,73
61229,47585,13644,45415,102,93000,493,1000,0.493,697,0.697,190,0.19,73
61765,47965,13800,46035,103,94000,536,1000,0.536,620,0.62,156,0.156,73
62251,48277,13974,46723,104,95000,486,1000,0.486,688,0.688,174,0.174,73
62768,48606,14162,47394,105,96000,517,1000,0.517,671,0.671,188,0.188,73
63255,48921,14334,48079,106,97000,487,1000,0.487,685,0.685,172,0.172,73
63767,49257,14510,48743,107,98000,512,1000,0.512,664,0.664,176,0.176,73
64266,49595,14671,49405,108,99000,499,1000,0.499,662,0.662,161,0.161,73
64787,49940,14847,50060,109,100000,521,1000,0.521,655,0.655,176,0.176,73
65288,50270,15018,50730,110,101000,501,1000,0.501,670,0.67,171,0.171,73
65796,50615,15181,51385,111,102000,508,1000,0.508,655,0.655,163,0.163,73
66327,50989,15338,52011,112,103000,531,1000,0.531,626,0.626,157,0.157,73
66818,51316,15502,52684,113,104000,491,1000,0.491,673,0.673,164,0.164,73
67362,51688,15674,53312,114,105000,544,1000,0.544,628,0.628,172,0.172,73
67871,52019,15852,53981,115,106000,509,1000,0.509,669,0.669,178,0.178,73
68351,52313,16038,54687,116,107000,480,1000,0.48,706,0.706,186,0.186,73
68838,52637,16201,55363,117,108000,487,1000,0.487,676,0.676,163,0.163,73
69355,53004,16351,55996,118,109000,517,1000,0.517,633,0.633,150,0.15,73
69840,53315,16525,56685,119,110000,485,1000,0.485,689,0.689,174,0.174,73
70338,53655,16683,57345,120,111000,498,1000,0.498,660,0.66,158,0.158,73
70783,53920,16863,58080,121,112000,445,1000,0.445,735,0.735,180,0.18,73
71248,54224,17024,58776,122,113000,465,1000,0.465,696,0.696,161,0.161,73
71704,54512,17192,59488,123,114000,456,1000,0.456,712,0.712,168,0.168,73
71869,54638,17231,59660,124,114298,165,298,0.5536912751677853,172,0.5771812080536913,39,0.13087248322147652,73
99,98,1,2,1,100,NA,NA,NA,NA,NA,NA,NA,74
198,196,2,4,2,200,99,100,0.99,2,0.02,1,0.01,74
297,294,3,6,3,300,99,100,0.99,2,0.02,1,0.01,74
395,392,3,8,4,400,98,100,0.98,2,0.02,0,0,74
491,484,7,16,5,500,96,100,0.96,8,0.08,4,0.04,74
590,582,8,18,6,600,99,100,0.99,2,0.02,1,0.01,74
687,676,11,24,7,700,97,100,0.97,6,0.06,3,0.03,74
787,776,11,24,8,800,100,100,1,0,0,0,0,74
882,869,13,31,9,900,95,100,0.95,7,0.07,2,0.02,74
981,967,14,33,10,1000,99,100,0.99,2,0.02,1,0.01,74
1940,1897,43,103,11,2000,959,1000,0.959,70,0.07,29,0.029,74
2887,2805,82,195,12,3000,947,1000,0.947,92,0.092,39,0.039,74
3814,3679,135,321,13,4000,927,1000,0.927,126,0.126,53,0.053,74
4717,4523,194,477,14,5000,903,1000,0.903,156,0.156,59,0.059,74
5612,5348,264,652,15,6000,895,1000,0.895,175,0.175,70,0.07,74
6489,6143,346,857,16,7000,877,1000,0.877,205,0.205,82,0.082,74
7341,6896,445,1104,17,8000,852,1000,0.852,247,0.247,99,0.099,74
8208,7693,515,1307,18,9000,867,1000,0.867,203,0.203,70,0.07,74
9042,8413,629,1587,19,10000,834,1000,0.834,280,0.28,114,0.114,74
9864,9138,726,1862,20,11000,822,1000,0.822,275,0.275,97,0.097,74
10687,9859,828,2141,21,12000,823,1000,0.823,279,0.279,102,0.102,74
11492,10550,942,2450,22,13000,805,1000,0.805,309,0.309,114,0.114,74
12293,11240,1053,2760,23,14000,801,1000,0.801,310,0.31,111,0.111,74
13073,11896,1177,3104,24,15000,780,1000,0.78,344,0.344,124,0.124,74
13848,12552,1296,3448,25,16000,775,1000,0.775,344,0.344,119,0.119,74
14623,13201,1422,3799,26,17000,775,1000,0.775,351,0.351,126,0.126,74
15395,13833,1562,4167,27,18000,772,1000,0.772,368,0.368,140,0.14,74
16144,14450,1694,4550,28,19000,749,1000,0.749,383,0.383,132,0.132,74
16884,15049,1835,4951,29,20000,740,1000,0.74,401,0.401,141,0.141,74
17627,15665,1962,5335,30,21000,743,1000,0.743,384,0.384,127,0.127,74
18374,16283,2091,5717,31,22000,747,1000,0.747,382,0.382,129,0.129,74
19116,16895,2221,6105,32,23000,742,1000,0.742,388,0.388,130,0.13,74
19848,17488,2360,6512,33,24000,732,1000,0.732,407,0.407,139,0.139,74
20571,18048,2523,6952,34,25000,723,1000,0.723,440,0.44,163,0.163,74
21286,18627,2659,7373,35,26000,715,1000,0.715,421,0.421,136,0.136,74
22016,19222,2794,7778,36,27000,730,1000,0.73,405,0.405,135,0.135,74
22694,19757,2937,8243,37,28000,678,1000,0.678,465,0.465,143,0.143,74
23425,20349,3076,8651,38,29000,731,1000,0.731,408,0.408,139,0.139,74
24121,20886,3235,9114,39,30000,696,1000,0.696,463,0.463,159,0.159,74
24821,21432,3389,9568,40,31000,700,1000,0.7,454,0.454,154,0.154,74
25493,21939,3554,10061,41,32000,672,1000,0.672,493,0.493,165,0.165,74
26187,22477,3710,10523,42,33000,694,1000,0.694,462,0.462,156,0.156,74
26879,23023,3856,10977,43,34000,692,1000,0.692,454,0.454,146,0.146,74
27549,23535,4014,11465,44,35000,670,1000,0.67,488,0.488,158,0.158,74
28209,24039,4170,11961,45,36000,660,1000,0.66,496,0.496,156,0.156,74
28873,24541,4332,12459,46,37000,664,1000,0.664,498,0.498,162,0.162,74
29530,25033,4497,12967,47,38000,657,1000,0.657,508,0.508,165,0.165,74
30176,25517,4659,13483,48,39000,646,1000,0.646,516,0.516,162,0.162,74
30824,25993,4831,14007,49,40000,648,1000,0.648,524,0.524,172,0.172,74
31502,26533,4969,14467,50,41000,678,1000,0.678,460,0.46,138,0.138,74
32149,27009,5140,14991,51,42000,647,1000,0.647,524,0.524,171,0.171,74
32801,27504,5297,15496,52,43000,652,1000,0.652,505,0.505,157,0.157,74
33447,27992,5455,16008,53,44000,646,1000,0.646,512,0.512,158,0.158,74
34050,28421,5629,16579,54,45000,603,1000,0.603,571,0.571,174,0.174,74
34674,28859,5815,17141,55,46000,624,1000,0.624,562,0.562,186,0.186,74
35305,29331,5974,17669,56,47000,631,1000,0.631,528,0.528,159,0.159,74
35911,29763,6148,18237,57,48000,606,1000,0.606,568,0.568,174,0.174,74
36521,30202,6319,18798,58,49000,610,1000,0.61,561,0.561,171,0.171,74
37126,30634,6492,19366,59,50000,605,1000,0.605,568,0.568,173,0.173,74
37768,31143,6625,19857,60,51000,642,1000,0.642,491,0.491,133,0.133,74
38391,31613,6778,20387,61,52000,623,1000,0.623,530,0.53,153,0.153,74
38996,32052,6944,20948,62,53000,605,1000,0.605,561,0.561,166,0.166,74
39628,32541,7087,21459,63,54000,632,1000,0.632,511,0.511,143,0.143,74
40214,32961,7253,22039,64,55000,586,1000,0.586,580,0.58,166,0.166,74
40848,33457,7391,22543,65,56000,634,1000,0.634,504,0.504,138,0.138,74
41447,33901,7546,23099,66,57000,599,1000,0.599,556,0.556,155,0.155,74
42058,34359,7699,23641,67,58000,611,1000,0.611,542,0.542,153,0.153,74
42654,34803,7851,24197,68,59000,596,1000,0.596,556,0.556,152,0.152,74
43239,35204,8035,24796,69,60000,585,1000,0.585,599,0.599,184,0.184,74
43821,35626,8195,25374,70,61000,582,1000,0.582,578,0.578,160,0.16,74
44413,36055,8358,25945,71,62000,592,1000,0.592,571,0.571,163,0.163,74
44991,36472,8519,26528,72,63000,578,1000,0.578,583,0.583,161,0.161,74
45557,36867,8690,27133,73,64000,566,1000,0.566,605,0.605,171,0.171,74
46148,37295,8853,27705,74,65000,591,1000,0.591,572,0.572,163,0.163,74
46699,37670,9029,28330,75,66000,551,1000,0.551,625,0.625,176,0.176,74
47261,38051,9210,28949,76,67000,562,1000,0.562,619,0.619,181,0.181,74
47821,38430,9391,29570,77,68000,560,1000,0.56,621,0.621,181,0.181,74
48375,38811,9564,30189,78,69000,554,1000,0.554,619,0.619,173,0.173,74
48938,39213,9725,30787,79,70000,563,1000,0.563,598,0.598,161,0.161,74
49494,39607,9887,31393,80,71000,556,1000,0.556,606,0.606,162,0.162,74
50043,39980,10063,32020,81,72000,549,1000,0.549,627,0.627,176,0.176,74
50593,40349,10244,32651,82,73000,550,1000,0.55,631,0.631,181,0.181,74
51139,40719,10420,33281,83,74000,546,1000,0.546,630,0.63,176,0.176,74
51663,41051,10612,33949,84,75000,524,1000,0.524,668,0.668,192,0.192,74
52227,41448,10779,34552,85,76000,564,1000,0.564,603,0.603,167,0.167,74
52768,41813,10955,35187,86,77000,541,1000,0.541,635,0.635,176,0.176,74
53319,42189,11130,35811,87,78000,551,1000,0.551,624,0.624,175,0.175,74
53843,42529,11314,36471,88,79000,524,1000,0.524,660,0.66,184,0.184,74
54377,42881,11496,37119,89,80000,534,1000,0.534,648,0.648,182,0.182,74
54954,43302,11652,37698,90,81000,577,1000,0.577,579,0.579,156,0.156,74
55499,43694,11805,38306,91,82000,545,1000,0.545,608,0.608,153,0.153,74
56050,44097,11953,38903,92,83000,551,1000,0.551,597,0.597,148,0.148,74
56577,44446,12131,39554,93,84000,527,1000,0.527,651,0.651,178,0.178,74
57097,44781,12316,40219,94,85000,520,1000,0.52,665,0.665,185,0.185,74
57640,45171,12469,40829,95,86000,543,1000,0.543,610,0.61,153,0.153,74
58149,45513,12636,41487,96,87000,509,1000,0.509,658,0.658,167,0.167,74
58678,45867,12811,42133,97,88000,529,1000,0.529,646,0.646,175,0.175,74
59186,46221,12965,42779,98,89000,508,1000,0.508,646,0.646,154,0.154,74
59702,46583,13119,43417,99,90000,516,1000,0.516,638,0.638,154,0.154,74
60224,46926,13298,44074,100,91000,522,1000,0.522,657,0.657,179,0.179,74
60737,47274,13463,44726,101,92000,513,1000,0.513,652,0.652,165,0.165,74
61265,47640,13625,45360,102,93000,528,1000,0.528,634,0.634,162,0.162,74
61802,48004,13798,45996,103,94000,537,1000,0.537,636,0.636,173,0.173,74
62322,48365,13957,46635,104,95000,520,1000,0.52,639,0.639,159,0.159,74
62808,48644,14164,47356,105,96000,486,1000,0.486,721,0.721,207,0.207,74
63321,48980,14341,48020,106,97000,513,1000,0.513,664,0.664,177,0.177,74
63837,49329,14508,48671,107,98000,516,1000,0.516,651,0.651,167,0.167,74
64320,49636,14684,49364,108,99000,483,1000,0.483,693,0.693,176,0.176,74
64817,49971,14846,50029,109,100000,497,1000,0.497,665,0.665,162,0.162,74
65331,50316,15015,50684,110,101000,514,1000,0.514,655,0.655,169,0.169,74
65840,50678,15162,51322,111,102000,509,1000,0.509,638,0.638,147,0.147,74
66335,51005,15330,51995,112,103000,495,1000,0.495,673,0.673,168,0.168,74
66834,51333,15501,52667,113,104000,499,1000,0.499,672,0.672,171,0.171,74
67315,51614,15701,53386,114,105000,481,1000,0.481,719,0.719,200,0.2,74
67822,51954,15868,54046,115,106000,507,1000,0.507,660,0.66,167,0.167,74
68318,52285,16033,54715,116,107000,496,1000,0.496,669,0.669,165,0.165,74
68804,52609,16195,55391,117,108000,486,1000,0.486,676,0.676,162,0.162,74
69321,52975,16346,56025,118,109000,517,1000,0.517,634,0.634,151,0.151,74
69800,53285,16515,56715,119,110000,479,1000,0.479,690,0.69,169,0.169,74
70293,53614,16679,57386,120,111000,493,1000,0.493,671,0.671,164,0.164,74
70793,53956,16837,58044,121,112000,500,1000,0.5,658,0.658,158,0.158,74
71254,54248,17006,58752,122,113000,461,1000,0.461,708,0.708,169,0.169,74
71729,54548,17181,59452,123,114000,475,1000,0.475,700,0.7,175,0.175,74
71869,54638,17231,59660,124,114298,140,298,0.4697986577181208,208,0.697986577181208,50,0.16778523489932887,74
100,100,0,0,1,100,NA,NA,NA,NA,NA,NA,NA,75
200,200,0,0,2,200,100,100,1,0,0,0,0,75
299,298,1,2,3,300,99,100,0.99,2,0.02,1,0.01,75
397,394,3,6,4,400,98,100,0.98,4,0.04,2,0.02,75
493,486,7,14,5,500,96,100,0.96,8,0.08,4,0.04,75
592,584,8,16,6,600,99,100,0.99,2,0.02,1,0.01,75
690,680,10,20,7,700,98,100,0.98,4,0.04,2,0.02,75
789,778,11,22,8,800,99,100,0.99,2,0.02,1,0.01,75
889,878,11,22,9,900,100,100,1,0,0,0,0,75
987,975,12,25,10,1000,98,100,0.98,3,0.03,1,0.01,75
1940,1890,50,110,11,2000,953,1000,0.953,85,0.085,38,0.038,75
2866,2766,100,234,12,3000,926,1000,0.926,124,0.124,50,0.05,75
3795,3647,148,353,13,4000,929,1000,0.929,119,0.119,48,0.048,75
4695,4479,216,521,14,5000,900,1000,0.9,168,0.168,68,0.068,75
5592,5308,284,692,15,6000,897,1000,0.897,171,0.171,68,0.068,75
6464,6087,377,913,16,7000,872,1000,0.872,221,0.221,93,0.093,75
7355,6901,454,1099,17,8000,891,1000,0.891,186,0.186,77,0.077,75
8208,7663,545,1337,18,9000,853,1000,0.853,238,0.238,91,0.091,75
9046,8415,631,1585,19,10000,838,1000,0.838,248,0.248,86,0.086,75
9861,9117,744,1883,20,11000,815,1000,0.815,298,0.298,113,0.113,75
10677,9822,855,2178,21,12000,816,1000,0.816,295,0.295,111,0.111,75
11484,10512,972,2488,22,13000,807,1000,0.807,310,0.31,117,0.117,75
12303,11230,1073,2770,23,14000,819,1000,0.819,282,0.282,101,0.101,75
13097,11896,1201,3104,24,15000,794,1000,0.794,334,0.334,128,0.128,75
13881,12565,1316,3435,25,16000,784,1000,0.784,331,0.331,115,0.115,75
14652,13214,1438,3786,26,17000,771,1000,0.771,351,0.351,122,0.122,75
15417,13848,1569,4152,27,18000,765,1000,0.765,366,0.366,131,0.131,75
16207,14531,1676,4469,28,19000,790,1000,0.79,317,0.317,107,0.107,75
16977,15177,1800,4823,29,20000,770,1000,0.77,354,0.354,124,0.124,75
17740,15807,1933,5193,30,21000,763,1000,0.763,370,0.37,133,0.133,75
18497,16427,2070,5573,31,22000,757,1000,0.757,380,0.38,137,0.137,75
19209,16990,2219,6010,32,23000,712,1000,0.712,437,0.437,149,0.149,75
19947,17615,2332,6385,33,24000,738,1000,0.738,375,0.375,113,0.113,75
20703,18229,2474,6771,34,25000,756,1000,0.756,386,0.386,142,0.142,75
21418,18803,2615,7197,35,26000,715,1000,0.715,426,0.426,141,0.141,75
22134,19367,2767,7633,36,27000,716,1000,0.716,436,0.436,152,0.152,75
22849,19928,2921,8072,37,28000,715,1000,0.715,439,0.439,154,0.154,75
23559,20497,3062,8503,38,29000,710,1000,0.71,431,0.431,141,0.141,75
24262,21069,3193,8931,39,30000,703,1000,0.703,428,0.428,131,0.131,75
24944,21595,3349,9405,40,31000,682,1000,0.682,474,0.474,156,0.156,75
25648,22161,3487,9839,41,32000,704,1000,0.704,434,0.434,138,0.138,75
26333,22703,3630,10297,42,33000,685,1000,0.685,458,0.458,143,0.143,75
27017,23237,3780,10763,43,34000,684,1000,0.684,466,0.466,150,0.15,75
27687,23749,3938,11251,44,35000,670,1000,0.67,488,0.488,158,0.158,75
28379,24294,4085,11706,45,36000,692,1000,0.692,455,0.455,147,0.147,75
29062,24833,4229,12167,46,37000,683,1000,0.683,461,0.461,144,0.144,75
29683,25285,4398,12715,47,38000,621,1000,0.621,548,0.548,169,0.169,75
30336,25785,4551,13215,48,39000,653,1000,0.653,500,0.5,153,0.153,75
30996,26279,4717,13721,49,40000,660,1000,0.66,506,0.506,166,0.166,75
31636,26768,4868,14232,50,41000,640,1000,0.64,511,0.511,151,0.151,75
32263,27240,5023,14760,51,42000,627,1000,0.627,528,0.528,155,0.155,75
32912,27737,5175,15263,52,43000,649,1000,0.649,503,0.503,152,0.152,75
33565,28251,5314,15749,53,44000,653,1000,0.653,486,0.486,139,0.139,75
34188,28706,5482,16294,54,45000,623,1000,0.623,545,0.545,168,0.168,75
34827,29194,5633,16806,55,46000,639,1000,0.639,512,0.512,151,0.151,75
35449,29651,5798,17349,56,47000,622,1000,0.622,543,0.543,165,0.165,75
36042,30080,5962,17920,57,48000,593,1000,0.593,571,0.571,164,0.164,75
36649,30526,6123,18474,58,49000,607,1000,0.607,554,0.554,161,0.161,75
37235,30934,6301,19066,59,50000,586,1000,0.586,592,0.592,178,0.178,75
37844,31376,6468,19624,60,51000,609,1000,0.609,558,0.558,167,0.167,75
38462,31829,6633,20171,61,52000,618,1000,0.618,547,0.547,165,0.165,75
39082,32275,6807,20725,62,53000,620,1000,0.62,554,0.554,174,0.174,75
39678,32699,6979,21301,63,54000,596,1000,0.596,576,0.576,172,0.172,75
40306,33163,7143,21837,64,55000,628,1000,0.628,536,0.536,164,0.164,75
40906,33591,7315,22409,65,56000,600,1000,0.6,572,0.572,172,0.172,75
41523,34055,7468,22945,66,57000,617,1000,0.617,536,0.536,153,0.153,75
42078,34431,7647,23569,67,58000,555,1000,0.555,624,0.624,179,0.179,75
42655,34832,7823,24168,68,59000,577,1000,0.577,599,0.599,176,0.176,75
43250,35278,7972,24722,69,60000,595,1000,0.595,554,0.554,149,0.149,75
43827,35689,8138,25311,70,61000,577,1000,0.577,589,0.589,166,0.166,75
44406,36097,8309,25903,71,62000,579,1000,0.579,592,0.592,171,0.171,75
44966,36488,8478,26512,72,63000,560,1000,0.56,609,0.609,169,0.169,75
45533,36883,8650,27117,73,64000,567,1000,0.567,605,0.605,172,0.172,75
46121,37313,8808,27687,74,65000,588,1000,0.588,570,0.57,158,0.158,75
46684,37711,8973,28289,75,66000,563,1000,0.563,602,0.602,165,0.165,75
47269,38153,9116,28847,76,67000,585,1000,0.585,558,0.558,143,0.143,75
47811,38508,9303,29492,77,68000,542,1000,0.542,645,0.645,187,0.187,75
48359,38890,9469,30110,78,69000,548,1000,0.548,618,0.618,166,0.166,75
48916,39271,9645,30729,79,70000,557,1000,0.557,619,0.619,176,0.176,75
49491,39664,9827,31336,80,71000,575,1000,0.575,607,0.607,182,0.182,75
50033,40010,10023,31990,81,72000,542,1000,0.542,654,0.654,196,0.196,75
50590,40419,10171,32581,82,73000,557,1000,0.557,591,0.591,148,0.148,75
51122,40768,10354,33232,83,74000,532,1000,0.532,651,0.651,183,0.183,75
51655,41132,10523,33868,84,75000,533,1000,0.533,636,0.636,169,0.169,75
52221,41540,10681,34460,85,76000,566,1000,0.566,592,0.592,158,0.158,75
52760,41905,10855,35095,86,77000,539,1000,0.539,635,0.635,174,0.174,75
53304,42291,11013,35709,87,78000,544,1000,0.544,614,0.614,158,0.158,75
53843,42639,11204,36361,88,79000,539,1000,0.539,652,0.652,191,0.191,75
54396,43012,11384,36988,89,80000,553,1000,0.553,627,0.627,180,0.18,75
54921,43359,11562,37641,90,81000,525,1000,0.525,653,0.653,178,0.178,75
55453,43714,11739,38286,91,82000,532,1000,0.532,645,0.645,177,0.177,75
55981,44069,11912,38931,92,83000,528,1000,0.528,645,0.645,173,0.173,75
56526,44465,12061,39535,93,84000,545,1000,0.545,604,0.604,149,0.149,75
57076,44859,12217,40141,94,85000,550,1000,0.55,606,0.606,156,0.156,75
57610,45232,12378,40768,95,86000,534,1000,0.534,627,0.627,161,0.161,75
58154,45604,12550,41396,96,87000,544,1000,0.544,628,0.628,172,0.172,75
58693,45990,12703,42010,97,88000,539,1000,0.539,614,0.614,153,0.153,75
59240,46371,12869,42629,98,89000,547,1000,0.547,619,0.619,166,0.166,75
59737,46700,13037,43300,99,90000,497,1000,0.497,671,0.671,168,0.168,75
60258,47058,13200,43942,100,91000,521,1000,0.521,642,0.642,163,0.163,75
60775,47425,13350,44575,101,92000,517,1000,0.517,633,0.633,150,0.15,75
61290,47751,13539,45249,102,93000,515,1000,0.515,674,0.674,189,0.189,75
61812,48088,13724,45912,103,94000,522,1000,0.522,663,0.663,185,0.185,75
62329,48443,13886,46557,104,95000,517,1000,0.517,645,0.645,162,0.162,75
62862,48819,14043,47181,105,96000,533,1000,0.533,624,0.624,157,0.157,75
63380,49147,14233,47853,106,97000,518,1000,0.518,672,0.672,190,0.19,75
63878,49474,14404,48526,107,98000,498,1000,0.498,673,0.673,171,0.171,75
64374,49779,14595,49221,108,99000,496,1000,0.496,695,0.695,191,0.191,75
64886,50135,14751,49865,109,100000,512,1000,0.512,644,0.644,156,0.156,75
65365,50419,14946,50581,110,101000,479,1000,0.479,716,0.716,195,0.195,75
65852,50716,15136,51284,111,102000,487,1000,0.487,703,0.703,190,0.19,75
66340,51027,15313,51973,112,103000,488,1000,0.488,689,0.689,177,0.177,75
66839,51347,15492,52653,113,104000,499,1000,0.499,680,0.68,179,0.179,75
67342,51682,15660,53318,114,105000,503,1000,0.503,665,0.665,168,0.168,75
67849,52030,15819,53970,115,106000,507,1000,0.507,652,0.652,159,0.159,75
68326,52354,15972,54646,116,107000,477,1000,0.477,676,0.676,153,0.153,75
68804,52658,16146,55342,117,108000,478,1000,0.478,696,0.696,174,0.174,75
69297,52980,16317,56020,118,109000,493,1000,0.493,678,0.678,171,0.171,75
69797,53317,16480,56683,119,110000,500,1000,0.5,663,0.663,163,0.163,75
70283,53639,16644,57361,120,111000,486,1000,0.486,678,0.678,164,0.164,75
70768,53953,16815,58047,121,112000,485,1000,0.485,686,0.686,171,0.171,75
71235,54224,17011,58776,122,113000,467,1000,0.467,729,0.729,196,0.196,75
71724,54551,17173,59449,123,114000,489,1000,0.489,673,0.673,162,0.162,75
71869,54638,17231,59660,124,114298,145,298,0.4865771812080537,211,0.7080536912751678,58,0.19463087248322147,75
100,100,0,0,1,100,NA,NA,NA,NA,NA,NA,NA,76
200,200,0,0,2,200,100,100,1,0,0,0,0,76
299,298,1,2,3,300,99,100,0.99,2,0.02,1,0.01,76
398,396,2,4,4,400,99,100,0.99,2,0.02,1,0.01,76
494,488,6,12,5,500,96,100,0.96,8,0.08,4,0.04,76
592,584,8,16,6,600,98,100,0.98,4,0.04,2,0.02,76
690,680,10,20,7,700,98,100,0.98,4,0.04,2,0.02,76
786,772,14,28,8,800,96,100,0.96,8,0.08,4,0.04,76
884,869,15,31,9,900,98,100,0.98,3,0.03,1,0.01,76
981,964,17,36,10,1000,97,100,0.97,5,0.05,2,0.02,76
1944,1901,43,99,11,2000,963,1000,0.963,63,0.063,26,0.026,76
2880,2791,89,209,12,3000,936,1000,0.936,110,0.11,46,0.046,76
3805,3666,139,334,13,4000,925,1000,0.925,125,0.125,50,0.05,76
4697,4478,219,522,14,5000,892,1000,0.892,188,0.188,80,0.08,76
5583,5286,297,714,15,6000,886,1000,0.886,192,0.192,78,0.078,76
6457,6078,379,922,16,7000,874,1000,0.874,208,0.208,82,0.082,76
7318,6850,468,1150,17,8000,861,1000,0.861,228,0.228,89,0.089,76
8166,7595,571,1405,18,9000,848,1000,0.848,255,0.255,103,0.103,76
9007,8342,665,1658,19,10000,841,1000,0.841,253,0.253,94,0.094,76
9844,9064,780,1936,20,11000,837,1000,0.837,278,0.278,115,0.115,76
10686,9805,881,2195,21,12000,842,1000,0.842,259,0.259,101,0.101,76
11474,10468,1006,2532,22,13000,788,1000,0.788,337,0.337,125,0.125,76
12302,11207,1095,2793,23,14000,828,1000,0.828,261,0.261,89,0.089,76
13112,11915,1197,3085,24,15000,810,1000,0.81,292,0.292,102,0.102,76
13908,12595,1313,3405,25,16000,796,1000,0.796,320,0.32,116,0.116,76
14678,13246,1432,3754,26,17000,770,1000,0.77,349,0.349,119,0.119,76
15447,13897,1550,4103,27,18000,769,1000,0.769,349,0.349,118,0.118,76
16194,14508,1686,4492,28,19000,747,1000,0.747,389,0.389,136,0.136,76
16942,15113,1829,4887,29,20000,748,1000,0.748,395,0.395,143,0.143,76
17690,15737,1953,5263,30,21000,748,1000,0.748,376,0.376,124,0.124,76
18448,16365,2083,5635,31,22000,758,1000,0.758,372,0.372,130,0.13,76
19167,16926,2241,6074,32,23000,719,1000,0.719,439,0.439,158,0.158,76
19899,17532,2367,6468,33,24000,732,1000,0.732,394,0.394,126,0.126,76
20622,18110,2512,6890,34,25000,723,1000,0.723,422,0.422,145,0.145,76
21364,18729,2635,7271,35,26000,742,1000,0.742,381,0.381,123,0.123,76
22073,19284,2789,7716,36,27000,709,1000,0.709,445,0.445,154,0.154,76
22772,19853,2919,8147,37,28000,699,1000,0.699,431,0.431,130,0.13,76
23458,20393,3065,8607,38,29000,686,1000,0.686,460,0.46,146,0.146,76
24164,20947,3217,9053,39,30000,706,1000,0.706,446,0.446,152,0.152,76
24833,21458,3375,9542,40,31000,669,1000,0.669,489,0.489,158,0.158,76
25508,21969,3539,10031,41,32000,675,1000,0.675,489,0.489,164,0.164,76
26216,22543,3673,10457,42,33000,708,1000,0.708,426,0.426,134,0.134,76
26895,23079,3816,10921,43,34000,679,1000,0.679,464,0.464,143,0.143,76
27565,23595,3970,11405,44,35000,670,1000,0.67,484,0.484,154,0.154,76
28214,24073,4141,11927,45,36000,649,1000,0.649,522,0.522,171,0.171,76
28891,24597,4294,12403,46,37000,677,1000,0.677,476,0.476,153,0.153,76
29559,25113,4446,12887,47,38000,668,1000,0.668,484,0.484,152,0.152,76
30212,25600,4612,13400,48,39000,653,1000,0.653,513,0.513,166,0.166,76
30893,26133,4760,13867,49,40000,681,1000,0.681,467,0.467,148,0.148,76
31534,26619,4915,14381,50,41000,641,1000,0.641,514,0.514,155,0.155,76
32198,27143,5055,14857,51,42000,664,1000,0.664,476,0.476,140,0.14,76
32867,27680,5187,15320,52,43000,669,1000,0.669,463,0.463,132,0.132,76
33524,28186,5338,15814,53,44000,657,1000,0.657,494,0.494,151,0.151,76
34130,28623,5507,16377,54,45000,606,1000,0.606,563,0.563,169,0.169,76
34754,29093,5661,16907,55,46000,624,1000,0.624,530,0.53,154,0.154,76
35376,29550,5826,17450,56,47000,622,1000,0.622,543,0.543,165,0.165,76
35999,30006,5993,17994,57,48000,623,1000,0.623,544,0.544,167,0.167,76
36618,30460,6158,18540,58,49000,619,1000,0.619,546,0.546,165,0.165,76
37227,30909,6318,19091,59,50000,609,1000,0.609,551,0.551,160,0.16,76
37851,31382,6469,19618,60,51000,624,1000,0.624,527,0.527,151,0.151,76
38464,31816,6648,20184,61,52000,613,1000,0.613,566,0.566,179,0.179,76
39083,32270,6813,20730,62,53000,619,1000,0.619,546,0.546,165,0.165,76
39669,32696,6973,21304,63,54000,586,1000,0.586,574,0.574,160,0.16,76
40245,33102,7143,21898,64,55000,576,1000,0.576,594,0.594,170,0.17,76
40844,33526,7318,22474,65,56000,599,1000,0.599,576,0.576,175,0.175,76
41423,33927,7496,23073,66,57000,579,1000,0.579,599,0.599,178,0.178,76
42008,34344,7664,23656,67,58000,585,1000,0.585,583,0.583,168,0.168,76
42602,34767,7835,24233,68,59000,594,1000,0.594,577,0.577,171,0.171,76
43196,35205,7991,24795,69,60000,594,1000,0.594,562,0.562,156,0.156,76
43767,35624,8143,25376,70,61000,571,1000,0.571,581,0.581,152,0.152,76
44363,36057,8306,25943,71,62000,596,1000,0.596,567,0.567,163,0.163,76
44932,36453,8479,26547,72,63000,569,1000,0.569,604,0.604,173,0.173,76
45498,36861,8637,27139,73,64000,566,1000,0.566,592,0.592,158,0.158,76
46074,37280,8794,27720,74,65000,576,1000,0.576,581,0.581,157,0.157,76
46662,37705,8957,28295,75,66000,588,1000,0.588,575,0.575,163,0.163,76
47243,38129,9114,28871,76,67000,581,1000,0.581,576,0.576,157,0.157,76
47807,38514,9293,29486,77,68000,564,1000,0.564,615,0.615,179,0.179,76
48382,38937,9445,30063,78,69000,575,1000,0.575,577,0.577,152,0.152,76
48976,39383,9593,30617,79,70000,594,1000,0.594,554,0.554,148,0.148,76
49532,39769,9763,31231,80,71000,556,1000,0.556,614,0.614,170,0.17,76
50110,40193,9917,31807,81,72000,578,1000,0.578,576,0.576,154,0.154,76
50687,40602,10085,32398,82,73000,577,1000,0.577,591,0.591,168,0.168,76
51250,40999,10251,33001,83,74000,563,1000,0.563,603,0.603,166,0.166,76
51774,41326,10448,33674,84,75000,524,1000,0.524,673,0.673,197,0.197,76
52328,41716,10612,34284,85,76000,554,1000,0.554,610,0.61,164,0.164,76
52886,42099,10787,34901,86,77000,558,1000,0.558,617,0.617,175,0.175,76
53426,42454,10972,35546,87,78000,540,1000,0.54,645,0.645,185,0.185,76
53968,42827,11141,36173,88,79000,542,1000,0.542,627,0.627,169,0.169,76
54506,43202,11304,36798,89,80000,538,1000,0.538,625,0.625,163,0.163,76
55038,43558,11480,37442,90,81000,532,1000,0.532,644,0.644,176,0.176,76
55573,43928,11645,38072,91,82000,535,1000,0.535,630,0.63,165,0.165,76
56121,44308,11813,38692,92,83000,548,1000,0.548,620,0.62,168,0.168,76
56648,44658,11990,39342,93,84000,527,1000,0.527,650,0.65,177,0.177,76
57171,45004,12167,39996,94,85000,523,1000,0.523,654,0.654,177,0.177,76
57692,45344,12348,40656,95,86000,521,1000,0.521,660,0.66,181,0.181,76
58223,45719,12504,41281,96,87000,531,1000,0.531,625,0.625,156,0.156,76
58740,46069,12671,41931,97,88000,517,1000,0.517,650,0.65,167,0.167,76
59273,46443,12830,42557,98,89000,533,1000,0.533,626,0.626,159,0.159,76
59788,46783,13005,43217,99,90000,515,1000,0.515,660,0.66,175,0.175,76
60296,47108,13188,43892,100,91000,508,1000,0.508,675,0.675,183,0.183,76
60799,47428,13371,44572,101,92000,503,1000,0.503,680,0.68,183,0.183,76
61296,47751,13545,45249,102,93000,497,1000,0.497,677,0.677,174,0.174,76
61827,48120,13707,45880,103,94000,531,1000,0.531,631,0.631,162,0.162,76
62340,48479,13861,46521,104,95000,513,1000,0.513,641,0.641,154,0.154,76
62858,48824,14034,47176,105,96000,518,1000,0.518,655,0.655,173,0.173,76
63361,49165,14196,47835,106,97000,503,1000,0.503,659,0.659,162,0.162,76
63883,49527,14356,48473,107,98000,522,1000,0.522,638,0.638,160,0.16,76
64414,49894,14520,49106,108,99000,531,1000,0.531,633,0.633,164,0.164,76
64948,50266,14682,49734,109,100000,534,1000,0.534,628,0.628,162,0.162,76
65430,50560,14870,50440,110,101000,482,1000,0.482,706,0.706,188,0.188,76
65938,50901,15037,51099,111,102000,508,1000,0.508,659,0.659,167,0.167,76
66409,51160,15249,51840,112,103000,471,1000,0.471,741,0.741,212,0.212,76
66922,51513,15409,52487,113,104000,513,1000,0.513,647,0.647,160,0.16,76
67399,51794,15605,53206,114,105000,477,1000,0.477,719,0.719,196,0.196,76
67892,52127,15765,53873,115,106000,493,1000,0.493,667,0.667,160,0.16,76
68370,52428,15942,54572,116,107000,478,1000,0.478,699,0.699,177,0.177,76
68840,52695,16145,55305,117,108000,470,1000,0.47,733,0.733,203,0.203,76
69319,52998,16321,56002,118,109000,479,1000,0.479,697,0.697,176,0.176,76
69793,53313,16480,56687,119,110000,474,1000,0.474,685,0.685,159,0.159,76
70289,53638,16651,57362,120,111000,496,1000,0.496,675,0.675,171,0.171,76
70745,53920,16825,58080,121,112000,456,1000,0.456,718,0.718,174,0.174,76
71234,54222,17012,58778,122,113000,489,1000,0.489,698,0.698,187,0.187,76
71724,54551,17173,59449,123,114000,490,1000,0.49,671,0.671,161,0.161,76
71869,54638,17231,59660,124,114298,145,298,0.4865771812080537,211,0.7080536912751678,58,0.19463087248322147,76
100,100,0,0,1,100,NA,NA,NA,NA,NA,NA,NA,77
200,200,0,0,2,200,100,100,1,0,0,0,0,77
300,300,0,0,3,300,100,100,1,0,0,0,0,77
397,394,3,6,4,400,97,100,0.97,6,0.06,3,0.03,77
496,492,4,8,5,500,99,100,0.99,2,0.02,1,0.01,77
593,586,7,14,6,600,97,100,0.97,6,0.06,3,0.03,77
689,680,9,20,7,700,96,100,0.96,6,0.06,2,0.02,77
788,779,9,21,8,800,99,100,0.99,1,0.01,0,0,77
883,869,14,31,9,900,95,100,0.95,10,0.1,5,0.05,77
979,963,16,37,10,1000,96,100,0.96,6,0.06,2,0.02,77
1935,1889,46,111,11,2000,956,1000,0.956,74,0.074,30,0.03,77
2866,2766,100,234,12,3000,931,1000,0.931,123,0.123,54,0.054,77
3783,3618,165,382,13,4000,917,1000,0.917,148,0.148,65,0.065,77
4674,4435,239,565,14,5000,891,1000,0.891,183,0.183,74,0.074,77
5563,5252,311,748,15,6000,889,1000,0.889,183,0.183,72,0.072,77
6437,6046,391,954,16,7000,874,1000,0.874,206,0.206,80,0.08,77
7291,6820,471,1180,17,8000,854,1000,0.854,226,0.226,80,0.08,77
8133,7561,572,1439,18,9000,842,1000,0.842,259,0.259,101,0.101,77
8978,8298,680,1702,19,10000,845,1000,0.845,263,0.263,108,0.108,77
9785,8991,794,2009,20,11000,807,1000,0.807,307,0.307,114,0.114,77
10635,9747,888,2253,21,12000,850,1000,0.85,244,0.244,94,0.094,77
11421,10404,1017,2596,22,13000,786,1000,0.786,343,0.343,129,0.129,77
12232,11103,1129,2897,23,14000,811,1000,0.811,301,0.301,112,0.112,77
13052,11829,1223,3171,24,15000,820,1000,0.82,274,0.274,94,0.094,77
13834,12489,1345,3511,25,16000,782,1000,0.782,340,0.34,122,0.122,77
14605,13118,1487,3882,26,17000,771,1000,0.771,371,0.371,142,0.142,77
15369,13752,1617,4248,27,18000,764,1000,0.764,366,0.366,130,0.13,77
16132,14386,1746,4614,28,19000,763,1000,0.763,366,0.366,129,0.129,77
16898,15031,1867,4969,29,20000,766,1000,0.766,355,0.355,121,0.121,77
17660,15675,1985,5325,30,21000,762,1000,0.762,356,0.356,118,0.118,77
18397,16289,2108,5711,31,22000,737,1000,0.737,386,0.386,123,0.123,77
19140,16893,2247,6107,32,23000,743,1000,0.743,396,0.396,139,0.139,77
19878,17495,2383,6505,33,24000,738,1000,0.738,398,0.398,136,0.136,77
20588,18063,2525,6937,34,25000,710,1000,0.71,432,0.432,142,0.142,77
21322,18671,2651,7329,35,26000,734,1000,0.734,392,0.392,126,0.126,77
22026,19228,2798,7772,36,27000,704,1000,0.704,443,0.443,147,0.147,77
22711,19753,2958,8247,37,28000,685,1000,0.685,475,0.475,160,0.16,77
23422,20332,3090,8668,38,29000,711,1000,0.711,421,0.421,132,0.132,77
24105,20858,3247,9142,39,30000,683,1000,0.683,474,0.474,157,0.157,77
24813,21425,3388,9575,40,31000,708,1000,0.708,433,0.433,141,0.141,77
25512,21982,3530,10018,41,32000,699,1000,0.699,443,0.443,142,0.142,77
26182,22480,3702,10520,42,33000,670,1000,0.67,502,0.502,172,0.172,77
26861,22996,3865,11004,43,34000,679,1000,0.679,484,0.484,163,0.163,77
27530,23497,4033,11503,44,35000,669,1000,0.669,499,0.499,168,0.168,77
28171,23983,4188,12017,45,36000,641,1000,0.641,514,0.514,155,0.155,77
28817,24463,4354,12537,46,37000,646,1000,0.646,520,0.52,166,0.166,77
29488,24988,4500,13012,47,38000,671,1000,0.671,475,0.475,146,0.146,77
30119,25459,4660,13541,48,39000,631,1000,0.631,529,0.529,160,0.16,77
30764,25947,4817,14053,49,40000,645,1000,0.645,512,0.512,157,0.157,77
31417,26444,4973,14556,50,41000,653,1000,0.653,503,0.503,156,0.156,77
32059,26938,5121,15062,51,42000,642,1000,0.642,506,0.506,148,0.148,77
32684,27391,5293,15609,52,43000,625,1000,0.625,547,0.547,172,0.172,77
33333,27877,5456,16123,53,44000,649,1000,0.649,514,0.514,163,0.163,77
33966,28342,5624,16658,54,45000,633,1000,0.633,535,0.535,168,0.168,77
34608,28839,5769,17161,55,46000,642,1000,0.642,503,0.503,145,0.145,77
35230,29307,5923,17693,56,47000,622,1000,0.622,532,0.532,154,0.154,77
35843,29757,6086,18243,57,48000,613,1000,0.613,550,0.55,163,0.163,77
36454,30196,6258,18804,58,49000,611,1000,0.611,561,0.561,172,0.172,77
37104,30687,6417,19313,59,50000,650,1000,0.65,509,0.509,159,0.159,77
37717,31122,6595,19878,60,51000,613,1000,0.613,565,0.565,178,0.178,77
38330,31572,6758,20428,61,52000,613,1000,0.613,550,0.55,163,0.163,77
38929,32024,6905,20976,62,53000,599,1000,0.599,548,0.548,147,0.147,77
39508,32431,7077,21569,63,54000,579,1000,0.579,593,0.593,172,0.172,77
40118,32863,7255,22137,64,55000,610,1000,0.61,568,0.568,178,0.178,77
40710,33291,7419,22709,65,56000,592,1000,0.592,572,0.572,164,0.164,77
41301,33704,7597,23296,66,57000,591,1000,0.591,587,0.587,178,0.178,77
41880,34108,7772,23892,67,58000,579,1000,0.579,596,0.596,175,0.175,77
42447,34500,7947,24500,68,59000,567,1000,0.567,608,0.608,175,0.175,77
43046,34936,8110,25064,69,60000,599,1000,0.599,564,0.564,163,0.163,77
43640,35370,8270,25630,70,61000,594,1000,0.594,566,0.566,160,0.16,77
44222,35785,8437,26215,71,62000,582,1000,0.582,585,0.585,167,0.167,77
44806,36189,8617,26811,72,63000,584,1000,0.584,596,0.596,180,0.18,77
45386,36607,8779,27393,73,64000,580,1000,0.58,582,0.582,162,0.162,77
45967,37025,8942,27975,74,65000,581,1000,0.581,582,0.582,163,0.163,77
46572,37466,9106,28534,75,66000,605,1000,0.605,559,0.559,164,0.164,77
47154,37891,9263,29109,76,67000,582,1000,0.582,575,0.575,157,0.157,77
47726,38297,9429,29703,77,68000,572,1000,0.572,594,0.594,166,0.166,77
48292,38689,9603,30311,78,69000,566,1000,0.566,608,0.608,174,0.174,77
48875,39121,9754,30879,79,70000,583,1000,0.583,568,0.568,151,0.151,77
49403,39465,9938,31535,80,71000,528,1000,0.528,656,0.656,184,0.184,77
49968,39868,10100,32132,81,72000,565,1000,0.565,597,0.597,162,0.162,77
50534,40268,10266,32732,82,73000,566,1000,0.566,600,0.6,166,0.166,77
51087,40663,10424,33337,83,74000,553,1000,0.553,605,0.605,158,0.158,77
51643,41065,10578,33935,84,75000,556,1000,0.556,598,0.598,154,0.154,77
52204,41445,10759,34555,85,76000,561,1000,0.561,620,0.62,181,0.181,77
52749,41818,10931,35182,86,77000,545,1000,0.545,627,0.627,172,0.172,77
53278,42181,11097,35819,87,78000,529,1000,0.529,637,0.637,166,0.166,77
53844,42578,11266,36422,88,79000,566,1000,0.566,603,0.603,169,0.169,77
54375,42924,11451,37076,89,80000,531,1000,0.531,654,0.654,185,0.185,77
54929,43318,11611,37682,90,81000,554,1000,0.554,606,0.606,160,0.16,77
55457,43685,11772,38315,91,82000,528,1000,0.528,633,0.633,161,0.161,77
56012,44082,11930,38918,92,83000,555,1000,0.555,603,0.603,158,0.158,77
56543,44451,12092,39549,93,84000,531,1000,0.531,631,0.631,162,0.162,77
57056,44798,12258,40202,94,85000,513,1000,0.513,653,0.653,166,0.166,77
57610,45186,12424,40814,95,86000,554,1000,0.554,612,0.612,166,0.166,77
58153,45573,12580,41427,96,87000,543,1000,0.543,613,0.613,156,0.156,77
58650,45871,12779,42129,97,88000,497,1000,0.497,702,0.702,199,0.199,77
59157,46220,12937,42780,98,89000,507,1000,0.507,651,0.651,158,0.158,77
59690,46602,13088,43398,99,90000,533,1000,0.533,618,0.618,151,0.151,77
60223,46987,13236,44013,100,91000,533,1000,0.533,615,0.615,148,0.148,77
60760,47349,13411,44651,101,92000,537,1000,0.537,638,0.638,175,0.175,77
61266,47676,13590,45324,102,93000,506,1000,0.506,673,0.673,179,0.179,77
61770,48015,13755,45985,103,94000,504,1000,0.504,661,0.661,165,0.165,77
62283,48367,13916,46633,104,95000,513,1000,0.513,648,0.648,161,0.161,77
62805,48719,14086,47281,105,96000,522,1000,0.522,648,0.648,170,0.17,77
63314,49075,14239,47925,106,97000,509,1000,0.509,644,0.644,153,0.153,77
63821,49409,14412,48591,107,98000,507,1000,0.507,666,0.666,173,0.173,77
64335,49742,14593,49258,108,99000,514,1000,0.514,667,0.667,181,0.181,77
64852,50081,14771,49919,109,100000,517,1000,0.517,661,0.661,178,0.178,77
65344,50402,14942,50598,110,101000,492,1000,0.492,679,0.679,171,0.171,77
65844,50724,15120,51276,111,102000,500,1000,0.5,678,0.678,178,0.178,77
66345,51051,15294,51949,112,103000,501,1000,0.501,673,0.673,174,0.174,77
66867,51411,15456,52589,113,104000,522,1000,0.522,640,0.64,162,0.162,77
67358,51728,15630,53272,114,105000,491,1000,0.491,683,0.683,174,0.174,77
67829,52006,15823,53994,115,106000,471,1000,0.471,722,0.722,193,0.193,77
68334,52359,15975,54641,116,107000,505,1000,0.505,647,0.647,152,0.152,77
68848,52707,16141,55293,117,108000,514,1000,0.514,652,0.652,166,0.166,77
69345,53041,16304,55959,118,109000,497,1000,0.497,666,0.666,163,0.163,77
69838,53361,16477,56639,119,110000,493,1000,0.493,680,0.68,173,0.173,77
70324,53679,16645,57321,120,111000,486,1000,0.486,682,0.682,168,0.168,77
70803,53973,16830,58027,121,112000,479,1000,0.479,706,0.706,185,0.185,77
71266,54260,17006,58740,122,113000,463,1000,0.463,713,0.713,176,0.176,77
71728,54548,17180,59452,123,114000,462,1000,0.462,712,0.712,174,0.174,77
71869,54638,17231,59660,124,114298,141,298,0.47315436241610737,208,0.697986577181208,51,0.17114093959731544,77
100,100,0,0,1,100,NA,NA,NA,NA,NA,NA,NA,78
200,200,0,0,2,200,100,100,1,0,0,0,0,78
300,300,0,0,3,300,100,100,1,0,0,0,0,78
400,400,0,0,4,400,100,100,1,0,0,0,0,78
499,498,1,2,5,500,99,100,0.99,2,0.02,1,0.01,78
597,594,3,6,6,600,98,100,0.98,4,0.04,2,0.02,78
694,689,5,11,7,700,97,100,0.97,5,0.05,2,0.02,78
789,780,9,20,8,800,95,100,0.95,9,0.09,4,0.04,78
885,872,13,28,9,900,96,100,0.96,8,0.08,4,0.04,78
984,970,14,30,10,1000,99,100,0.99,2,0.02,1,0.01,78
1936,1884,52,116,11,2000,952,1000,0.952,86,0.086,38,0.038,78
2867,2765,102,235,12,3000,931,1000,0.931,119,0.119,50,0.05,78
3772,3603,169,397,13,4000,905,1000,0.905,162,0.162,67,0.067,78
4661,4421,240,579,14,5000,889,1000,0.889,182,0.182,71,0.071,78
5530,5202,328,798,15,6000,869,1000,0.869,219,0.219,88,0.088,78
6394,5986,408,1014,16,7000,864,1000,0.864,216,0.216,80,0.08,78
7268,6777,491,1223,17,8000,874,1000,0.874,209,0.209,83,0.083,78
8114,7533,581,1467,18,9000,846,1000,0.846,244,0.244,90,0.09,78
8980,8321,659,1679,19,10000,866,1000,0.866,212,0.212,78,0.078,78
9820,9060,760,1940,20,11000,840,1000,0.84,261,0.261,101,0.101,78
10653,9795,858,2205,21,12000,833,1000,0.833,265,0.265,98,0.098,78
11463,10498,965,2502,22,13000,810,1000,0.81,297,0.297,107,0.107,78
12258,11166,1092,2834,23,14000,795,1000,0.795,332,0.332,127,0.127,78
13026,11813,1213,3187,24,15000,768,1000,0.768,353,0.353,121,0.121,78
13825,12498,1327,3502,25,16000,799,1000,0.799,315,0.315,114,0.114,78
14624,13177,1447,3823,26,17000,799,1000,0.799,321,0.321,120,0.12,78
15418,13846,1572,4154,27,18000,794,1000,0.794,331,0.331,125,0.125,78
16176,14463,1713,4537,28,19000,758,1000,0.758,383,0.383,141,0.141,78
16959,15123,1836,4877,29,20000,783,1000,0.783,340,0.34,123,0.123,78
17703,15720,1983,5280,30,21000,744,1000,0.744,403,0.403,147,0.147,78
18430,16317,2113,5683,31,22000,727,1000,0.727,403,0.403,130,0.13,78
19162,16907,2255,6093,32,23000,732,1000,0.732,410,0.41,142,0.142,78
19869,17468,2401,6532,33,24000,707,1000,0.707,439,0.439,146,0.146,78
20592,18048,2544,6952,34,25000,723,1000,0.723,420,0.42,143,0.143,78
21299,18606,2693,7394,35,26000,707,1000,0.707,442,0.442,149,0.149,78
22023,19188,2835,7812,36,27000,724,1000,0.724,418,0.418,142,0.142,78
22762,19800,2962,8200,37,28000,739,1000,0.739,388,0.388,127,0.127,78
23474,20381,3093,8619,38,29000,712,1000,0.712,419,0.419,131,0.131,78
24178,20940,3238,9060,39,30000,704,1000,0.704,441,0.441,145,0.145,78
24875,21510,3365,9490,40,31000,697,1000,0.697,430,0.43,127,0.127,78
25574,22063,3511,9937,41,32000,699,1000,0.699,447,0.447,146,0.146,78
26252,22586,3666,10414,42,33000,678,1000,0.678,477,0.477,155,0.155,78
26930,23104,3826,10896,43,34000,678,1000,0.678,482,0.482,160,0.16,78
27611,23625,3986,11375,44,35000,681,1000,0.681,479,0.479,160,0.16,78
28301,24168,4133,11832,45,36000,690,1000,0.69,457,0.457,147,0.147,78
28966,24687,4279,12313,46,37000,665,1000,0.665,481,0.481,146,0.146,78
29606,25161,4445,12839,47,38000,640,1000,0.64,526,0.526,166,0.166,78
30268,25665,4603,13335,48,39000,662,1000,0.662,496,0.496,158,0.158,78
30933,26170,4763,13830,49,40000,665,1000,0.665,495,0.495,160,0.16,78
31573,26643,4930,14357,50,41000,640,1000,0.64,527,0.527,167,0.167,78
32210,27122,5088,14878,51,42000,637,1000,0.637,521,0.521,158,0.158,78
32849,27616,5233,15384,52,43000,639,1000,0.639,506,0.506,145,0.145,78
33491,28100,5391,15900,53,44000,642,1000,0.642,516,0.516,158,0.158,78
34112,28556,5556,16444,54,45000,621,1000,0.621,544,0.544,165,0.165,78
34737,29022,5715,16978,55,46000,625,1000,0.625,534,0.534,159,0.159,78
35351,29467,5884,17533,56,47000,614,1000,0.614,555,0.555,169,0.169,78
35970,29935,6035,18065,57,48000,619,1000,0.619,532,0.532,151,0.151,78
36602,30421,6181,18579,58,49000,632,1000,0.632,514,0.514,146,0.146,78
37209,30853,6356,19147,59,50000,607,1000,0.607,568,0.568,175,0.175,78
37828,31329,6499,19671,60,51000,619,1000,0.619,524,0.524,143,0.143,78
38430,31769,6661,20231,61,52000,602,1000,0.602,560,0.56,162,0.162,78
39039,32204,6835,20796,62,53000,609,1000,0.609,565,0.565,174,0.174,78
39635,32641,6994,21359,63,54000,596,1000,0.596,563,0.563,159,0.159,78
40250,33086,7164,21914,64,55000,615,1000,0.615,555,0.555,170,0.17,78
40863,33533,7330,22467,65,56000,613,1000,0.613,553,0.553,166,0.166,78
41463,33965,7498,23035,66,57000,600,1000,0.6,568,0.568,168,0.168,78
42055,34397,7658,23603,67,58000,592,1000,0.592,568,0.568,160,0.16,78
42626,34798,7828,24202,68,59000,571,1000,0.571,599,0.599,170,0.17,78
43231,35262,7969,24738,69,60000,605,1000,0.605,536,0.536,141,0.141,78
43814,35688,8126,25312,70,61000,583,1000,0.583,574,0.574,157,0.157,78
44404,36117,8287,25883,71,62000,590,1000,0.59,571,0.571,161,0.161,78
44960,36502,8458,26498,72,63000,556,1000,0.556,615,0.615,171,0.171,78
45554,36916,8638,27084,73,64000,594,1000,0.594,586,0.586,180,0.18,78
46121,37322,8799,27678,74,65000,567,1000,0.567,594,0.594,161,0.161,78
46720,37764,8956,28236,75,66000,599,1000,0.599,558,0.558,157,0.157,78
47305,38192,9113,28808,76,67000,585,1000,0.585,572,0.572,157,0.157,78
47854,38568,9286,29432,77,68000,549,1000,0.549,624,0.624,173,0.173,78
48412,38958,9454,30042,78,69000,558,1000,0.558,610,0.61,168,0.168,78
48988,39375,9613,30625,79,70000,576,1000,0.576,583,0.583,159,0.159,78
49537,39728,9809,31272,80,71000,549,1000,0.549,647,0.647,196,0.196,78
50121,40162,9959,31838,81,72000,584,1000,0.584,566,0.566,150,0.15,78
50692,40564,10128,32436,82,73000,571,1000,0.571,598,0.598,169,0.169,78
51251,40963,10288,33037,83,74000,559,1000,0.559,601,0.601,160,0.16,78
51787,41329,10458,33671,84,75000,536,1000,0.536,634,0.634,170,0.17,78
52338,41713,10625,34287,85,76000,551,1000,0.551,616,0.616,167,0.167,78
52884,42093,10791,34907,86,77000,546,1000,0.546,620,0.62,166,0.166,78
53427,42460,10967,35540,87,78000,543,1000,0.543,633,0.633,176,0.176,78
53962,42810,11152,36190,88,79000,535,1000,0.535,650,0.65,185,0.185,78
54494,43161,11333,36839,89,80000,532,1000,0.532,649,0.649,181,0.181,78
55054,43557,11497,37443,90,81000,560,1000,0.56,604,0.604,164,0.164,78
55605,43937,11668,38063,91,82000,551,1000,0.551,620,0.62,171,0.171,78
56129,44277,11852,38723,92,83000,524,1000,0.524,660,0.66,184,0.184,78
56676,44662,12014,39338,93,84000,547,1000,0.547,615,0.615,162,0.162,78
57182,44984,12198,40016,94,85000,506,1000,0.506,678,0.678,184,0.184,78
57707,45332,12375,40668,95,86000,525,1000,0.525,652,0.652,177,0.177,78
58239,45685,12554,41315,96,87000,532,1000,0.532,647,0.647,179,0.179,78
58761,46059,12702,41941,97,88000,522,1000,0.522,626,0.626,148,0.148,78
59284,46409,12875,42591,98,89000,523,1000,0.523,650,0.65,173,0.173,78
59780,46735,13045,43265,99,90000,496,1000,0.496,674,0.674,170,0.17,78
60271,47047,13224,43953,100,91000,491,1000,0.491,688,0.688,179,0.179,78
60786,47403,13383,44597,101,92000,515,1000,0.515,644,0.644,159,0.159,78
61311,47753,13558,45247,102,93000,525,1000,0.525,650,0.65,175,0.175,78
61831,48096,13735,45904,103,94000,520,1000,0.52,657,0.657,177,0.177,78
62332,48418,13914,46582,104,95000,501,1000,0.501,678,0.678,179,0.179,78
62843,48760,14083,47240,105,96000,511,1000,0.511,658,0.658,169,0.169,78
63352,49091,14261,47909,106,97000,509,1000,0.509,669,0.669,178,0.178,78
63836,49410,14426,48590,107,98000,484,1000,0.484,681,0.681,165,0.165,78
64341,49731,14610,49269,108,99000,505,1000,0.505,679,0.679,184,0.184,78
64854,50082,14772,49918,109,100000,513,1000,0.513,649,0.649,162,0.162,78
65337,50400,14937,50600,110,101000,483,1000,0.483,682,0.682,165,0.165,78
65852,50740,15112,51260,111,102000,515,1000,0.515,660,0.66,175,0.175,78
66364,51081,15283,51919,112,103000,512,1000,0.512,659,0.659,171,0.171,78
66844,51390,15454,52610,113,104000,480,1000,0.48,691,0.691,171,0.171,78
67336,51684,15652,53316,114,105000,492,1000,0.492,706,0.706,198,0.198,78
67849,52036,15813,53964,115,106000,513,1000,0.513,648,0.648,161,0.161,78
68330,52341,15989,54659,116,107000,481,1000,0.481,695,0.695,176,0.176,78
68826,52670,16156,55330,117,108000,496,1000,0.496,671,0.671,167,0.167,78
69333,53025,16308,55975,118,109000,507,1000,0.507,645,0.645,152,0.152,78
69852,53381,16471,56619,119,110000,519,1000,0.519,644,0.644,163,0.163,78
70330,53680,16650,57320,120,111000,478,1000,0.478,701,0.701,179,0.179,78
70778,53936,16842,58064,121,112000,448,1000,0.448,744,0.744,192,0.192,78
71253,54251,17002,58749,122,113000,475,1000,0.475,685,0.685,160,0.16,78
71726,54542,17184,59458,123,114000,473,1000,0.473,709,0.709,182,0.182,78
71869,54638,17231,59660,124,114298,143,298,0.4798657718120805,202,0.6778523489932886,47,0.15771812080536912,78
100,100,0,0,1,100,NA,NA,NA,NA,NA,NA,NA,79
200,200,0,0,2,200,100,100,1,0,0,0,0,79
300,300,0,0,3,300,100,100,1,0,0,0,0,79
399,398,1,2,4,400,99,100,0.99,2,0.02,1,0.01,79
497,494,3,6,5,500,98,100,0.98,4,0.04,2,0.02,79
596,592,4,8,6,600,99,100,0.99,2,0.02,1,0.01,79
694,688,6,12,7,700,98,100,0.98,4,0.04,2,0.02,79
789,779,10,21,8,800,95,100,0.95,9,0.09,4,0.04,79
887,876,11,24,9,900,98,100,0.98,3,0.03,1,0.01,79
985,972,13,28,10,1000,98,100,0.98,4,0.04,2,0.02,79
1935,1885,50,115,11,2000,950,1000,0.95,87,0.087,37,0.037,79
2879,2790,89,210,12,3000,944,1000,0.944,95,0.095,39,0.039,79
3792,3637,155,363,13,4000,913,1000,0.913,153,0.153,66,0.066,79
4691,4470,221,530,14,5000,899,1000,0.899,167,0.167,66,0.066,79
5574,5284,290,716,15,6000,883,1000,0.883,186,0.186,69,0.069,79
6470,6115,355,885,16,7000,896,1000,0.896,169,0.169,65,0.065,79
7325,6873,452,1127,17,8000,855,1000,0.855,242,0.242,97,0.097,79
8175,7645,530,1355,18,9000,850,1000,0.85,228,0.228,78,0.078,79
9036,8411,625,1589,19,10000,861,1000,0.861,234,0.234,95,0.095,79
9855,9104,751,1896,20,11000,819,1000,0.819,307,0.307,126,0.126,79
10669,9815,854,2185,21,12000,814,1000,0.814,289,0.289,103,0.103,79
11482,10511,971,2489,22,13000,813,1000,0.813,304,0.304,117,0.117,79
12283,11194,1089,2806,23,14000,801,1000,0.801,317,0.317,118,0.118,79
13069,11865,1204,3135,24,15000,786,1000,0.786,329,0.329,115,0.115,79
13852,12531,1321,3469,25,16000,783,1000,0.783,334,0.334,117,0.117,79
14622,13181,1441,3819,26,17000,770,1000,0.77,350,0.35,120,0.12,79
15384,13810,1574,4190,27,18000,762,1000,0.762,371,0.371,133,0.133,79
16143,14447,1696,4553,28,19000,759,1000,0.759,363,0.363,122,0.122,79
16903,15086,1817,4914,29,20000,760,1000,0.76,361,0.361,121,0.121,79
17635,15685,1950,5315,30,21000,732,1000,0.732,401,0.401,133,0.133,79
18382,16285,2097,5715,31,22000,747,1000,0.747,400,0.4,147,0.147,79
19123,16896,2227,6104,32,23000,741,1000,0.741,389,0.389,130,0.13,79
19861,17506,2355,6494,33,24000,738,1000,0.738,390,0.39,128,0.128,79
20586,18084,2502,6916,34,25000,725,1000,0.725,422,0.422,147,0.147,79
21310,18662,2648,7338,35,26000,724,1000,0.724,422,0.422,146,0.146,79
22043,19250,2793,7750,36,27000,733,1000,0.733,412,0.412,145,0.145,79
22749,19813,2936,8187,37,28000,706,1000,0.706,437,0.437,143,0.143,79
23456,20382,3074,8618,38,29000,707,1000,0.707,431,0.431,138,0.138,79
24135,20914,3221,9086,39,30000,679,1000,0.679,468,0.468,147,0.147,79
24840,21477,3363,9523,40,31000,705,1000,0.705,437,0.437,142,0.142,79
25516,21996,3520,10004,41,32000,676,1000,0.676,481,0.481,157,0.157,79
26207,22545,3662,10455,42,33000,691,1000,0.691,451,0.451,142,0.142,79
26897,23077,3820,10923,43,34000,690,1000,0.69,468,0.468,158,0.158,79
27555,23580,3975,11420,44,35000,658,1000,0.658,497,0.497,155,0.155,79
28252,24135,4117,11865,45,36000,697,1000,0.697,445,0.445,142,0.142,79
28916,24632,4284,12368,46,37000,664,1000,0.664,503,0.503,167,0.167,79
29582,25153,4429,12847,47,38000,666,1000,0.666,479,0.479,145,0.145,79
30266,25669,4597,13331,48,39000,684,1000,0.684,484,0.484,168,0.168,79
30926,26164,4762,13836,49,40000,660,1000,0.66,505,0.505,165,0.165,79
31584,26653,4931,14347,50,41000,658,1000,0.658,511,0.511,169,0.169,79
32244,27163,5081,14837,51,42000,660,1000,0.66,490,0.49,150,0.15,79
32863,27594,5269,15406,52,43000,619,1000,0.619,569,0.569,188,0.188,79
33518,28086,5432,15914,53,44000,655,1000,0.655,508,0.508,163,0.163,79
34160,28573,5587,16427,54,45000,642,1000,0.642,513,0.513,155,0.155,79
34759,28980,5779,17020,55,46000,599,1000,0.599,593,0.593,192,0.192,79
35411,29476,5935,17524,56,47000,652,1000,0.652,504,0.504,156,0.156,79
36038,29947,6091,18053,57,48000,627,1000,0.627,529,0.529,156,0.156,79
36674,30419,6255,18581,58,49000,636,1000,0.636,528,0.528,164,0.164,79
37299,30900,6399,19100,59,50000,625,1000,0.625,519,0.519,144,0.144,79
37907,31336,6571,19664,60,51000,608,1000,0.608,564,0.564,172,0.172,79
38497,31759,6738,20241,61,52000,590,1000,0.59,577,0.577,167,0.167,79
39099,32186,6913,20814,62,53000,602,1000,0.602,573,0.573,175,0.175,79
39684,32600,7084,21400,63,54000,585,1000,0.585,586,0.586,171,0.171,79
40298,33049,7249,21951,64,55000,614,1000,0.614,551,0.551,165,0.165,79
40898,33486,7412,22514,65,56000,600,1000,0.6,563,0.563,163,0.163,79
41529,33968,7561,23032,66,57000,631,1000,0.631,518,0.518,149,0.149,79
42155,34441,7714,23559,67,58000,626,1000,0.626,527,0.527,153,0.153,79
42764,34879,7885,24121,68,59000,609,1000,0.609,562,0.562,171,0.171,79
43350,35302,8048,24698,69,60000,586,1000,0.586,577,0.577,163,0.163,79
43925,35720,8205,25280,70,61000,575,1000,0.575,582,0.582,157,0.157,79
44505,36128,8377,25872,71,62000,580,1000,0.58,592,0.592,172,0.172,79
45058,36522,8536,26478,72,63000,553,1000,0.553,606,0.606,159,0.159,79
45646,36958,8688,27042,73,64000,588,1000,0.588,564,0.564,152,0.152,79
46235,37383,8852,27617,74,65000,589,1000,0.589,575,0.575,164,0.164,79
46819,37806,9013,28194,75,66000,584,1000,0.584,577,0.577,161,0.161,79
47377,38190,9187,28810,76,67000,558,1000,0.558,616,0.616,174,0.174,79
47951,38605,9346,29395,77,68000,574,1000,0.574,585,0.585,159,0.159,79
48496,38975,9521,30025,78,69000,545,1000,0.545,630,0.63,175,0.175,79
49056,39373,9683,30627,79,70000,560,1000,0.56,602,0.602,162,0.162,79
49604,39736,9868,31264,80,71000,548,1000,0.548,637,0.637,185,0.185,79
50163,40129,10034,31871,81,72000,559,1000,0.559,607,0.607,166,0.166,79
50710,40507,10203,32493,82,73000,547,1000,0.547,622,0.622,169,0.169,79
51261,40878,10383,33122,83,74000,551,1000,0.551,629,0.629,180,0.18,79
51806,41257,10549,33743,84,75000,545,1000,0.545,621,0.621,166,0.166,79
52368,41667,10701,34333,85,76000,562,1000,0.562,590,0.59,152,0.152,79
52894,42014,10880,34986,86,77000,526,1000,0.526,653,0.653,179,0.179,79
53419,42349,11070,35651,87,78000,525,1000,0.525,665,0.665,190,0.19,79
53964,42731,11233,36269,88,79000,545,1000,0.545,618,0.618,163,0.163,79
54497,43082,11415,36918,89,80000,533,1000,0.533,649,0.649,182,0.182,79
55022,43444,11578,37556,90,81000,525,1000,0.525,638,0.638,163,0.163,79
55550,43776,11774,38224,91,82000,528,1000,0.528,668,0.668,196,0.196,79
56065,44114,11951,38886,92,83000,515,1000,0.515,662,0.662,177,0.177,79
56583,44465,12118,39535,93,84000,518,1000,0.518,649,0.649,167,0.167,79
57131,44865,12266,40135,94,85000,548,1000,0.548,600,0.6,148,0.148,79
57660,45223,12437,40777,95,86000,529,1000,0.529,642,0.642,171,0.171,79
58185,45567,12618,41433,96,87000,525,1000,0.525,656,0.656,181,0.181,79
58692,45895,12797,42105,97,88000,507,1000,0.507,672,0.672,179,0.179,79
59220,46273,12947,42727,98,89000,528,1000,0.528,622,0.622,150,0.15,79
59742,46623,13119,43377,99,90000,522,1000,0.522,650,0.65,172,0.172,79
60226,46912,13314,44088,100,91000,484,1000,0.484,711,0.711,195,0.195,79
60763,47298,13465,44702,101,92000,537,1000,0.537,614,0.614,151,0.151,79
61300,47666,13634,45334,102,93000,537,1000,0.537,632,0.632,169,0.169,79
61806,48013,13793,45987,103,94000,506,1000,0.506,653,0.653,159,0.159,79
62299,48305,13994,46695,104,95000,493,1000,0.493,708,0.708,201,0.201,79
62816,48645,14171,47355,105,96000,517,1000,0.517,660,0.66,177,0.177,79
63333,49013,14320,47987,106,97000,517,1000,0.517,632,0.632,149,0.149,79
63839,49352,14487,48648,107,98000,506,1000,0.506,661,0.661,167,0.167,79
64333,49661,14672,49339,108,99000,494,1000,0.494,691,0.691,185,0.185,79
64823,49987,14836,50013,109,100000,490,1000,0.49,674,0.674,164,0.164,79
65339,50348,14991,50652,110,101000,516,1000,0.516,639,0.639,155,0.155,79
65822,50658,15164,51342,111,102000,483,1000,0.483,690,0.69,173,0.173,79
66331,51004,15327,51996,112,103000,509,1000,0.509,654,0.654,163,0.163,79
66846,51378,15468,52622,113,104000,515,1000,0.515,626,0.626,141,0.141,79
67359,51737,15622,53263,114,105000,513,1000,0.513,641,0.641,154,0.154,79
67866,52097,15769,53903,115,106000,507,1000,0.507,640,0.64,147,0.147,79
68356,52418,15938,54582,116,107000,490,1000,0.49,679,0.679,169,0.169,79
68884,52790,16094,55210,117,108000,528,1000,0.528,628,0.628,156,0.156,79
69377,53112,16265,55888,118,109000,493,1000,0.493,678,0.678,171,0.171,79
69863,53427,16436,56573,119,110000,486,1000,0.486,685,0.685,171,0.171,79
70323,53685,16638,57315,120,111000,460,1000,0.46,742,0.742,202,0.202,79
70788,53969,16819,58031,121,112000,465,1000,0.465,716,0.716,181,0.181,79
71261,54262,16999,58738,122,113000,473,1000,0.473,707,0.707,180,0.18,79
71729,54551,17178,59449,123,114000,468,1000,0.468,711,0.711,179,0.179,79
71869,54638,17231,59660,124,114298,140,298,0.4697986577181208,211,0.7080536912751678,53,0.17785234899328858,79
100,100,0,0,1,100,NA,NA,NA,NA,NA,NA,NA,80
199,198,1,2,2,200,99,100,0.99,2,0.02,1,0.01,80
299,298,1,2,3,300,100,100,1,0,0,0,0,80
397,394,3,6,4,400,98,100,0.98,4,0.04,2,0.02,80
495,490,5,10,5,500,98,100,0.98,4,0.04,2,0.02,80
591,582,9,18,6,600,96,100,0.96,8,0.08,4,0.04,80
689,678,11,22,7,700,98,100,0.98,4,0.04,2,0.02,80
786,773,13,27,8,800,97,100,0.97,5,0.05,2,0.02,80
885,871,14,29,9,900,99,100,0.99,2,0.02,1,0.01,80
983,967,16,33,10,1000,98,100,0.98,4,0.04,2,0.02,80
1938,1882,56,118,11,2000,955,1000,0.955,85,0.085,40,0.04,80
2882,2783,99,217,12,3000,944,1000,0.944,99,0.099,43,0.043,80
3788,3626,162,374,13,4000,906,1000,0.906,157,0.157,63,0.063,80
4697,4468,229,532,14,5000,909,1000,0.909,158,0.158,67,0.067,80
5581,5266,315,734,15,6000,884,1000,0.884,202,0.202,86,0.086,80
6454,6062,392,938,16,7000,873,1000,0.873,204,0.204,77,0.077,80
7310,6830,480,1170,17,8000,856,1000,0.856,232,0.232,88,0.088,80
8157,7580,577,1420,18,9000,847,1000,0.847,250,0.25,97,0.097,80
8995,8324,671,1676,19,10000,838,1000,0.838,256,0.256,94,0.094,80
9817,9035,782,1965,20,11000,822,1000,0.822,289,0.289,111,0.111,80
10607,9692,915,2308,21,12000,790,1000,0.79,343,0.343,133,0.133,80
11411,10386,1025,2614,22,13000,804,1000,0.804,306,0.306,110,0.11,80
12197,11051,1146,2949,23,14000,786,1000,0.786,335,0.335,121,0.121,80
12988,11725,1263,3275,24,15000,791,1000,0.791,326,0.326,117,0.117,80
13766,12370,1396,3630,25,16000,778,1000,0.778,355,0.355,133,0.133,80
14562,13044,1518,3956,26,17000,796,1000,0.796,326,0.326,122,0.122,80
15343,13707,1636,4293,27,18000,781,1000,0.781,337,0.337,118,0.118,80
16120,14355,1765,4645,28,19000,777,1000,0.777,352,0.352,129,0.129,80
16844,14911,1933,5089,29,20000,724,1000,0.724,444,0.444,168,0.168,80
17601,15546,2055,5454,30,21000,757,1000,0.757,365,0.365,122,0.122,80
18347,16161,2186,5839,31,22000,746,1000,0.746,385,0.385,131,0.131,80
19104,16791,2313,6209,32,23000,757,1000,0.757,370,0.37,127,0.127,80
19855,17419,2436,6581,33,24000,751,1000,0.751,372,0.372,123,0.123,80
20593,18018,2575,6982,34,25000,738,1000,0.738,401,0.401,139,0.139,80
21306,18586,2720,7414,35,26000,713,1000,0.713,432,0.432,145,0.145,80
22006,19127,2879,7873,36,27000,700,1000,0.7,459,0.459,159,0.159,80
22730,19717,3013,8283,37,28000,724,1000,0.724,410,0.41,134,0.134,80
23442,20285,3157,8715,38,29000,712,1000,0.712,432,0.432,144,0.144,80
24136,20825,3311,9175,39,30000,694,1000,0.694,460,0.46,154,0.154,80
24822,21345,3477,9655,40,31000,686,1000,0.686,480,0.48,166,0.166,80
25510,21900,3610,10100,41,32000,688,1000,0.688,445,0.445,133,0.133,80
26181,22421,3760,10579,42,33000,671,1000,0.671,479,0.479,150,0.15,80
26875,22974,3901,11026,43,34000,694,1000,0.694,447,0.447,141,0.141,80
27536,23471,4065,11529,44,35000,661,1000,0.661,503,0.503,164,0.164,80
28180,23944,4236,12056,45,36000,644,1000,0.644,527,0.527,171,0.171,80
28848,24451,4397,12549,46,37000,668,1000,0.668,493,0.493,161,0.161,80
29505,24936,4569,13064,47,38000,657,1000,0.657,515,0.515,172,0.172,80
30175,25450,4725,13550,48,39000,670,1000,0.67,486,0.486,156,0.156,80
30838,25964,4874,14036,49,40000,663,1000,0.663,486,0.486,149,0.149,80
31478,26443,5035,14557,50,41000,640,1000,0.64,521,0.521,161,0.161,80
32103,26893,5210,15107,51,42000,625,1000,0.625,550,0.55,175,0.175,80
32757,27405,5352,15595,52,43000,654,1000,0.654,488,0.488,142,0.142,80
33395,27877,5518,16123,53,44000,638,1000,0.638,528,0.528,166,0.166,80
34033,28349,5684,16651,54,45000,638,1000,0.638,528,0.528,166,0.166,80
34635,28790,5845,17210,55,46000,602,1000,0.602,559,0.559,161,0.161,80
35247,29237,6010,17763,56,47000,612,1000,0.612,553,0.553,165,0.165,80
35888,29733,6155,18267,57,48000,641,1000,0.641,504,0.504,145,0.145,80
36523,30222,6301,18778,58,49000,635,1000,0.635,511,0.511,146,0.146,80
37154,30700,6454,19300,59,50000,631,1000,0.631,522,0.522,153,0.153,80
37777,31176,6601,19824,60,51000,623,1000,0.623,524,0.524,147,0.147,80
38402,31647,6755,20353,61,52000,625,1000,0.625,529,0.529,154,0.154,80
39017,32098,6919,20902,62,53000,615,1000,0.615,549,0.549,164,0.164,80
39625,32559,7066,21441,63,54000,608,1000,0.608,539,0.539,147,0.147,80
40228,32989,7239,22011,64,55000,603,1000,0.603,570,0.57,173,0.173,80
40821,33405,7416,22595,65,56000,593,1000,0.593,584,0.584,177,0.177,80
41433,33862,7571,23138,66,57000,612,1000,0.612,543,0.543,155,0.155,80
42042,34321,7721,23679,67,58000,609,1000,0.609,541,0.541,150,0.15,80
42620,34721,7899,24279,68,59000,578,1000,0.578,600,0.6,178,0.178,80
43210,35143,8067,24857,69,60000,590,1000,0.59,578,0.578,168,0.168,80
43787,35561,8226,25439,70,61000,577,1000,0.577,582,0.582,159,0.159,80
44358,35979,8379,26021,71,62000,571,1000,0.571,582,0.582,153,0.153,80
44935,36369,8566,26631,72,63000,577,1000,0.577,610,0.61,187,0.187,80
45505,36776,8729,27224,73,64000,570,1000,0.57,593,0.593,163,0.163,80
46066,37172,8894,27828,74,65000,561,1000,0.561,604,0.604,165,0.165,80
46610,37524,9086,28476,75,66000,544,1000,0.544,648,0.648,192,0.192,80
47170,37917,9253,29083,76,67000,560,1000,0.56,607,0.607,167,0.167,80
47734,38312,9422,29688,77,68000,564,1000,0.564,605,0.605,169,0.169,80
48302,38707,9595,30293,78,69000,568,1000,0.568,605,0.605,173,0.173,80
48845,39096,9749,30904,79,70000,543,1000,0.543,611,0.611,154,0.154,80
49431,39525,9906,31475,80,71000,586,1000,0.586,571,0.571,157,0.157,80
49953,39845,10108,32155,81,72000,522,1000,0.522,680,0.68,202,0.202,80
50524,40257,10267,32743,82,73000,571,1000,0.571,588,0.588,159,0.159,80
51082,40665,10417,33335,83,74000,558,1000,0.558,592,0.592,150,0.15,80
51655,41083,10572,33917,84,75000,573,1000,0.573,582,0.582,155,0.155,80
52198,41458,10740,34542,85,76000,543,1000,0.543,625,0.625,168,0.168,80
52734,41835,10899,35165,86,77000,536,1000,0.536,623,0.623,159,0.159,80
53269,42205,11064,35795,87,78000,535,1000,0.535,630,0.63,165,0.165,80
53810,42574,11236,36426,88,79000,541,1000,0.541,631,0.631,172,0.172,80
54358,42958,11400,37042,89,80000,548,1000,0.548,616,0.616,164,0.164,80
54920,43344,11576,37656,90,81000,562,1000,0.562,614,0.614,176,0.176,80
55465,43724,11741,38276,91,82000,545,1000,0.545,620,0.62,165,0.165,80
55992,44071,11921,38929,92,83000,527,1000,0.527,653,0.653,180,0.18,80
56545,44466,12079,39534,93,84000,553,1000,0.553,605,0.605,158,0.158,80
57062,44806,12256,40194,94,85000,517,1000,0.517,660,0.66,177,0.177,80
57618,45197,12421,40803,95,86000,556,1000,0.556,609,0.609,165,0.165,80
58156,45590,12566,41410,96,87000,538,1000,0.538,607,0.607,145,0.145,80
58664,45904,12760,42096,97,88000,508,1000,0.508,686,0.686,194,0.194,80
59194,46263,12931,42737,98,89000,530,1000,0.53,641,0.641,171,0.171,80
59710,46607,13103,43393,99,90000,516,1000,0.516,656,0.656,172,0.172,80
60223,46945,13278,44055,100,91000,513,1000,0.513,662,0.662,175,0.175,80
60764,47329,13435,44671,101,92000,541,1000,0.541,616,0.616,157,0.157,80
61292,47700,13592,45300,102,93000,528,1000,0.528,629,0.629,157,0.157,80
61822,48065,13757,45935,103,94000,530,1000,0.53,635,0.635,165,0.165,80
62353,48433,13920,46567,104,95000,531,1000,0.531,632,0.632,163,0.163,80
62858,48763,14095,47237,105,96000,505,1000,0.505,670,0.67,175,0.175,80
63373,49116,14257,47884,106,97000,515,1000,0.515,647,0.647,162,0.162,80
63896,49470,14426,48530,107,98000,523,1000,0.523,646,0.646,169,0.169,80
64379,49791,14588,49209,108,99000,483,1000,0.483,679,0.679,162,0.162,80
64879,50119,14760,49881,109,100000,500,1000,0.5,672,0.672,172,0.172,80
65386,50460,14926,50540,110,101000,507,1000,0.507,659,0.659,166,0.166,80
65892,50796,15096,51204,111,102000,506,1000,0.506,664,0.664,170,0.17,80
66363,51081,15282,51919,112,103000,471,1000,0.471,715,0.715,186,0.186,80
66879,51423,15456,52577,113,104000,516,1000,0.516,658,0.658,174,0.174,80
67388,51758,15630,53242,114,105000,509,1000,0.509,665,0.665,174,0.174,80
67898,52117,15781,53883,115,106000,510,1000,0.51,641,0.641,151,0.151,80
68381,52423,15958,54577,116,107000,483,1000,0.483,694,0.694,177,0.177,80
68863,52724,16139,55276,117,108000,482,1000,0.482,699,0.699,181,0.181,80
69337,53019,16318,55981,118,109000,474,1000,0.474,705,0.705,179,0.179,80
69805,53305,16500,56695,119,110000,468,1000,0.468,714,0.714,182,0.182,80
70285,53612,16673,57388,120,111000,480,1000,0.48,693,0.693,173,0.173,80
70755,53916,16839,58084,121,112000,470,1000,0.47,696,0.696,166,0.166,80
71228,54214,17014,58786,122,113000,473,1000,0.473,702,0.702,175,0.175,80
71731,54548,17183,59452,123,114000,503,1000,0.503,666,0.666,169,0.169,80
71869,54638,17231,59660,124,114298,138,298,0.46308724832214765,208,0.697986577181208,48,0.1610738255033557,80
100,100,0,0,1,100,NA,NA,NA,NA,NA,NA,NA,81
200,200,0,0,2,200,100,100,1,0,0,0,0,81
298,296,2,4,3,300,98,100,0.98,4,0.04,2,0.02,81
397,394,3,6,4,400,99,100,0.99,2,0.02,1,0.01,81
494,489,5,11,5,500,97,100,0.97,5,0.05,2,0.02,81
592,586,6,14,6,600,98,100,0.98,3,0.03,1,0.01,81
689,680,9,20,7,700,97,100,0.97,6,0.06,3,0.03,81
783,769,14,31,8,800,94,100,0.94,11,0.11,5,0.05,81
882,867,15,33,9,900,99,100,0.99,2,0.02,1,0.01,81
976,958,18,42,10,1000,94,100,0.94,9,0.09,3,0.03,81
1927,1870,57,130,11,2000,951,1000,0.951,88,0.088,39,0.039,81
2852,2740,112,260,12,3000,925,1000,0.925,130,0.13,55,0.055,81
3756,3582,174,418,13,4000,904,1000,0.904,158,0.158,62,0.062,81
4668,4432,236,568,14,5000,912,1000,0.912,150,0.15,62,0.062,81
5565,5271,294,729,15,6000,897,1000,0.897,161,0.161,58,0.058,81
6435,6058,377,942,16,7000,870,1000,0.87,213,0.213,83,0.083,81
7290,6834,456,1166,17,8000,855,1000,0.855,224,0.224,79,0.079,81
8127,7566,561,1434,18,9000,837,1000,0.837,268,0.268,105,0.105,81
8966,8300,666,1700,19,10000,839,1000,0.839,266,0.266,105,0.105,81
9795,9023,772,1977,20,11000,829,1000,0.829,277,0.277,106,0.106,81
10624,9752,872,2248,21,12000,829,1000,0.829,271,0.271,100,0.1,81
11430,10436,994,2564,22,13000,806,1000,0.806,316,0.316,122,0.122,81
12219,11088,1131,2912,23,14000,789,1000,0.789,348,0.348,137,0.137,81
13007,11746,1261,3254,24,15000,788,1000,0.788,342,0.342,130,0.13,81
13814,12460,1354,3540,25,16000,807,1000,0.807,286,0.286,93,0.093,81
14590,13119,1471,3881,26,17000,776,1000,0.776,341,0.341,117,0.117,81
15354,13759,1595,4241,27,18000,764,1000,0.764,360,0.36,124,0.124,81
16123,14391,1732,4609,28,19000,769,1000,0.769,368,0.368,137,0.137,81
16887,15028,1859,4972,29,20000,764,1000,0.764,363,0.363,127,0.127,81
17640,15655,1985,5345,30,21000,753,1000,0.753,373,0.373,126,0.126,81
18382,16264,2118,5736,31,22000,742,1000,0.742,391,0.391,133,0.133,81
19130,16895,2235,6105,32,23000,748,1000,0.748,369,0.369,117,0.117,81
19851,17479,2372,6521,33,24000,721,1000,0.721,416,0.416,137,0.137,81
20585,18079,2506,6921,34,25000,734,1000,0.734,400,0.4,134,0.134,81
21294,18647,2647,7353,35,26000,709,1000,0.709,432,0.432,141,0.141,81
21992,19196,2796,7804,36,27000,698,1000,0.698,451,0.451,149,0.149,81
22714,19780,2934,8220,37,28000,722,1000,0.722,416,0.416,138,0.138,81
23431,20356,3075,8644,38,29000,717,1000,0.717,424,0.424,141,0.141,81
24125,20890,3235,9110,39,30000,694,1000,0.694,466,0.466,160,0.16,81
24802,21390,3412,9610,40,31000,677,1000,0.677,500,0.5,177,0.177,81
25515,21966,3549,10034,41,32000,713,1000,0.713,424,0.424,137,0.137,81
26208,22522,3686,10478,42,33000,693,1000,0.693,444,0.444,137,0.137,81
26879,23046,3833,10954,43,34000,671,1000,0.671,476,0.476,147,0.147,81
27551,23564,3987,11436,44,35000,672,1000,0.672,482,0.482,154,0.154,81
28221,24084,4137,11916,45,36000,670,1000,0.67,480,0.48,150,0.15,81
28914,24639,4275,12361,46,37000,693,1000,0.693,445,0.445,138,0.138,81
29553,25118,4435,12882,47,38000,639,1000,0.639,521,0.521,160,0.16,81
30210,25602,4608,13398,48,39000,657,1000,0.657,516,0.516,173,0.173,81
30865,26098,4767,13902,49,40000,655,1000,0.655,504,0.504,159,0.159,81
31495,26547,4948,14453,50,41000,630,1000,0.63,551,0.551,181,0.181,81
32158,27064,5094,14936,51,42000,663,1000,0.663,483,0.483,146,0.146,81
32803,27543,5260,15457,52,43000,645,1000,0.645,521,0.521,166,0.166,81
33428,27995,5433,16005,53,44000,625,1000,0.625,548,0.548,173,0.173,81
34069,28472,5597,16528,54,45000,641,1000,0.641,523,0.523,164,0.164,81
34689,28932,5757,17068,55,46000,620,1000,0.62,540,0.54,160,0.16,81
35293,29352,5941,17648,56,47000,604,1000,0.604,580,0.58,184,0.184,81
35930,29823,6107,18177,57,48000,637,1000,0.637,529,0.529,166,0.166,81
36569,30302,6267,18698,58,49000,639,1000,0.639,521,0.521,160,0.16,81
37187,30767,6420,19233,59,50000,618,1000,0.618,535,0.535,153,0.153,81
37802,31229,6573,19771,60,51000,615,1000,0.615,538,0.538,153,0.153,81
38432,31706,6726,20294,61,52000,630,1000,0.63,523,0.523,153,0.153,81
39037,32153,6884,20847,62,53000,605,1000,0.605,553,0.553,158,0.158,81
39622,32572,7050,21428,63,54000,585,1000,0.585,581,0.581,166,0.166,81
40233,33023,7210,21977,64,55000,611,1000,0.611,549,0.549,160,0.16,81
40845,33478,7367,22522,65,56000,612,1000,0.612,545,0.545,157,0.157,81
41435,33894,7541,23106,66,57000,590,1000,0.59,584,0.584,174,0.174,81
42032,34321,7711,23679,67,58000,597,1000,0.597,573,0.573,170,0.17,81
42630,34748,7882,24252,68,59000,598,1000,0.598,573,0.573,171,0.171,81
43237,35208,8029,24792,69,60000,607,1000,0.607,540,0.54,147,0.147,81
43817,35623,8194,25377,70,61000,580,1000,0.58,585,0.585,165,0.165,81
44414,36046,8368,25954,71,62000,597,1000,0.597,577,0.577,174,0.174,81
44994,36458,8536,26542,72,63000,580,1000,0.58,588,0.588,168,0.168,81
45570,36861,8709,27139,73,64000,576,1000,0.576,597,0.597,173,0.173,81
46149,37282,8867,27718,74,65000,579,1000,0.579,579,0.579,158,0.158,81
46720,37689,9031,28311,75,66000,571,1000,0.571,593,0.593,164,0.164,81
47328,38150,9178,28850,76,67000,608,1000,0.608,539,0.539,147,0.147,81
47902,38564,9338,29436,77,68000,574,1000,0.574,586,0.586,160,0.16,81
48474,38971,9503,30029,78,69000,572,1000,0.572,593,0.593,165,0.165,81
49045,39384,9661,30616,79,70000,571,1000,0.571,587,0.587,158,0.158,81
49601,39763,9838,31237,80,71000,556,1000,0.556,621,0.621,177,0.177,81
50152,40135,10017,31865,81,72000,551,1000,0.551,628,0.628,179,0.179,81
50719,40534,10185,32466,82,73000,567,1000,0.567,601,0.601,168,0.168,81
51252,40887,10365,33113,83,74000,533,1000,0.533,647,0.647,180,0.18,81
51775,41246,10529,33754,84,75000,523,1000,0.523,641,0.641,164,0.164,81
52316,41614,10702,34386,85,76000,541,1000,0.541,632,0.632,173,0.173,81
52858,42002,10856,34998,86,77000,542,1000,0.542,612,0.612,154,0.154,81
53399,42367,11032,35633,87,78000,541,1000,0.541,635,0.635,176,0.176,81
53958,42767,11191,36233,88,79000,559,1000,0.559,600,0.6,159,0.159,81
54456,43098,11358,36902,89,80000,498,1000,0.498,669,0.669,167,0.167,81
54996,43470,11526,37530,90,81000,540,1000,0.54,628,0.628,168,0.168,81
55535,43833,11702,38167,91,82000,539,1000,0.539,637,0.637,176,0.176,81
56083,44218,11865,38782,92,83000,548,1000,0.548,615,0.615,163,0.163,81
56643,44635,12008,39365,93,84000,560,1000,0.56,583,0.583,143,0.143,81
57172,44969,12203,40031,94,85000,529,1000,0.529,666,0.666,195,0.195,81
57706,45327,12379,40673,95,86000,534,1000,0.534,642,0.642,176,0.176,81
58242,45704,12538,41296,96,87000,536,1000,0.536,623,0.623,159,0.159,81
58737,46012,12725,41988,97,88000,495,1000,0.495,692,0.692,187,0.187,81
59288,46409,12879,42591,98,89000,551,1000,0.551,603,0.603,154,0.154,81
59803,46743,13060,43257,99,90000,515,1000,0.515,666,0.666,181,0.181,81
60315,47095,13220,43905,100,91000,512,1000,0.512,648,0.648,160,0.16,81
60847,47466,13381,44534,101,92000,532,1000,0.532,629,0.629,161,0.161,81
61355,47800,13555,45200,102,93000,508,1000,0.508,666,0.666,174,0.174,81
61873,48135,13738,45865,103,94000,518,1000,0.518,665,0.665,183,0.183,81
62362,48439,13923,46561,104,95000,489,1000,0.489,696,0.696,185,0.185,81
62885,48793,14092,47207,105,96000,523,1000,0.523,646,0.646,169,0.169,81
63404,49132,14272,47868,106,97000,519,1000,0.519,661,0.661,180,0.18,81
63916,49491,14425,48509,107,98000,512,1000,0.512,641,0.641,153,0.153,81
64395,49796,14599,49204,108,99000,479,1000,0.479,695,0.695,174,0.174,81
64899,50131,14768,49869,109,100000,504,1000,0.504,665,0.665,169,0.169,81
65393,50448,14945,50552,110,101000,494,1000,0.494,683,0.683,177,0.177,81
65875,50749,15126,51251,111,102000,482,1000,0.482,699,0.699,181,0.181,81
66389,51101,15288,51899,112,103000,514,1000,0.514,648,0.648,162,0.162,81
66889,51437,15452,52563,113,104000,500,1000,0.5,664,0.664,164,0.164,81
67373,51757,15616,53243,114,105000,484,1000,0.484,680,0.68,164,0.164,81
67853,52057,15796,53943,115,106000,480,1000,0.48,700,0.7,180,0.18,81
68347,52374,15973,54626,116,107000,494,1000,0.494,683,0.683,177,0.177,81
68835,52682,16153,55318,117,108000,488,1000,0.488,692,0.692,180,0.18,81
69322,52998,16324,56002,118,109000,487,1000,0.487,684,0.684,171,0.171,81
69822,53328,16494,56672,119,110000,500,1000,0.5,670,0.67,170,0.17,81
70305,53649,16656,57351,120,111000,483,1000,0.483,679,0.679,162,0.162,81
70767,53934,16833,58066,121,112000,462,1000,0.462,715,0.715,177,0.177,81
71259,54258,17001,58742,122,113000,492,1000,0.492,676,0.676,168,0.168,81
71730,54553,17177,59447,123,114000,471,1000,0.471,705,0.705,176,0.176,81
71869,54638,17231,59660,124,114298,139,298,0.4664429530201342,213,0.714765100671141,54,0.18120805369127516,81
100,100,0,0,1,100,NA,NA,NA,NA,NA,NA,NA,82
199,198,1,2,2,200,99,100,0.99,2,0.02,1,0.01,82
298,296,2,4,3,300,99,100,0.99,2,0.02,1,0.01,82
395,390,5,10,4,400,97,100,0.97,6,0.06,3,0.03,82
495,490,5,10,5,500,100,100,1,0,0,0,0,82
591,583,8,17,6,600,96,100,0.96,7,0.07,3,0.03,82
686,675,11,25,7,700,95,100,0.95,8,0.08,3,0.03,82
785,773,12,27,8,800,99,100,0.99,2,0.02,1,0.01,82
882,868,14,32,9,900,97,100,0.97,5,0.05,2,0.02,82
978,962,16,38,10,1000,96,100,0.96,6,0.06,2,0.02,82
1937,1891,46,109,11,2000,959,1000,0.959,71,0.071,30,0.03,82
2869,2773,96,227,12,3000,932,1000,0.932,118,0.118,50,0.05,82
3794,3646,148,354,13,4000,925,1000,0.925,127,0.127,52,0.052,82
4700,4492,208,508,14,5000,906,1000,0.906,154,0.154,60,0.06,82
5590,5307,283,693,15,6000,890,1000,0.89,185,0.185,75,0.075,82
6470,6096,374,904,16,7000,880,1000,0.88,211,0.211,91,0.091,82
7359,6910,449,1090,17,8000,889,1000,0.889,186,0.186,75,0.075,82
8197,7644,553,1356,18,9000,838,1000,0.838,266,0.266,104,0.104,82
9021,8361,660,1639,19,10000,824,1000,0.824,283,0.283,107,0.107,82
9835,9062,773,1938,20,11000,814,1000,0.814,299,0.299,113,0.113,82
10661,9788,873,2212,21,12000,826,1000,0.826,274,0.274,100,0.1,82
11458,10466,992,2534,22,13000,797,1000,0.797,322,0.322,119,0.119,82
12263,11170,1093,2830,23,14000,805,1000,0.805,296,0.296,101,0.101,82
13052,11837,1215,3163,24,15000,789,1000,0.789,333,0.333,122,0.122,82
13823,12483,1340,3517,25,16000,771,1000,0.771,354,0.354,125,0.125,82
14599,13147,1452,3853,26,17000,776,1000,0.776,336,0.336,112,0.112,82
15378,13809,1569,4191,27,18000,779,1000,0.779,338,0.338,117,0.117,82
16144,14447,1697,4553,28,19000,766,1000,0.766,362,0.362,128,0.128,82
16898,15076,1822,4924,29,20000,754,1000,0.754,371,0.371,125,0.125,82
17655,15708,1947,5292,30,21000,757,1000,0.757,368,0.368,125,0.125,82
18386,16304,2082,5696,31,22000,731,1000,0.731,404,0.404,135,0.135,82
19106,16869,2237,6131,32,23000,720,1000,0.72,435,0.435,155,0.155,82
19839,17476,2363,6524,33,24000,733,1000,0.733,393,0.393,126,0.126,82
20568,18070,2498,6930,34,25000,729,1000,0.729,406,0.406,135,0.135,82
21275,18629,2646,7371,35,26000,707,1000,0.707,441,0.441,148,0.148,82
21985,19201,2784,7799,36,27000,710,1000,0.71,428,0.428,138,0.138,82
22699,19763,2936,8237,37,28000,714,1000,0.714,438,0.438,152,0.152,82
23422,20351,3071,8649,38,29000,723,1000,0.723,412,0.412,135,0.135,82
24117,20902,3215,9098,39,30000,695,1000,0.695,449,0.449,144,0.144,82
24818,21459,3359,9541,40,31000,701,1000,0.701,443,0.443,144,0.144,82
25521,22010,3511,9990,41,32000,703,1000,0.703,449,0.449,152,0.152,82
26187,22524,3663,10476,42,33000,666,1000,0.666,486,0.486,152,0.152,82
26851,23035,3816,10965,43,34000,664,1000,0.664,489,0.489,153,0.153,82
27545,23583,3962,11417,44,35000,694,1000,0.694,452,0.452,146,0.146,82
28204,24098,4106,11902,45,36000,659,1000,0.659,485,0.485,144,0.144,82
28893,24643,4250,12357,46,37000,689,1000,0.689,455,0.455,144,0.144,82
29552,25154,4398,12846,47,38000,659,1000,0.659,489,0.489,148,0.148,82
30223,25675,4548,13325,48,39000,671,1000,0.671,479,0.479,150,0.15,82
30893,26199,4694,13801,49,40000,670,1000,0.67,476,0.476,146,0.146,82
31547,26709,4838,14291,50,41000,654,1000,0.654,490,0.49,144,0.144,82
32196,27201,4995,14799,51,42000,649,1000,0.649,508,0.508,157,0.157,82
32840,27675,5165,15325,52,43000,644,1000,0.644,526,0.526,170,0.17,82
33477,28171,5306,15829,53,44000,637,1000,0.637,504,0.504,141,0.141,82
34124,28676,5448,16324,54,45000,647,1000,0.647,495,0.495,142,0.142,82
34760,29160,5600,16840,55,46000,636,1000,0.636,516,0.516,152,0.152,82
35372,29598,5774,17402,56,47000,612,1000,0.612,562,0.562,174,0.174,82
36014,30081,5933,17919,57,48000,642,1000,0.642,517,0.517,159,0.159,82
36623,30524,6099,18476,58,49000,609,1000,0.609,557,0.557,166,0.166,82
37222,30961,6261,19039,59,50000,599,1000,0.599,563,0.563,162,0.162,82
37843,31430,6413,19570,60,51000,621,1000,0.621,531,0.531,152,0.152,82
38477,31907,6570,20093,61,52000,634,1000,0.634,523,0.523,157,0.157,82
39085,32347,6738,20653,62,53000,608,1000,0.608,560,0.56,168,0.168,82
39667,32758,6909,21242,63,54000,582,1000,0.582,589,0.589,171,0.171,82
40249,33155,7094,21845,64,55000,582,1000,0.582,603,0.603,185,0.185,82
40820,33560,7260,22440,65,56000,571,1000,0.571,595,0.595,166,0.166,82
41398,33963,7435,23037,66,57000,578,1000,0.578,597,0.597,175,0.175,82
42007,34389,7618,23611,67,58000,609,1000,0.609,574,0.574,183,0.183,82
42635,34863,7772,24137,68,59000,628,1000,0.628,526,0.526,154,0.154,82
43203,35244,7959,24756,69,60000,568,1000,0.568,619,0.619,187,0.187,82
43774,35641,8133,25359,70,61000,571,1000,0.571,603,0.603,174,0.174,82
44374,36064,8310,25936,71,62000,600,1000,0.6,577,0.577,177,0.177,82
44979,36530,8449,26470,72,63000,605,1000,0.605,534,0.534,139,0.139,82
45536,36909,8627,27091,73,64000,557,1000,0.557,621,0.621,178,0.178,82
46083,37271,8812,27729,74,65000,547,1000,0.547,638,0.638,185,0.185,82
46646,37652,8994,28348,75,66000,563,1000,0.563,619,0.619,182,0.182,82
47225,38053,9172,28947,76,67000,579,1000,0.579,599,0.599,178,0.178,82
47784,38446,9338,29554,77,68000,559,1000,0.559,607,0.607,166,0.166,82
48351,38851,9500,30149,78,69000,567,1000,0.567,595,0.595,162,0.162,82
48929,39260,9669,30740,79,70000,578,1000,0.578,591,0.591,169,0.169,82
49494,39653,9841,31347,80,71000,565,1000,0.565,607,0.607,172,0.172,82
50056,40040,10016,31960,81,72000,562,1000,0.562,613,0.613,175,0.175,82
50617,40435,10182,32565,82,73000,561,1000,0.561,605,0.605,166,0.166,82
51179,40847,10332,33153,83,74000,562,1000,0.562,588,0.588,150,0.15,82
51711,41198,10513,33802,84,75000,532,1000,0.532,649,0.649,181,0.181,82
52259,41564,10695,34436,85,76000,548,1000,0.548,634,0.634,182,0.182,82
52804,41939,10865,35061,86,77000,545,1000,0.545,625,0.625,170,0.17,82
53347,42308,11039,35692,87,78000,543,1000,0.543,631,0.631,174,0.174,82
53902,42700,11202,36300,88,79000,555,1000,0.555,608,0.608,163,0.163,82
54418,43045,11373,36955,89,80000,516,1000,0.516,655,0.655,171,0.171,82
54962,43420,11542,37580,90,81000,544,1000,0.544,625,0.625,169,0.169,82
55491,43767,11724,38233,91,82000,529,1000,0.529,653,0.653,182,0.182,82
56024,44134,11890,38866,92,83000,533,1000,0.533,633,0.633,166,0.166,82
56543,44478,12065,39522,93,84000,519,1000,0.519,656,0.656,175,0.175,82
57071,44836,12235,40164,94,85000,528,1000,0.528,642,0.642,170,0.17,82
57558,45138,12420,40862,95,86000,487,1000,0.487,698,0.698,185,0.185,82
58091,45500,12591,41500,96,87000,533,1000,0.533,638,0.638,171,0.171,82
58611,45851,12760,42149,97,88000,520,1000,0.52,649,0.649,169,0.169,82
59117,46179,12938,42821,98,89000,506,1000,0.506,672,0.672,178,0.178,82
59641,46540,13101,43460,99,90000,524,1000,0.524,639,0.639,163,0.163,82
60158,46903,13255,44097,100,91000,517,1000,0.517,637,0.637,154,0.154,82
60688,47268,13420,44732,101,92000,530,1000,0.53,635,0.635,165,0.165,82
61227,47635,13592,45365,102,93000,539,1000,0.539,633,0.633,172,0.172,82
61760,47999,13761,46001,103,94000,533,1000,0.533,636,0.636,169,0.169,82
62266,48347,13919,46653,104,95000,506,1000,0.506,652,0.652,158,0.158,82
62745,48639,14106,47361,105,96000,479,1000,0.479,708,0.708,187,0.187,82
63269,49011,14258,47989,106,97000,524,1000,0.524,628,0.628,152,0.152,82
63762,49315,14447,48685,107,98000,493,1000,0.493,696,0.696,189,0.189,82
64259,49641,14618,49359,108,99000,497,1000,0.497,674,0.674,171,0.171,82
64774,49978,14796,50022,109,100000,515,1000,0.515,663,0.663,178,0.178,82
65291,50324,14967,50676,110,101000,517,1000,0.517,654,0.654,171,0.171,82
65809,50675,15134,51325,111,102000,518,1000,0.518,649,0.649,167,0.167,82
66306,51014,15292,51986,112,103000,497,1000,0.497,661,0.661,158,0.158,82
66820,51349,15471,52651,113,104000,514,1000,0.514,665,0.665,179,0.179,82
67307,51677,15630,53323,114,105000,487,1000,0.487,672,0.672,159,0.159,82
67808,52028,15780,53972,115,106000,501,1000,0.501,649,0.649,150,0.15,82
68297,52328,15969,54672,116,107000,489,1000,0.489,700,0.7,189,0.189,82
68775,52648,16127,55352,117,108000,478,1000,0.478,680,0.68,158,0.158,82
69279,52973,16306,56027,118,109000,504,1000,0.504,675,0.675,179,0.179,82
69783,53327,16456,56673,119,110000,504,1000,0.504,646,0.646,150,0.15,82
70294,53664,16630,57336,120,111000,511,1000,0.511,663,0.663,174,0.174,82
70807,54002,16805,57998,121,112000,513,1000,0.513,662,0.662,175,0.175,82
71258,54260,16998,58740,122,113000,451,1000,0.451,742,0.742,193,0.193,82
71729,54546,17183,59454,123,114000,471,1000,0.471,714,0.714,185,0.185,82
71869,54638,17231,59660,124,114298,140,298,0.4697986577181208,206,0.6912751677852349,48,0.1610738255033557,82
100,100,0,0,1,100,NA,NA,NA,NA,NA,NA,NA,83
200,200,0,0,2,200,100,100,1,0,0,0,0,83
298,296,2,4,3,300,98,100,0.98,4,0.04,2,0.02,83
398,396,2,4,4,400,100,100,1,0,0,0,0,83
498,496,2,4,5,500,100,100,1,0,0,0,0,83
597,594,3,6,6,600,99,100,0.99,2,0.02,1,0.01,83
694,688,6,12,7,700,97,100,0.97,6,0.06,3,0.03,83
793,786,7,14,8,800,99,100,0.99,2,0.02,1,0.01,83
888,878,10,22,9,900,95,100,0.95,8,0.08,3,0.03,83
983,969,14,31,10,1000,95,100,0.95,9,0.09,4,0.04,83
1948,1905,43,95,11,2000,965,1000,0.965,64,0.064,29,0.029,83
2883,2792,91,208,12,3000,935,1000,0.935,113,0.113,48,0.048,83
3807,3666,141,334,13,4000,924,1000,0.924,126,0.126,50,0.05,83
4705,4483,222,517,14,5000,898,1000,0.898,183,0.183,81,0.081,83
5603,5311,292,689,15,6000,898,1000,0.898,172,0.172,70,0.07,83
6477,6095,382,905,16,7000,874,1000,0.874,216,0.216,90,0.09,83
7336,6874,462,1126,17,8000,859,1000,0.859,221,0.221,80,0.08,83
8183,7626,557,1374,18,9000,847,1000,0.847,248,0.248,95,0.095,83
9019,8369,650,1631,19,10000,836,1000,0.836,257,0.257,93,0.093,83
9852,9101,751,1899,20,11000,833,1000,0.833,268,0.268,101,0.101,83
10680,9833,847,2167,21,12000,828,1000,0.828,268,0.268,96,0.096,83
11492,10545,947,2455,22,13000,812,1000,0.812,288,0.288,100,0.1,83
12296,11235,1061,2765,23,14000,804,1000,0.804,310,0.31,114,0.114,83
13085,11902,1183,3098,24,15000,789,1000,0.789,333,0.333,122,0.122,83
13870,12571,1299,3429,25,16000,785,1000,0.785,331,0.331,116,0.116,83
14658,13244,1414,3756,26,17000,788,1000,0.788,327,0.327,115,0.115,83
15438,13896,1542,4104,27,18000,780,1000,0.78,348,0.348,128,0.128,83
16175,14497,1678,4503,28,19000,737,1000,0.737,399,0.399,136,0.136,83
16968,15193,1775,4807,29,20000,793,1000,0.793,304,0.304,97,0.097,83
17738,15847,1891,5153,30,21000,770,1000,0.77,346,0.346,116,0.116,83
18489,16467,2022,5533,31,22000,751,1000,0.751,380,0.38,131,0.131,83
19247,17109,2138,5891,32,23000,758,1000,0.758,358,0.358,116,0.116,83
19986,17706,2280,6294,33,24000,739,1000,0.739,403,0.403,142,0.142,83
20733,18317,2416,6683,34,25000,747,1000,0.747,389,0.389,136,0.136,83
21433,18860,2573,7140,35,26000,700,1000,0.7,457,0.457,157,0.157,83
22136,19415,2721,7585,36,27000,703,1000,0.703,445,0.445,148,0.148,83
22852,19991,2861,8009,37,28000,716,1000,0.716,424,0.424,140,0.14,83
23545,20537,3008,8463,38,29000,693,1000,0.693,454,0.454,147,0.147,83
24232,21065,3167,8935,39,30000,687,1000,0.687,472,0.472,159,0.159,83
24938,21624,3314,9376,40,31000,706,1000,0.706,441,0.441,147,0.147,83
25607,22128,3479,9872,41,32000,669,1000,0.669,496,0.496,165,0.165,83
26317,22696,3621,10304,42,33000,710,1000,0.71,432,0.432,142,0.142,83
26987,23194,3793,10806,43,34000,670,1000,0.67,502,0.502,172,0.172,83
27661,23724,3937,11276,44,35000,674,1000,0.674,470,0.47,144,0.144,83
28316,24218,4098,11782,45,36000,655,1000,0.655,506,0.506,161,0.161,83
28985,24734,4251,12266,46,37000,669,1000,0.669,484,0.484,153,0.153,83
29663,25256,4407,12744,47,38000,678,1000,0.678,478,0.478,156,0.156,83
30324,25759,4565,13241,48,39000,661,1000,0.661,497,0.497,158,0.158,83
30976,26258,4718,13742,49,40000,652,1000,0.652,501,0.501,153,0.153,83
31618,26729,4889,14271,50,41000,642,1000,0.642,529,0.529,171,0.171,83
32253,27193,5060,14807,51,42000,635,1000,0.635,536,0.536,171,0.171,83
32866,27641,5225,15359,52,43000,613,1000,0.613,552,0.552,165,0.165,83
33502,28099,5403,15901,53,44000,636,1000,0.636,542,0.542,178,0.178,83
34147,28602,5545,16398,54,45000,645,1000,0.645,497,0.497,142,0.142,83
34757,29039,5718,16961,55,46000,610,1000,0.61,563,0.563,173,0.173,83
35377,29485,5892,17515,56,47000,620,1000,0.62,554,0.554,174,0.174,83
36004,29952,6052,18048,57,48000,627,1000,0.627,533,0.533,160,0.16,83
36634,30420,6214,18580,58,49000,630,1000,0.63,532,0.532,162,0.162,83
37258,30884,6374,19116,59,50000,624,1000,0.624,536,0.536,160,0.16,83
37894,31372,6522,19628,60,51000,636,1000,0.636,512,0.512,148,0.148,83
38497,31803,6694,20197,61,52000,603,1000,0.603,569,0.569,172,0.172,83
39110,32258,6852,20742,62,53000,613,1000,0.613,545,0.545,158,0.158,83
39734,32736,6998,21264,63,54000,624,1000,0.624,522,0.522,146,0.146,83
40350,33196,7154,21804,64,55000,616,1000,0.616,540,0.54,156,0.156,83
40963,33657,7306,22343,65,56000,613,1000,0.613,539,0.539,152,0.152,83
41531,34048,7483,22952,66,57000,568,1000,0.568,609,0.609,177,0.177,83
42137,34485,7652,23515,67,58000,606,1000,0.606,563,0.563,169,0.169,83
42714,34895,7819,24105,68,59000,577,1000,0.577,590,0.59,167,0.167,83
43296,35311,7985,24689,69,60000,582,1000,0.582,584,0.584,166,0.166,83
43903,35751,8152,25249,70,61000,607,1000,0.607,560,0.56,167,0.167,83
44498,36184,8314,25816,71,62000,595,1000,0.595,567,0.567,162,0.162,83
45094,36618,8476,26382,72,63000,596,1000,0.596,566,0.566,162,0.162,83
45661,37007,8654,26993,73,64000,567,1000,0.567,611,0.611,178,0.178,83
46249,37426,8823,27574,74,65000,588,1000,0.588,581,0.581,169,0.169,83
46814,37822,8992,28178,75,66000,565,1000,0.565,604,0.604,169,0.169,83
47385,38234,9151,28766,76,67000,571,1000,0.571,588,0.588,159,0.159,83
47950,38637,9313,29363,77,68000,565,1000,0.565,597,0.597,162,0.162,83
48507,39013,9494,29987,78,69000,557,1000,0.557,624,0.624,181,0.181,83
49087,39431,9656,30569,79,70000,580,1000,0.58,582,0.582,162,0.162,83
49651,39832,9819,31168,80,71000,564,1000,0.564,599,0.599,163,0.163,83
50182,40181,10001,31819,81,72000,531,1000,0.531,651,0.651,182,0.182,83
50699,40508,10191,32492,82,73000,517,1000,0.517,673,0.673,190,0.19,83
51283,40934,10349,33066,83,74000,584,1000,0.584,574,0.574,158,0.158,83
51793,41246,10547,33754,84,75000,510,1000,0.51,688,0.688,198,0.198,83
52349,41650,10699,34350,85,76000,556,1000,0.556,596,0.596,152,0.152,83
52881,42002,10879,34998,86,77000,532,1000,0.532,648,0.648,180,0.18,83
53410,42349,11061,35651,87,78000,529,1000,0.529,653,0.653,182,0.182,83
53942,42696,11246,36304,88,79000,532,1000,0.532,653,0.653,185,0.185,83
54478,43048,11430,36952,89,80000,536,1000,0.536,648,0.648,184,0.184,83
55011,43395,11616,37605,90,81000,533,1000,0.533,653,0.653,186,0.186,83
55569,43794,11775,38206,91,82000,558,1000,0.558,601,0.601,159,0.159,83
56099,44161,11938,38839,92,83000,530,1000,0.53,633,0.633,163,0.163,83
56628,44516,12112,39484,93,84000,529,1000,0.529,645,0.645,174,0.174,83
57163,44898,12265,40102,94,85000,535,1000,0.535,618,0.618,153,0.153,83
57707,45285,12422,40715,95,86000,544,1000,0.544,613,0.613,157,0.157,83
58225,45630,12595,41370,96,87000,518,1000,0.518,655,0.655,173,0.173,83
58752,45974,12778,42026,97,88000,527,1000,0.527,656,0.656,183,0.183,83
59301,46372,12929,42628,98,89000,549,1000,0.549,602,0.602,151,0.151,83
59812,46685,13127,43315,99,90000,511,1000,0.511,687,0.687,198,0.198,83
60319,47028,13291,43972,100,91000,507,1000,0.507,657,0.657,164,0.164,83
60831,47359,13472,44641,101,92000,512,1000,0.512,669,0.669,181,0.181,83
61345,47697,13648,45303,102,93000,514,1000,0.514,662,0.662,176,0.176,83
61866,48059,13807,45941,103,94000,521,1000,0.521,638,0.638,159,0.159,83
62376,48396,13980,46604,104,95000,510,1000,0.51,663,0.663,173,0.173,83
62892,48739,14153,47261,105,96000,516,1000,0.516,657,0.657,173,0.173,83
63370,49043,14327,47957,106,97000,478,1000,0.478,696,0.696,174,0.174,83
63880,49378,14502,48622,107,98000,510,1000,0.51,665,0.665,175,0.175,83
64386,49714,14672,49286,108,99000,506,1000,0.506,664,0.664,170,0.17,83
64877,50033,14844,49967,109,100000,491,1000,0.491,681,0.681,172,0.172,83
65381,50390,14991,50610,110,101000,504,1000,0.504,643,0.643,147,0.147,83
65894,50728,15166,51272,111,102000,513,1000,0.513,662,0.662,175,0.175,83
66376,51043,15333,51957,112,103000,482,1000,0.482,685,0.685,167,0.167,83
66886,51397,15489,52603,113,104000,510,1000,0.51,646,0.646,156,0.156,83
67372,51720,15652,53280,114,105000,486,1000,0.486,677,0.677,163,0.163,83
67887,52061,15826,53939,115,106000,515,1000,0.515,659,0.659,174,0.174,83
68372,52372,16000,54628,116,107000,485,1000,0.485,689,0.689,174,0.174,83
68859,52704,16155,55296,117,108000,487,1000,0.487,668,0.668,155,0.155,83
69342,53018,16324,55982,118,109000,483,1000,0.483,686,0.686,169,0.169,83
69844,53351,16493,56649,119,110000,502,1000,0.502,667,0.667,169,0.169,83
70315,53660,16655,57340,120,111000,471,1000,0.471,691,0.691,162,0.162,83
70796,53970,16826,58030,121,112000,481,1000,0.481,690,0.69,171,0.171,83
71265,54253,17012,58747,122,113000,469,1000,0.469,717,0.717,186,0.186,83
71731,54548,17183,59452,123,114000,466,1000,0.466,705,0.705,171,0.171,83
71869,54638,17231,59660,124,114298,138,298,0.46308724832214765,208,0.697986577181208,48,0.1610738255033557,83
100,100,0,0,1,100,NA,NA,NA,NA,NA,NA,NA,84
199,198,1,2,2,200,99,100,0.99,2,0.02,1,0.01,84
297,294,3,6,3,300,98,100,0.98,4,0.04,2,0.02,84
396,392,4,8,4,400,99,100,0.99,2,0.02,1,0.01,84
495,490,5,10,5,500,99,100,0.99,2,0.02,1,0.01,84
595,590,5,10,6,600,100,100,1,0,0,0,0,84
694,688,6,12,7,700,99,100,0.99,2,0.02,1,0.01,84
792,784,8,16,8,800,98,100,0.98,4,0.04,2,0.02,84
886,875,11,25,9,900,94,100,0.94,9,0.09,3,0.03,84
981,967,14,33,10,1000,95,100,0.95,8,0.08,3,0.03,84
1945,1903,42,97,11,2000,964,1000,0.964,64,0.064,28,0.028,84
2891,2810,81,190,12,3000,946,1000,0.946,93,0.093,39,0.039,84
3799,3653,146,347,13,4000,908,1000,0.908,157,0.157,65,0.065,84
4703,4488,215,512,14,5000,904,1000,0.904,165,0.165,69,0.069,84
5591,5304,287,696,15,6000,888,1000,0.888,184,0.184,72,0.072,84
6463,6096,367,904,16,7000,872,1000,0.872,208,0.208,80,0.08,84
7325,6867,458,1133,17,8000,862,1000,0.862,229,0.229,91,0.091,84
8176,7635,541,1365,18,9000,851,1000,0.851,232,0.232,83,0.083,84
9024,8390,634,1610,19,10000,848,1000,0.848,245,0.245,93,0.093,84
9871,9144,727,1856,20,11000,847,1000,0.847,246,0.246,93,0.093,84
10691,9852,839,2148,21,12000,820,1000,0.82,292,0.292,112,0.112,84
11504,10551,953,2449,22,13000,813,1000,0.813,301,0.301,114,0.114,84
12310,11257,1053,2743,23,14000,806,1000,0.806,294,0.294,100,0.1,84
13107,11931,1176,3069,24,15000,797,1000,0.797,326,0.326,123,0.123,84
13901,12618,1283,3382,25,16000,794,1000,0.794,313,0.313,107,0.107,84
14670,13253,1417,3747,26,17000,769,1000,0.769,365,0.365,134,0.134,84
15435,13893,1542,4107,27,18000,765,1000,0.765,360,0.36,125,0.125,84
16177,14499,1678,4501,28,19000,742,1000,0.742,394,0.394,136,0.136,84
16953,15159,1794,4841,29,20000,776,1000,0.776,340,0.34,116,0.116,84
17708,15774,1934,5226,30,21000,755,1000,0.755,385,0.385,140,0.14,84
18467,16393,2074,5607,31,22000,759,1000,0.759,381,0.381,140,0.14,84
19211,16997,2214,6003,32,23000,744,1000,0.744,396,0.396,140,0.14,84
19938,17598,2340,6402,33,24000,727,1000,0.727,399,0.399,126,0.126,84
20676,18196,2480,6804,34,25000,738,1000,0.738,402,0.402,140,0.14,84
21404,18790,2614,7210,35,26000,728,1000,0.728,406,0.406,134,0.134,84
22124,19371,2753,7629,36,27000,720,1000,0.72,419,0.419,139,0.139,84
22817,19901,2916,8099,37,28000,693,1000,0.693,470,0.47,163,0.163,84
23503,20439,3064,8561,38,29000,686,1000,0.686,462,0.462,148,0.148,84
24195,20978,3217,9022,39,30000,692,1000,0.692,461,0.461,153,0.153,84
24869,21492,3377,9508,40,31000,674,1000,0.674,486,0.486,160,0.16,84
25544,22015,3529,9985,41,32000,675,1000,0.675,477,0.477,152,0.152,84
26246,22572,3674,10428,42,33000,702,1000,0.702,443,0.443,145,0.145,84
26960,23152,3808,10848,43,34000,714,1000,0.714,420,0.42,134,0.134,84
27632,23654,3978,11346,44,35000,672,1000,0.672,498,0.498,170,0.17,84
28292,24171,4121,11829,45,36000,660,1000,0.66,483,0.483,143,0.143,84
28972,24686,4286,12314,46,37000,680,1000,0.68,485,0.485,165,0.165,84
29660,25245,4415,12755,47,38000,688,1000,0.688,441,0.441,129,0.129,84
30317,25752,4565,13248,48,39000,657,1000,0.657,493,0.493,150,0.15,84
30969,26238,4731,13762,49,40000,652,1000,0.652,514,0.514,166,0.166,84
31617,26725,4892,14275,50,41000,648,1000,0.648,513,0.513,161,0.161,84
32289,27251,5038,14749,51,42000,672,1000,0.672,474,0.474,146,0.146,84
32934,27737,5197,15263,52,43000,645,1000,0.645,514,0.514,159,0.159,84
33560,28204,5356,15796,53,44000,626,1000,0.626,533,0.533,159,0.159,84
34198,28663,5535,16337,54,45000,638,1000,0.638,541,0.541,179,0.179,84
34836,29167,5669,16833,55,46000,638,1000,0.638,496,0.496,134,0.134,84
35471,29637,5834,17363,56,47000,635,1000,0.635,530,0.53,165,0.165,84
36086,30087,5999,17913,57,48000,615,1000,0.615,550,0.55,165,0.165,84
36698,30529,6169,18471,58,49000,612,1000,0.612,558,0.558,170,0.17,84
37308,30987,6321,19013,59,50000,610,1000,0.61,542,0.542,152,0.152,84
37926,31444,6482,19556,60,51000,618,1000,0.618,543,0.543,161,0.161,84
38549,31893,6656,20107,61,52000,623,1000,0.623,551,0.551,174,0.174,84
39140,32304,6836,20696,62,53000,591,1000,0.591,589,0.589,180,0.18,84
39725,32714,7011,21286,63,54000,585,1000,0.585,590,0.59,175,0.175,84
40311,33145,7166,21855,64,55000,586,1000,0.586,569,0.569,155,0.155,84
40924,33607,7317,22393,65,56000,613,1000,0.613,538,0.538,151,0.151,84
41526,34044,7482,22956,66,57000,602,1000,0.602,563,0.563,165,0.165,84
42136,34510,7626,23490,67,58000,610,1000,0.61,534,0.534,144,0.144,84
42730,34921,7809,24079,68,59000,594,1000,0.594,589,0.589,183,0.183,84
43297,35302,7995,24698,69,60000,567,1000,0.567,619,0.619,186,0.186,84
43879,35732,8147,25268,70,61000,582,1000,0.582,570,0.57,152,0.152,84
44430,36103,8327,25897,71,62000,551,1000,0.551,629,0.629,180,0.18,84
45024,36528,8496,26472,72,63000,594,1000,0.594,575,0.575,169,0.169,84
45590,36930,8660,27070,73,64000,566,1000,0.566,598,0.598,164,0.164,84
46142,37308,8834,27692,74,65000,552,1000,0.552,622,0.622,174,0.174,84
46705,37693,9012,28307,75,66000,563,1000,0.563,615,0.615,178,0.178,84
47279,38115,9164,28885,76,67000,574,1000,0.574,578,0.578,152,0.152,84
47837,38481,9356,29519,77,68000,558,1000,0.558,634,0.634,192,0.192,84
48408,38878,9530,30122,78,69000,571,1000,0.571,603,0.603,174,0.174,84
48971,39277,9694,30723,79,70000,563,1000,0.563,601,0.601,164,0.164,84
49523,39645,9878,31355,80,71000,552,1000,0.552,632,0.632,184,0.184,84
50054,40015,10039,31985,81,72000,531,1000,0.531,630,0.63,161,0.161,84
50626,40417,10209,32583,82,73000,572,1000,0.572,598,0.598,170,0.17,84
51180,40812,10368,33188,83,74000,554,1000,0.554,605,0.605,159,0.159,84
51714,41168,10546,33832,84,75000,534,1000,0.534,644,0.644,178,0.178,84
52277,41574,10703,34426,85,76000,563,1000,0.563,594,0.594,157,0.157,84
52809,41939,10870,35061,86,77000,532,1000,0.532,635,0.635,167,0.167,84
53366,42333,11033,35667,87,78000,557,1000,0.557,606,0.606,163,0.163,84
53926,42747,11179,36253,88,79000,560,1000,0.56,586,0.586,146,0.146,84
54473,43132,11341,36868,89,80000,547,1000,0.547,615,0.615,162,0.162,84
55020,43519,11501,37481,90,81000,547,1000,0.547,613,0.613,160,0.16,84
55539,43844,11695,38156,91,82000,519,1000,0.519,675,0.675,194,0.194,84
56086,44227,11859,38773,92,83000,547,1000,0.547,617,0.617,164,0.164,84
56608,44576,12032,39424,93,84000,522,1000,0.522,651,0.651,173,0.173,84
57144,44947,12197,40053,94,85000,536,1000,0.536,629,0.629,165,0.165,84
57684,45316,12368,40684,95,86000,540,1000,0.54,631,0.631,171,0.171,84
58208,45677,12531,41323,96,87000,524,1000,0.524,639,0.639,163,0.163,84
58725,46020,12705,41980,97,88000,517,1000,0.517,657,0.657,174,0.174,84
59233,46351,12882,42649,98,89000,508,1000,0.508,669,0.669,177,0.177,84
59745,46691,13054,43309,99,90000,512,1000,0.512,660,0.66,172,0.172,84
60301,47106,13195,43894,100,91000,556,1000,0.556,585,0.585,141,0.141,84
60822,47465,13357,44535,101,92000,521,1000,0.521,641,0.641,162,0.162,84
61336,47793,13543,45207,102,93000,514,1000,0.514,672,0.672,186,0.186,84
61836,48107,13729,45893,103,94000,500,1000,0.5,686,0.686,186,0.186,84
62376,48478,13898,46522,104,95000,540,1000,0.54,629,0.629,169,0.169,84
62888,48815,14073,47185,105,96000,512,1000,0.512,663,0.663,175,0.175,84
63379,49131,14248,47869,106,97000,491,1000,0.491,684,0.684,175,0.175,84
63864,49444,14420,48556,107,98000,485,1000,0.485,687,0.687,172,0.172,84
64378,49797,14581,49203,108,99000,514,1000,0.514,647,0.647,161,0.161,84
64881,50129,14752,49871,109,100000,503,1000,0.503,668,0.668,171,0.171,84
65393,50473,14920,50527,110,101000,512,1000,0.512,656,0.656,168,0.168,84
65893,50811,15082,51189,111,102000,500,1000,0.5,662,0.662,162,0.162,84
66402,51140,15262,51860,112,103000,509,1000,0.509,671,0.671,180,0.18,84
66886,51445,15441,52555,113,104000,484,1000,0.484,695,0.695,179,0.179,84
67379,51786,15593,53214,114,105000,493,1000,0.493,659,0.659,152,0.152,84
67863,52105,15758,53895,115,106000,484,1000,0.484,681,0.681,165,0.165,84
68343,52408,15935,54592,116,107000,480,1000,0.48,697,0.697,177,0.177,84
68853,52759,16094,55241,117,108000,510,1000,0.51,649,0.649,159,0.159,84
69331,53073,16258,55927,118,109000,478,1000,0.478,686,0.686,164,0.164,84
69840,53421,16419,56579,119,110000,509,1000,0.509,652,0.652,161,0.161,84
70307,53680,16627,57320,120,111000,467,1000,0.467,741,0.741,208,0.208,84
70795,54002,16793,57998,121,112000,488,1000,0.488,678,0.678,166,0.166,84
71261,54276,16985,58724,122,113000,466,1000,0.466,726,0.726,192,0.192,84
71727,54559,17168,59441,123,114000,466,1000,0.466,717,0.717,183,0.183,84
71869,54638,17231,59660,124,114298,142,298,0.47651006711409394,219,0.7348993288590604,63,0.21140939597315436,84
100,100,0,0,1,100,NA,NA,NA,NA,NA,NA,NA,85
199,198,1,2,2,200,99,100,0.99,2,0.02,1,0.01,85
299,298,1,2,3,300,100,100,1,0,0,0,0,85
397,394,3,6,4,400,98,100,0.98,4,0.04,2,0.02,85
495,490,5,10,5,500,98,100,0.98,4,0.04,2,0.02,85
594,589,5,11,6,600,99,100,0.99,1,0.01,0,0,85
691,683,8,17,7,700,97,100,0.97,6,0.06,3,0.03,85
788,777,11,23,8,800,97,100,0.97,6,0.06,3,0.03,85
881,865,16,35,9,900,93,100,0.93,12,0.12,5,0.05,85
979,961,18,39,10,1000,98,100,0.98,4,0.04,2,0.02,85
1920,1860,60,140,11,2000,941,1000,0.941,101,0.101,42,0.042,85
2852,2742,110,258,12,3000,932,1000,0.932,118,0.118,50,0.05,85
3772,3608,164,392,13,4000,920,1000,0.92,134,0.134,54,0.054,85
4669,4438,231,562,14,5000,897,1000,0.897,170,0.17,67,0.067,85
5548,5238,310,762,15,6000,879,1000,0.879,200,0.2,79,0.079,85
6420,6031,389,969,16,7000,872,1000,0.872,207,0.207,79,0.079,85
7285,6813,472,1187,17,8000,865,1000,0.865,218,0.218,83,0.083,85
8138,7592,546,1408,18,9000,853,1000,0.853,221,0.221,74,0.074,85
8995,8357,638,1643,19,10000,857,1000,0.857,235,0.235,92,0.092,85
9823,9072,751,1928,20,11000,828,1000,0.828,285,0.285,113,0.113,85
10615,9745,870,2255,21,12000,792,1000,0.792,327,0.327,119,0.119,85
11427,10441,986,2559,22,13000,812,1000,0.812,304,0.304,116,0.116,85
12233,11136,1097,2864,23,14000,806,1000,0.806,305,0.305,111,0.111,85
13030,11812,1218,3188,24,15000,797,1000,0.797,324,0.324,121,0.121,85
13826,12490,1336,3510,25,16000,796,1000,0.796,322,0.322,118,0.118,85
14617,13165,1452,3835,26,17000,791,1000,0.791,325,0.325,116,0.116,85
15376,13794,1582,4206,27,18000,759,1000,0.759,371,0.371,130,0.13,85
16132,14416,1716,4584,28,19000,756,1000,0.756,378,0.378,134,0.134,85
16879,15037,1842,4963,29,20000,747,1000,0.747,379,0.379,126,0.126,85
17632,15666,1966,5334,30,21000,753,1000,0.753,371,0.371,124,0.124,85
18374,16269,2105,5731,31,22000,742,1000,0.742,397,0.397,139,0.139,85
19117,16880,2237,6120,32,23000,743,1000,0.743,389,0.389,132,0.132,85
19860,17496,2364,6504,33,24000,743,1000,0.743,384,0.384,127,0.127,85
20575,18064,2511,6936,34,25000,715,1000,0.715,432,0.432,147,0.147,85
21303,18664,2639,7336,35,26000,728,1000,0.728,400,0.4,128,0.128,85
22000,19205,2795,7795,36,27000,697,1000,0.697,459,0.459,156,0.156,85
22717,19783,2934,8217,37,28000,717,1000,0.717,422,0.422,139,0.139,85
23409,20320,3089,8680,38,29000,692,1000,0.692,463,0.463,155,0.155,85
24106,20853,3253,9147,39,30000,697,1000,0.697,467,0.467,164,0.164,85
24828,21439,3389,9561,40,31000,722,1000,0.722,414,0.414,136,0.136,85
25515,21985,3530,10015,41,32000,687,1000,0.687,454,0.454,141,0.141,85
26207,22523,3684,10477,42,33000,692,1000,0.692,462,0.462,154,0.154,85
26901,23068,3833,10932,43,34000,694,1000,0.694,455,0.455,149,0.149,85
27569,23577,3992,11423,44,35000,668,1000,0.668,491,0.491,159,0.159,85
28274,24137,4137,11863,45,36000,705,1000,0.705,440,0.44,145,0.145,85
28951,24671,4280,12329,46,37000,677,1000,0.677,466,0.466,143,0.143,85
29615,25196,4419,12804,47,38000,664,1000,0.664,475,0.475,139,0.139,85
30295,25727,4568,13273,48,39000,680,1000,0.68,469,0.469,149,0.149,85
30938,26215,4723,13785,49,40000,643,1000,0.643,512,0.512,155,0.155,85
31594,26717,4877,14283,50,41000,656,1000,0.656,498,0.498,154,0.154,85
32256,27225,5031,14775,51,42000,662,1000,0.662,492,0.492,154,0.154,85
32902,27719,5183,15281,52,43000,646,1000,0.646,506,0.506,152,0.152,85
33531,28183,5348,15817,53,44000,629,1000,0.629,536,0.536,165,0.165,85
34149,28625,5524,16375,54,45000,618,1000,0.618,558,0.558,176,0.176,85
34785,29082,5703,16918,55,46000,636,1000,0.636,543,0.543,179,0.179,85
35416,29557,5859,17443,56,47000,631,1000,0.631,525,0.525,156,0.156,85
36012,29969,6043,18031,57,48000,596,1000,0.596,588,0.588,184,0.184,85
36653,30473,6180,18527,58,49000,641,1000,0.641,496,0.496,137,0.137,85
37265,30932,6333,19068,59,50000,612,1000,0.612,541,0.541,153,0.153,85
37853,31370,6483,19630,60,51000,588,1000,0.588,562,0.562,150,0.15,85
38466,31802,6664,20198,61,52000,613,1000,0.613,568,0.568,181,0.181,85
39087,32259,6828,20741,62,53000,621,1000,0.621,543,0.543,164,0.164,85
39695,32712,6983,21288,63,54000,608,1000,0.608,547,0.547,155,0.155,85
40319,33184,7135,21816,64,55000,624,1000,0.624,528,0.528,152,0.152,85
40884,33563,7321,22437,65,56000,565,1000,0.565,621,0.621,186,0.186,85
41485,34011,7474,22989,66,57000,601,1000,0.601,552,0.552,153,0.153,85
42096,34465,7631,23535,67,58000,611,1000,0.611,546,0.546,157,0.157,85
42686,34868,7818,24132,68,59000,590,1000,0.59,597,0.597,187,0.187,85
43268,35270,7998,24730,69,60000,582,1000,0.582,598,0.598,180,0.18,85
43860,35700,8160,25300,70,61000,592,1000,0.592,570,0.57,162,0.162,85
44435,36116,8319,25884,71,62000,575,1000,0.575,584,0.584,159,0.159,85
45024,36529,8495,26471,72,63000,589,1000,0.589,587,0.587,176,0.176,85
45604,36925,8679,27075,73,64000,580,1000,0.58,604,0.604,184,0.184,85
46192,37346,8846,27654,74,65000,588,1000,0.588,579,0.579,167,0.167,85
46775,37754,9021,28246,75,66000,583,1000,0.583,592,0.592,175,0.175,85
47322,38126,9196,28874,76,67000,547,1000,0.547,628,0.628,175,0.175,85
47903,38551,9352,29449,77,68000,581,1000,0.581,575,0.575,156,0.156,85
48471,38945,9526,30055,78,69000,568,1000,0.568,606,0.606,174,0.174,85
49046,39349,9697,30651,79,70000,575,1000,0.575,596,0.596,171,0.171,85
49613,39757,9856,31243,80,71000,567,1000,0.567,592,0.592,159,0.159,85
50171,40131,10040,31869,81,72000,558,1000,0.558,626,0.626,184,0.184,85
50729,40518,10211,32482,82,73000,558,1000,0.558,613,0.613,171,0.171,85
51280,40909,10371,33091,83,74000,551,1000,0.551,609,0.609,160,0.16,85
51792,41224,10568,33776,84,75000,512,1000,0.512,685,0.685,197,0.197,85
52331,41601,10730,34399,85,76000,539,1000,0.539,623,0.623,162,0.162,85
52860,41950,10910,35050,86,77000,529,1000,0.529,651,0.651,180,0.18,85
53399,42299,11100,35701,87,78000,539,1000,0.539,651,0.651,190,0.19,85
53951,42704,11247,36296,88,79000,552,1000,0.552,595,0.595,147,0.147,85
54496,43083,11413,36917,89,80000,545,1000,0.545,621,0.621,166,0.166,85
55003,43413,11590,37587,90,81000,507,1000,0.507,670,0.67,177,0.177,85
55517,43751,11766,38249,91,82000,514,1000,0.514,662,0.662,176,0.176,85
56057,44136,11921,38864,92,83000,540,1000,0.54,615,0.615,155,0.155,85
56587,44490,12097,39510,93,84000,530,1000,0.53,646,0.646,176,0.176,85
57114,44835,12279,40165,94,85000,527,1000,0.527,655,0.655,182,0.182,85
57647,45200,12447,40800,95,86000,533,1000,0.533,635,0.635,168,0.168,85
58156,45524,12632,41476,96,87000,509,1000,0.509,676,0.676,185,0.185,85
58678,45894,12784,42106,97,88000,522,1000,0.522,630,0.63,152,0.152,85
59193,46242,12951,42758,98,89000,515,1000,0.515,652,0.652,167,0.167,85
59721,46605,13116,43395,99,90000,528,1000,0.528,637,0.637,165,0.165,85
60232,46943,13289,44057,100,91000,511,1000,0.511,662,0.662,173,0.173,85
60727,47278,13449,44722,101,92000,495,1000,0.495,665,0.665,160,0.16,85
61217,47600,13617,45400,102,93000,490,1000,0.49,678,0.678,168,0.168,85
61738,47951,13787,46049,103,94000,521,1000,0.521,649,0.649,170,0.17,85
62231,48256,13975,46744,104,95000,493,1000,0.493,695,0.695,188,0.188,85
62779,48662,14117,47338,105,96000,548,1000,0.548,594,0.594,142,0.142,85
63263,48960,14303,48040,106,97000,484,1000,0.484,702,0.702,186,0.186,85
63765,49300,14465,48700,107,98000,502,1000,0.502,660,0.66,162,0.162,85
64276,49639,14637,49361,108,99000,511,1000,0.511,661,0.661,172,0.172,85
64796,49988,14808,50012,109,100000,520,1000,0.52,651,0.651,171,0.171,85
65297,50341,14956,50659,110,101000,501,1000,0.501,647,0.647,148,0.148,85
65809,50670,15139,51330,111,102000,512,1000,0.512,671,0.671,183,0.183,85
66291,50980,15311,52020,112,103000,482,1000,0.482,690,0.69,172,0.172,85
66811,51325,15486,52675,113,104000,520,1000,0.52,655,0.655,175,0.175,85
67329,51687,15642,53313,114,105000,518,1000,0.518,638,0.638,156,0.156,85
67821,51997,15824,54003,115,106000,492,1000,0.492,690,0.69,182,0.182,85
68318,52321,15997,54679,116,107000,497,1000,0.497,676,0.676,173,0.173,85
68776,52604,16172,55396,117,108000,458,1000,0.458,717,0.717,175,0.175,85
69283,52940,16343,56060,118,109000,507,1000,0.507,664,0.664,171,0.171,85
69787,53281,16506,56719,119,110000,504,1000,0.504,659,0.659,163,0.163,85
70302,53629,16673,57371,120,111000,515,1000,0.515,652,0.652,167,0.167,85
70779,53946,16833,58054,121,112000,477,1000,0.477,683,0.683,160,0.16,85
71257,54245,17012,58755,122,113000,478,1000,0.478,701,0.701,179,0.179,85
71747,54572,17175,59428,123,114000,490,1000,0.49,673,0.673,163,0.163,85
71869,54638,17231,59660,124,114298,122,298,0.40939597315436244,232,0.7785234899328859,56,0.18791946308724833,85
100,100,0,0,1,100,NA,NA,NA,NA,NA,NA,NA,86
200,200,0,0,2,200,100,100,1,0,0,0,0,86
299,298,1,2,3,300,99,100,0.99,2,0.02,1,0.01,86
397,394,3,6,4,400,98,100,0.98,4,0.04,2,0.02,86
496,492,4,8,5,500,99,100,0.99,2,0.02,1,0.01,86
594,589,5,11,6,600,98,100,0.98,3,0.03,1,0.01,86
690,681,9,19,7,700,96,100,0.96,8,0.08,4,0.04,86
789,779,10,21,8,800,99,100,0.99,2,0.02,1,0.01,86
883,867,16,33,9,900,94,100,0.94,12,0.12,6,0.06,86
980,962,18,38,10,1000,97,100,0.97,5,0.05,2,0.02,86
1936,1885,51,115,11,2000,956,1000,0.956,77,0.077,33,0.033,86
2878,2785,93,215,12,3000,942,1000,0.942,100,0.1,42,0.042,86
3795,3640,155,360,13,4000,917,1000,0.917,145,0.145,62,0.062,86
4687,4454,233,546,14,5000,892,1000,0.892,186,0.186,78,0.078,86
5571,5256,315,744,15,6000,884,1000,0.884,198,0.198,82,0.082,86
6435,6045,390,955,16,7000,864,1000,0.864,211,0.211,75,0.075,86
7289,6816,473,1184,17,8000,854,1000,0.854,229,0.229,83,0.083,86
8141,7566,575,1434,18,9000,852,1000,0.852,250,0.25,102,0.102,86
8992,8323,669,1677,19,10000,851,1000,0.851,243,0.243,94,0.094,86
9829,9060,769,1940,20,11000,837,1000,0.837,263,0.263,100,0.1,86
10649,9773,876,2227,21,12000,820,1000,0.82,287,0.287,107,0.107,86
11451,10460,991,2540,22,13000,802,1000,0.802,313,0.313,115,0.115,86
12233,11125,1108,2875,23,14000,782,1000,0.782,335,0.335,117,0.117,86
13022,11808,1214,3192,24,15000,789,1000,0.789,317,0.317,106,0.106,86
13811,12471,1340,3529,25,16000,789,1000,0.789,337,0.337,126,0.126,86
14591,13128,1463,3872,26,17000,780,1000,0.78,343,0.343,123,0.123,86
15387,13805,1582,4195,27,18000,796,1000,0.796,323,0.323,119,0.119,86
16139,14420,1719,4580,28,19000,752,1000,0.752,385,0.385,137,0.137,86
16891,15037,1854,4963,29,20000,752,1000,0.752,383,0.383,135,0.135,86
17644,15662,1982,5338,30,21000,753,1000,0.753,375,0.375,128,0.128,86
18423,16326,2097,5674,31,22000,779,1000,0.779,336,0.336,115,0.115,86
19160,16931,2229,6069,32,23000,737,1000,0.737,395,0.395,132,0.132,86
19913,17574,2339,6426,33,24000,753,1000,0.753,357,0.357,110,0.11,86
20654,18180,2474,6820,34,25000,741,1000,0.741,394,0.394,135,0.135,86
21382,18762,2620,7238,35,26000,728,1000,0.728,418,0.418,146,0.146,86
22114,19358,2756,7642,36,27000,732,1000,0.732,404,0.404,136,0.136,86
22838,19947,2891,8053,37,28000,724,1000,0.724,411,0.411,135,0.135,86
23529,20484,3045,8516,38,29000,691,1000,0.691,463,0.463,154,0.154,86
24233,21040,3193,8960,39,30000,704,1000,0.704,444,0.444,148,0.148,86
24940,21610,3330,9390,40,31000,707,1000,0.707,430,0.43,137,0.137,86
25612,22132,3480,9868,41,32000,672,1000,0.672,478,0.478,150,0.15,86
26307,22679,3628,10321,42,33000,695,1000,0.695,453,0.453,148,0.148,86
27008,23243,3765,10757,43,34000,701,1000,0.701,436,0.436,137,0.137,86
27694,23797,3897,11203,44,35000,686,1000,0.686,446,0.446,132,0.132,86
28366,24314,4052,11686,45,36000,672,1000,0.672,483,0.483,155,0.155,86
29044,24855,4189,12145,46,37000,678,1000,0.678,459,0.459,137,0.137,86
29697,25353,4344,12647,47,38000,653,1000,0.653,502,0.502,155,0.155,86
30357,25872,4485,13128,48,39000,660,1000,0.66,481,0.481,141,0.141,86
30998,26351,4647,13649,49,40000,641,1000,0.641,521,0.521,162,0.162,86
31648,26857,4791,14143,50,41000,650,1000,0.65,494,0.494,144,0.144,86
32306,27351,4955,14649,51,42000,658,1000,0.658,506,0.506,164,0.164,86
32943,27828,5115,15172,52,43000,637,1000,0.637,523,0.523,160,0.16,86
33559,28265,5294,15735,53,44000,616,1000,0.616,563,0.563,179,0.179,86
34176,28714,5462,16286,54,45000,617,1000,0.617,551,0.551,168,0.168,86
34792,29162,5630,16838,55,46000,616,1000,0.616,552,0.552,168,0.168,86
35432,29627,5805,17373,56,47000,640,1000,0.64,535,0.535,175,0.175,86
36092,30137,5955,17863,57,48000,660,1000,0.66,490,0.49,150,0.15,86
36707,30596,6111,18404,58,49000,615,1000,0.615,541,0.541,156,0.156,86
37312,31042,6270,18958,59,50000,605,1000,0.605,554,0.554,159,0.159,86
37909,31446,6463,19554,60,51000,597,1000,0.597,596,0.596,193,0.193,86
38505,31869,6636,20131,61,52000,596,1000,0.596,577,0.577,173,0.173,86
39124,32339,6785,20661,62,53000,619,1000,0.619,530,0.53,149,0.149,86
39716,32753,6963,21247,63,54000,592,1000,0.592,586,0.586,178,0.178,86
40316,33180,7136,21820,64,55000,600,1000,0.6,573,0.573,173,0.173,86
40925,33625,7300,22375,65,56000,609,1000,0.609,555,0.555,164,0.164,86
41518,34036,7482,22964,66,57000,593,1000,0.593,589,0.589,182,0.182,86
42122,34476,7646,23524,67,58000,604,1000,0.604,560,0.56,164,0.164,86
42718,34905,7813,24095,68,59000,596,1000,0.596,571,0.571,167,0.167,86
43303,35314,7989,24686,69,60000,585,1000,0.585,591,0.591,176,0.176,86
43890,35742,8148,25258,70,61000,587,1000,0.587,572,0.572,159,0.159,86
44494,36191,8303,25809,71,62000,604,1000,0.604,551,0.551,155,0.155,86
45068,36604,8464,26396,72,63000,574,1000,0.574,587,0.587,161,0.161,86
45668,37053,8615,26947,73,64000,600,1000,0.6,551,0.551,151,0.151,86
46240,37446,8794,27554,74,65000,572,1000,0.572,607,0.607,179,0.179,86
46821,37865,8956,28135,75,66000,581,1000,0.581,581,0.581,162,0.162,86
47380,38256,9124,28744,76,67000,559,1000,0.559,609,0.609,168,0.168,86
47929,38645,9284,29355,77,68000,549,1000,0.549,611,0.611,160,0.16,86
48493,39056,9437,29944,78,69000,564,1000,0.564,589,0.589,153,0.153,86
49038,39448,9590,30552,79,70000,545,1000,0.545,608,0.608,153,0.153,86
49611,39846,9765,31154,80,71000,573,1000,0.573,602,0.602,175,0.175,86
50146,40192,9954,31808,81,72000,535,1000,0.535,654,0.654,189,0.189,86
50717,40605,10112,32395,82,73000,571,1000,0.571,587,0.587,158,0.158,86
51263,40988,10275,33012,83,74000,546,1000,0.546,617,0.617,163,0.163,86
51785,41349,10436,33651,84,75000,522,1000,0.522,639,0.639,161,0.161,86
52335,41732,10603,34268,85,76000,550,1000,0.55,617,0.617,167,0.167,86
52893,42134,10759,34866,86,77000,558,1000,0.558,598,0.598,156,0.156,86
53423,42505,10918,35495,87,78000,530,1000,0.53,629,0.629,159,0.159,86
53953,42857,11096,36143,88,79000,530,1000,0.53,648,0.648,178,0.178,86
54493,43227,11266,36773,89,80000,540,1000,0.54,630,0.63,170,0.17,86
55033,43602,11431,37398,90,81000,540,1000,0.54,625,0.625,165,0.165,86
55592,44004,11588,37996,91,82000,559,1000,0.559,598,0.598,157,0.157,86
56149,44395,11754,38605,92,83000,557,1000,0.557,609,0.609,166,0.166,86
56657,44733,11924,39267,93,84000,508,1000,0.508,662,0.662,170,0.17,86
57216,45133,12083,39867,94,85000,559,1000,0.559,600,0.6,159,0.159,86
57757,45515,12242,40485,95,86000,541,1000,0.541,618,0.618,159,0.159,86
58293,45864,12429,41136,96,87000,536,1000,0.536,651,0.651,187,0.187,86
58802,46176,12626,41824,97,88000,509,1000,0.509,688,0.688,197,0.197,86
59327,46523,12804,42477,98,89000,525,1000,0.525,653,0.653,178,0.178,86
59845,46884,12961,43116,99,90000,518,1000,0.518,639,0.639,157,0.157,86
60342,47206,13136,43794,100,91000,497,1000,0.497,678,0.678,175,0.175,86
60864,47561,13303,44439,101,92000,522,1000,0.522,645,0.645,167,0.167,86
61345,47856,13489,45144,102,93000,481,1000,0.481,705,0.705,186,0.186,86
61886,48239,13647,45761,103,94000,541,1000,0.541,617,0.617,158,0.158,86
62404,48591,13813,46409,104,95000,518,1000,0.518,648,0.648,166,0.166,86
62931,48940,13991,47060,105,96000,527,1000,0.527,651,0.651,178,0.178,86
63424,49259,14165,47741,106,97000,493,1000,0.493,681,0.681,174,0.174,86
63914,49577,14337,48423,107,98000,490,1000,0.49,682,0.682,172,0.172,86
64427,49924,14503,49076,108,99000,513,1000,0.513,653,0.653,166,0.166,86
64917,50258,14659,49742,109,100000,490,1000,0.49,666,0.666,156,0.156,86
65408,50565,14843,50435,110,101000,491,1000,0.491,693,0.693,184,0.184,86
65935,50942,14993,51058,111,102000,527,1000,0.527,623,0.623,150,0.15,86
66416,51255,15161,51745,112,103000,481,1000,0.481,687,0.687,168,0.168,86
66913,51583,15330,52417,113,104000,497,1000,0.497,672,0.672,169,0.169,86
67381,51831,15550,53169,114,105000,468,1000,0.468,752,0.752,220,0.22,86
67867,52126,15741,53874,115,106000,486,1000,0.486,705,0.705,191,0.191,86
68350,52423,15927,54577,116,107000,483,1000,0.483,703,0.703,186,0.186,86
68838,52733,16105,55267,117,108000,488,1000,0.488,690,0.69,178,0.178,86
69310,53007,16303,55993,118,109000,472,1000,0.472,726,0.726,198,0.198,86
69819,53344,16475,56656,119,110000,509,1000,0.509,663,0.663,172,0.172,86
70303,53646,16657,57354,120,111000,484,1000,0.484,698,0.698,182,0.182,86
70781,53956,16825,58044,121,112000,478,1000,0.478,690,0.69,168,0.168,86
71250,54237,17013,58763,122,113000,469,1000,0.469,719,0.719,188,0.188,86
71719,54538,17181,59462,123,114000,469,1000,0.469,699,0.699,168,0.168,86
71869,54638,17231,59660,124,114298,150,298,0.5033557046979866,198,0.6644295302013423,50,0.16778523489932887,86
100,100,0,0,1,100,NA,NA,NA,NA,NA,NA,NA,87
199,198,1,2,2,200,99,100,0.99,2,0.02,1,0.01,87
299,298,1,2,3,300,100,100,1,0,0,0,0,87
397,394,3,6,4,400,98,100,0.98,4,0.04,2,0.02,87
497,494,3,6,5,500,100,100,1,0,0,0,0,87
597,594,3,6,6,600,100,100,1,0,0,0,0,87
696,692,4,8,7,700,99,100,0.99,2,0.02,1,0.01,87
794,788,6,12,8,800,98,100,0.98,4,0.04,2,0.02,87
892,884,8,16,9,900,98,100,0.98,4,0.04,2,0.02,87
989,979,10,21,10,1000,97,100,0.97,5,0.05,2,0.02,87
1949,1907,42,93,11,2000,960,1000,0.96,72,0.072,32,0.032,87
2894,2811,83,189,12,3000,945,1000,0.945,96,0.096,41,0.041,87
3806,3656,150,344,13,4000,912,1000,0.912,155,0.155,67,0.067,87
4716,4509,207,491,14,5000,910,1000,0.91,147,0.147,57,0.057,87
5602,5318,284,682,15,6000,886,1000,0.886,191,0.191,77,0.077,87
6489,6134,355,866,16,7000,887,1000,0.887,184,0.184,71,0.071,87
7356,6913,443,1087,17,8000,867,1000,0.867,221,0.221,88,0.088,87
8220,7683,537,1317,18,9000,864,1000,0.864,230,0.23,94,0.094,87
9046,8411,635,1589,19,10000,826,1000,0.826,272,0.272,98,0.098,87
9865,9124,741,1876,20,11000,819,1000,0.819,287,0.287,106,0.106,87
10681,9820,861,2180,21,12000,816,1000,0.816,304,0.304,120,0.12,87
11465,10484,981,2516,22,13000,784,1000,0.784,336,0.336,120,0.12,87
12243,11136,1107,2864,23,14000,778,1000,0.778,348,0.348,126,0.126,87
13043,11813,1230,3187,24,15000,800,1000,0.8,323,0.323,123,0.123,87
13852,12512,1340,3488,25,16000,809,1000,0.809,301,0.301,110,0.11,87
14639,13180,1459,3820,26,17000,787,1000,0.787,332,0.332,119,0.119,87
15430,13850,1580,4150,27,18000,791,1000,0.791,330,0.33,121,0.121,87
16177,14461,1716,4539,28,19000,747,1000,0.747,389,0.389,136,0.136,87
16942,15095,1847,4905,29,20000,765,1000,0.765,366,0.366,131,0.131,87
17705,15733,1972,5267,30,21000,763,1000,0.763,362,0.362,125,0.125,87
18441,16334,2107,5666,31,22000,736,1000,0.736,399,0.399,135,0.135,87
19174,16938,2236,6062,32,23000,733,1000,0.733,396,0.396,129,0.129,87
19894,17538,2356,6462,33,24000,720,1000,0.72,400,0.4,120,0.12,87
20647,18166,2481,6834,34,25000,753,1000,0.753,372,0.372,125,0.125,87
21383,18766,2617,7234,35,26000,736,1000,0.736,400,0.4,136,0.136,87
22105,19344,2761,7656,36,27000,722,1000,0.722,422,0.422,144,0.144,87
22820,19905,2915,8095,37,28000,715,1000,0.715,439,0.439,154,0.154,87
23522,20463,3059,8537,38,29000,702,1000,0.702,442,0.442,144,0.144,87
24215,21003,3212,8997,39,30000,693,1000,0.693,460,0.46,153,0.153,87
24916,21552,3364,9448,40,31000,701,1000,0.701,451,0.451,152,0.152,87
25610,22093,3517,9907,41,32000,694,1000,0.694,459,0.459,153,0.153,87
26288,22621,3667,10379,42,33000,678,1000,0.678,472,0.472,150,0.15,87
26952,23129,3823,10871,43,34000,664,1000,0.664,492,0.492,156,0.156,87
27616,23624,3992,11376,44,35000,664,1000,0.664,505,0.505,169,0.169,87
28285,24150,4135,11850,45,36000,669,1000,0.669,474,0.474,143,0.143,87
28942,24651,4291,12349,46,37000,657,1000,0.657,499,0.499,156,0.156,87
29609,25165,4444,12835,47,38000,667,1000,0.667,486,0.486,153,0.153,87
30264,25659,4605,13341,48,39000,655,1000,0.655,506,0.506,161,0.161,87
30910,26139,4771,13861,49,40000,646,1000,0.646,520,0.52,166,0.166,87
31560,26629,4931,14371,50,41000,650,1000,0.65,510,0.51,160,0.16,87
32208,27131,5077,14869,51,42000,648,1000,0.648,498,0.498,146,0.146,87
32844,27604,5240,15396,52,43000,636,1000,0.636,527,0.527,163,0.163,87
33477,28070,5407,15930,53,44000,633,1000,0.633,534,0.534,167,0.167,87
34092,28511,5581,16489,54,45000,615,1000,0.615,559,0.559,174,0.174,87
34716,28971,5745,17029,55,46000,624,1000,0.624,540,0.54,164,0.164,87
35363,29467,5896,17533,56,47000,647,1000,0.647,504,0.504,151,0.151,87
35983,29911,6072,18089,57,48000,620,1000,0.62,556,0.556,176,0.176,87
36607,30373,6234,18627,58,49000,624,1000,0.624,538,0.538,162,0.162,87
37249,30868,6381,19132,59,50000,642,1000,0.642,505,0.505,147,0.147,87
37849,31314,6535,19686,60,51000,600,1000,0.6,554,0.554,154,0.154,87
38457,31778,6679,20222,61,52000,608,1000,0.608,536,0.536,144,0.144,87
39053,32196,6857,20804,62,53000,596,1000,0.596,582,0.582,178,0.178,87
39663,32638,7025,21362,63,54000,610,1000,0.61,558,0.558,168,0.168,87
40252,33047,7205,21953,64,55000,589,1000,0.589,591,0.591,180,0.18,87
40858,33501,7357,22499,65,56000,606,1000,0.606,546,0.546,152,0.152,87
41462,33955,7507,23045,66,57000,604,1000,0.604,546,0.546,150,0.15,87
42058,34394,7664,23606,67,58000,596,1000,0.596,561,0.561,157,0.157,87
42662,34851,7811,24149,68,59000,604,1000,0.604,543,0.543,147,0.147,87
43256,35279,7977,24721,69,60000,594,1000,0.594,572,0.572,166,0.166,87
43844,35705,8139,25295,70,61000,588,1000,0.588,574,0.574,162,0.162,87
44421,36104,8317,25896,71,62000,577,1000,0.577,601,0.601,178,0.178,87
45009,36524,8485,26476,72,63000,588,1000,0.588,580,0.58,168,0.168,87
45581,36940,8641,27060,73,64000,572,1000,0.572,584,0.584,156,0.156,87
46150,37335,8815,27665,74,65000,569,1000,0.569,605,0.605,174,0.174,87
46733,37753,8980,28247,75,66000,583,1000,0.583,582,0.582,165,0.165,87
47309,38163,9146,28837,76,67000,576,1000,0.576,590,0.59,166,0.166,87
47879,38563,9316,29437,77,68000,570,1000,0.57,600,0.6,170,0.17,87
48453,38966,9487,30034,78,69000,574,1000,0.574,597,0.597,171,0.171,87
49016,39359,9657,30641,79,70000,563,1000,0.563,607,0.607,170,0.17,87
49592,39767,9825,31233,80,71000,576,1000,0.576,592,0.592,168,0.168,87
50133,40155,9978,31845,81,72000,541,1000,0.541,612,0.612,153,0.153,87
50673,40513,10160,32487,82,73000,540,1000,0.54,642,0.642,182,0.182,87
51244,40923,10321,33077,83,74000,571,1000,0.571,590,0.59,161,0.161,87
51815,41345,10470,33655,84,75000,571,1000,0.571,578,0.578,149,0.149,87
52339,41690,10649,34310,85,76000,524,1000,0.524,655,0.655,179,0.179,87
52922,42120,10802,34880,86,77000,583,1000,0.583,570,0.57,153,0.153,87
53482,42514,10968,35486,87,78000,560,1000,0.56,606,0.606,166,0.166,87
54049,42923,11126,36077,88,79000,567,1000,0.567,591,0.591,158,0.158,87
54578,43277,11301,36723,89,80000,529,1000,0.529,646,0.646,175,0.175,87
55105,43632,11473,37368,90,81000,527,1000,0.527,645,0.645,172,0.172,87
55646,44002,11644,37998,91,82000,541,1000,0.541,630,0.63,171,0.171,87
56149,44313,11836,38687,92,83000,503,1000,0.503,689,0.689,192,0.192,87
56700,44705,11995,39295,93,84000,551,1000,0.551,608,0.608,159,0.159,87
57214,45022,12192,39978,94,85000,514,1000,0.514,683,0.683,197,0.197,87
57760,45401,12359,40599,95,86000,546,1000,0.546,621,0.621,167,0.167,87
58278,45751,12527,41249,96,87000,518,1000,0.518,650,0.65,168,0.168,87
58796,46073,12723,41927,97,88000,518,1000,0.518,678,0.678,196,0.196,87
59318,46413,12905,42587,98,89000,522,1000,0.522,660,0.66,182,0.182,87
59815,46741,13074,43259,99,90000,497,1000,0.497,672,0.672,169,0.169,87
60300,47056,13244,43944,100,91000,485,1000,0.485,685,0.685,170,0.17,87
60828,47421,13407,44579,101,92000,528,1000,0.528,635,0.635,163,0.163,87
61361,47795,13566,45205,102,93000,533,1000,0.533,626,0.626,159,0.159,87
61878,48138,13740,45862,103,94000,517,1000,0.517,657,0.657,174,0.174,87
62377,48457,13920,46543,104,95000,499,1000,0.499,681,0.681,180,0.18,87
62893,48795,14098,47205,105,96000,516,1000,0.516,662,0.662,178,0.178,87
63394,49118,14276,47882,106,97000,501,1000,0.501,677,0.677,178,0.178,87
63891,49443,14448,48557,107,98000,497,1000,0.497,675,0.675,172,0.172,87
64365,49739,14626,49261,108,99000,474,1000,0.474,704,0.704,178,0.178,87
64873,50079,14794,49921,109,100000,508,1000,0.508,660,0.66,168,0.168,87
65384,50440,14944,50560,110,101000,511,1000,0.511,639,0.639,150,0.15,87
65889,50782,15107,51218,111,102000,505,1000,0.505,658,0.658,163,0.163,87
66394,51110,15284,51890,112,103000,505,1000,0.505,672,0.672,177,0.177,87
66879,51417,15462,52583,113,104000,485,1000,0.485,693,0.693,178,0.178,87
67345,51695,15650,53305,114,105000,466,1000,0.466,722,0.722,188,0.188,87
67834,52003,15831,53997,115,106000,489,1000,0.489,692,0.692,181,0.181,87
68316,52296,16020,54704,116,107000,482,1000,0.482,707,0.707,189,0.189,87
68832,52651,16181,55349,117,108000,516,1000,0.516,645,0.645,161,0.161,87
69312,52963,16349,56037,118,109000,480,1000,0.48,688,0.688,168,0.168,87
69777,53271,16506,56729,119,110000,465,1000,0.465,692,0.692,157,0.157,87
70295,53635,16660,57365,120,111000,518,1000,0.518,636,0.636,154,0.154,87
70778,53944,16834,58056,121,112000,483,1000,0.483,691,0.691,174,0.174,87
71253,54241,17012,58759,122,113000,475,1000,0.475,703,0.703,178,0.178,87
71724,54536,17188,59464,123,114000,471,1000,0.471,705,0.705,176,0.176,87
71869,54638,17231,59660,124,114298,145,298,0.4865771812080537,196,0.6577181208053692,43,0.14429530201342283,87
99,98,1,2,1,100,NA,NA,NA,NA,NA,NA,NA,88
198,196,2,4,2,200,99,100,0.99,2,0.02,1,0.01,88
296,293,3,7,3,300,98,100,0.98,3,0.03,1,0.01,88
394,389,5,11,4,400,98,100,0.98,4,0.04,2,0.02,88
494,489,5,11,5,500,100,100,1,0,0,0,0,88
591,583,8,17,6,600,97,100,0.97,6,0.06,3,0.03,88
688,678,10,22,7,700,97,100,0.97,5,0.05,2,0.02,88
786,774,12,26,8,800,98,100,0.98,4,0.04,2,0.02,88
883,869,14,31,9,900,97,100,0.97,5,0.05,2,0.02,88
980,963,17,37,10,1000,97,100,0.97,6,0.06,3,0.03,88
1943,1901,42,99,11,2000,963,1000,0.963,62,0.062,25,0.025,88
2869,2776,93,224,12,3000,926,1000,0.926,125,0.125,51,0.051,88
3788,3639,149,361,13,4000,919,1000,0.919,137,0.137,56,0.056,88
4682,4460,222,540,14,5000,894,1000,0.894,179,0.179,73,0.073,88
5576,5283,293,717,15,6000,894,1000,0.894,177,0.177,71,0.071,88
6457,6093,364,907,16,7000,881,1000,0.881,190,0.19,71,0.071,88
7320,6872,448,1128,17,8000,863,1000,0.863,221,0.221,84,0.084,88
8177,7648,529,1352,18,9000,857,1000,0.857,224,0.224,81,0.081,88
9030,8410,620,1590,19,10000,853,1000,0.853,238,0.238,91,0.091,88
9834,9095,739,1905,20,11000,804,1000,0.804,315,0.315,119,0.119,88
10650,9799,851,2201,21,12000,816,1000,0.816,296,0.296,112,0.112,88
11448,10480,968,2520,22,13000,798,1000,0.798,319,0.319,117,0.117,88
12241,11157,1084,2843,23,14000,793,1000,0.793,323,0.323,116,0.116,88
13022,11809,1213,3191,24,15000,781,1000,0.781,348,0.348,129,0.129,88
13823,12504,1319,3496,25,16000,801,1000,0.801,305,0.305,106,0.106,88
14596,13160,1436,3840,26,17000,773,1000,0.773,344,0.344,117,0.117,88
15346,13754,1592,4246,27,18000,750,1000,0.75,406,0.406,156,0.156,88
16108,14397,1711,4603,28,19000,762,1000,0.762,357,0.357,119,0.119,88
16873,15029,1844,4971,29,20000,765,1000,0.765,368,0.368,133,0.133,88
17629,15652,1977,5348,30,21000,756,1000,0.756,377,0.377,133,0.133,88
18386,16281,2105,5719,31,22000,757,1000,0.757,371,0.371,128,0.128,88
19127,16893,2234,6107,32,23000,741,1000,0.741,388,0.388,129,0.129,88
19872,17508,2364,6492,33,24000,745,1000,0.745,385,0.385,130,0.13,88
20589,18075,2514,6925,34,25000,717,1000,0.717,433,0.433,150,0.15,88
21322,18672,2650,7328,35,26000,733,1000,0.733,403,0.403,136,0.136,88
22039,19255,2784,7745,36,27000,717,1000,0.717,417,0.417,134,0.134,88
22749,19816,2933,8184,37,28000,710,1000,0.71,439,0.439,149,0.149,88
23473,20393,3080,8607,38,29000,724,1000,0.724,423,0.423,147,0.147,88
24161,20928,3233,9072,39,30000,688,1000,0.688,465,0.465,153,0.153,88
24853,21473,3380,9527,40,31000,692,1000,0.692,455,0.455,147,0.147,88
25556,22026,3530,9974,41,32000,703,1000,0.703,447,0.447,150,0.15,88
26244,22566,3678,10434,42,33000,688,1000,0.688,460,0.46,148,0.148,88
26932,23105,3827,10895,43,34000,688,1000,0.688,461,0.461,149,0.149,88
27629,23658,3971,11342,44,35000,697,1000,0.697,447,0.447,144,0.144,88
28311,24197,4114,11803,45,36000,682,1000,0.682,461,0.461,143,0.143,88
28972,24699,4273,12301,46,37000,661,1000,0.661,498,0.498,159,0.159,88
29637,25205,4432,12795,47,38000,665,1000,0.665,494,0.494,159,0.159,88
30307,25730,4577,13270,48,39000,670,1000,0.67,475,0.475,145,0.145,88
30963,26243,4720,13757,49,40000,656,1000,0.656,487,0.487,143,0.143,88
31608,26719,4889,14281,50,41000,645,1000,0.645,524,0.524,169,0.169,88
32256,27214,5042,14786,51,42000,648,1000,0.648,505,0.505,153,0.153,88
32903,27707,5196,15293,52,43000,647,1000,0.647,507,0.507,154,0.154,88
33536,28174,5362,15826,53,44000,633,1000,0.633,533,0.533,166,0.166,88
34140,28609,5531,16391,54,45000,604,1000,0.604,565,0.565,169,0.169,88
34781,29095,5686,16905,55,46000,641,1000,0.641,514,0.514,155,0.155,88
35403,29559,5844,17441,56,47000,622,1000,0.622,536,0.536,158,0.158,88
36016,30009,6007,17991,57,48000,613,1000,0.613,550,0.55,163,0.163,88
36640,30449,6191,18551,58,49000,624,1000,0.624,560,0.56,184,0.184,88
37251,30888,6363,19112,59,50000,611,1000,0.611,561,0.561,172,0.172,88
37873,31351,6522,19649,60,51000,622,1000,0.622,537,0.537,159,0.159,88
38517,31853,6664,20147,61,52000,644,1000,0.644,498,0.498,142,0.142,88
39169,32360,6809,20640,62,53000,652,1000,0.652,493,0.493,145,0.145,88
39775,32805,6970,21195,63,54000,606,1000,0.606,555,0.555,161,0.161,88
40364,33216,7148,21784,64,55000,589,1000,0.589,589,0.589,178,0.178,88
40968,33639,7329,22361,65,56000,604,1000,0.604,577,0.577,181,0.181,88
41566,34088,7478,22912,66,57000,598,1000,0.598,551,0.551,149,0.149,88
42173,34535,7638,23465,67,58000,607,1000,0.607,553,0.553,160,0.16,88
42746,34929,7817,24071,68,59000,573,1000,0.573,606,0.606,179,0.179,88
43326,35334,7992,24666,69,60000,580,1000,0.58,595,0.595,175,0.175,88
43910,35750,8160,25250,70,61000,584,1000,0.584,584,0.584,168,0.168,88
44495,36179,8316,25821,71,62000,585,1000,0.585,571,0.571,156,0.156,88
45087,36612,8475,26388,72,63000,592,1000,0.592,567,0.567,159,0.159,88
45646,36992,8654,27008,73,64000,559,1000,0.559,620,0.62,179,0.179,88
46240,37427,8813,27573,74,65000,594,1000,0.594,565,0.565,159,0.159,88
46812,37819,8993,28181,75,66000,572,1000,0.572,608,0.608,180,0.18,88
47415,38278,9137,28722,76,67000,603,1000,0.603,541,0.541,144,0.144,88
47984,38667,9317,29333,77,68000,569,1000,0.569,611,0.611,180,0.18,88
48546,39056,9490,29944,78,69000,562,1000,0.562,611,0.611,173,0.173,88
49078,39394,9684,30606,79,70000,532,1000,0.532,662,0.662,194,0.194,88
49623,39793,9830,31207,80,71000,545,1000,0.545,601,0.601,146,0.146,88
50214,40223,9991,31777,81,72000,591,1000,0.591,570,0.57,161,0.161,88
50744,40567,10177,32433,82,73000,530,1000,0.53,656,0.656,186,0.186,88
51310,40970,10340,33030,83,74000,566,1000,0.566,597,0.597,163,0.163,88
51910,41417,10493,33583,84,75000,600,1000,0.6,553,0.553,153,0.153,88
52455,41791,10664,34209,85,76000,545,1000,0.545,626,0.626,171,0.171,88
52985,42150,10835,34850,86,77000,530,1000,0.53,641,0.641,171,0.171,88
53530,42528,11002,35472,87,78000,545,1000,0.545,622,0.622,167,0.167,88
54089,42944,11145,36056,88,79000,559,1000,0.559,584,0.584,143,0.143,88
54633,43310,11323,36690,89,80000,544,1000,0.544,634,0.634,178,0.178,88
55180,43719,11461,37281,90,81000,547,1000,0.547,591,0.591,138,0.138,88
55704,44077,11627,37923,91,82000,524,1000,0.524,642,0.642,166,0.166,88
56250,44467,11783,38533,92,83000,546,1000,0.546,610,0.61,156,0.156,88
56788,44832,11956,39168,93,84000,538,1000,0.538,635,0.635,173,0.173,88
57324,45225,12099,39775,94,85000,536,1000,0.536,607,0.607,143,0.143,88
57844,45575,12269,40425,95,86000,520,1000,0.52,650,0.65,170,0.17,88
58356,45917,12439,41083,96,87000,512,1000,0.512,658,0.658,170,0.17,88
58885,46285,12600,41715,97,88000,529,1000,0.529,632,0.632,161,0.161,88
59413,46649,12764,42351,98,89000,528,1000,0.528,636,0.636,164,0.164,88
59953,47011,12942,42989,99,90000,540,1000,0.54,638,0.638,178,0.178,88
60483,47373,13110,43627,100,91000,530,1000,0.53,638,0.638,168,0.168,88
61031,47737,13294,44263,101,92000,548,1000,0.548,636,0.636,184,0.184,88
61525,48034,13491,44966,102,93000,494,1000,0.494,703,0.703,197,0.197,88
62038,48378,13660,45622,103,94000,513,1000,0.513,656,0.656,169,0.169,88
62529,48699,13830,46301,104,95000,491,1000,0.491,679,0.679,170,0.17,88
63031,49019,14012,46981,105,96000,502,1000,0.502,680,0.68,182,0.182,88
63543,49367,14176,47633,106,97000,512,1000,0.512,652,0.652,164,0.164,88
64007,49642,14365,48358,107,98000,464,1000,0.464,725,0.725,189,0.189,88
64502,49949,14553,49051,108,99000,495,1000,0.495,693,0.693,188,0.188,88
65011,50294,14717,49706,109,100000,509,1000,0.509,655,0.655,164,0.164,88
65510,50628,14882,50372,110,101000,499,1000,0.499,666,0.666,165,0.165,88
66011,50945,15066,51055,111,102000,501,1000,0.501,683,0.683,184,0.184,88
66518,51272,15246,51728,112,103000,507,1000,0.507,673,0.673,180,0.18,88
67016,51596,15420,52404,113,104000,498,1000,0.498,676,0.676,174,0.174,88
67499,51899,15600,53101,114,105000,483,1000,0.483,697,0.697,180,0.18,88
67997,52231,15766,53769,115,106000,498,1000,0.498,668,0.668,166,0.166,88
68474,52536,15938,54464,116,107000,477,1000,0.477,695,0.695,172,0.172,88
68923,52799,16124,55201,117,108000,449,1000,0.449,737,0.737,186,0.186,88
69372,53039,16333,55961,118,109000,449,1000,0.449,760,0.76,209,0.209,88
69843,53351,16492,56649,119,110000,471,1000,0.471,688,0.688,159,0.159,88
70328,53676,16652,57324,120,111000,485,1000,0.485,675,0.675,160,0.16,88
70812,53990,16822,58010,121,112000,484,1000,0.484,686,0.686,170,0.17,88
71247,54232,17015,58768,122,113000,435,1000,0.435,758,0.758,193,0.193,88
71730,54558,17172,59442,123,114000,483,1000,0.483,674,0.674,157,0.157,88
71869,54638,17231,59660,124,114298,139,298,0.4664429530201342,218,0.7315436241610739,59,0.19798657718120805,88
100,100,0,0,1,100,NA,NA,NA,NA,NA,NA,NA,89
200,200,0,0,2,200,100,100,1,0,0,0,0,89
299,298,1,2,3,300,99,100,0.99,2,0.02,1,0.01,89
397,395,2,5,4,400,98,100,0.98,3,0.03,1,0.01,89
493,488,5,12,5,500,96,100,0.96,7,0.07,3,0.03,89
591,584,7,16,6,600,98,100,0.98,4,0.04,2,0.02,89
689,680,9,20,7,700,98,100,0.98,4,0.04,2,0.02,89
788,778,10,22,8,800,99,100,0.99,2,0.02,1,0.01,89
887,876,11,24,9,900,99,100,0.99,2,0.02,1,0.01,89
986,974,12,26,10,1000,99,100,0.99,2,0.02,1,0.01,89
1943,1898,45,102,11,2000,957,1000,0.957,76,0.076,33,0.033,89
2864,2763,101,237,12,3000,921,1000,0.921,135,0.135,56,0.056,89
3765,3597,168,403,13,4000,901,1000,0.901,166,0.166,67,0.067,89
4663,4426,237,574,14,5000,898,1000,0.898,171,0.171,69,0.069,89
5550,5256,294,744,15,6000,887,1000,0.887,170,0.17,57,0.057,89
6416,6034,382,966,16,7000,866,1000,0.866,222,0.222,88,0.088,89
7273,6794,479,1206,17,8000,857,1000,0.857,240,0.24,97,0.097,89
8118,7561,557,1439,18,9000,845,1000,0.845,233,0.233,78,0.078,89
8952,8295,657,1705,19,10000,834,1000,0.834,266,0.266,100,0.1,89
9782,9033,749,1967,20,11000,830,1000,0.83,262,0.262,92,0.092,89
10583,9721,862,2279,21,12000,801,1000,0.801,312,0.312,113,0.113,89
11383,10398,985,2602,22,13000,800,1000,0.8,323,0.323,123,0.123,89
12171,11049,1122,2951,23,14000,788,1000,0.788,349,0.349,137,0.137,89
12955,11723,1232,3277,24,15000,784,1000,0.784,326,0.326,110,0.11,89
13757,12429,1328,3571,25,16000,802,1000,0.802,294,0.294,96,0.096,89
14506,13046,1460,3954,26,17000,749,1000,0.749,383,0.383,132,0.132,89
15251,13645,1606,4355,27,18000,745,1000,0.745,401,0.401,146,0.146,89
16016,14293,1723,4707,28,19000,765,1000,0.765,352,0.352,117,0.117,89
16786,14956,1830,5044,29,20000,770,1000,0.77,337,0.337,107,0.107,89
17539,15580,1959,5420,30,21000,753,1000,0.753,376,0.376,129,0.129,89
18304,16217,2087,5783,31,22000,765,1000,0.765,363,0.363,128,0.128,89
19060,16839,2221,6161,32,23000,756,1000,0.756,378,0.378,134,0.134,89
19796,17429,2367,6571,33,24000,736,1000,0.736,410,0.41,146,0.146,89
20505,17995,2510,7005,34,25000,709,1000,0.709,434,0.434,143,0.143,89
21227,18572,2655,7428,35,26000,722,1000,0.722,423,0.423,145,0.145,89
21942,19143,2799,7857,36,27000,715,1000,0.715,429,0.429,144,0.144,89
22654,19704,2950,8296,37,28000,712,1000,0.712,439,0.439,151,0.151,89
23371,20284,3087,8716,38,29000,717,1000,0.717,420,0.42,137,0.137,89
24071,20851,3220,9149,39,30000,700,1000,0.7,433,0.433,133,0.133,89
24794,21440,3354,9560,40,31000,723,1000,0.723,411,0.411,134,0.134,89
25461,21941,3520,10059,41,32000,667,1000,0.667,499,0.499,166,0.166,89
26168,22502,3666,10498,42,33000,707,1000,0.707,439,0.439,146,0.146,89
26872,23062,3810,10938,43,34000,704,1000,0.704,440,0.44,144,0.144,89
27577,23639,3938,11361,44,35000,705,1000,0.705,423,0.423,128,0.128,89
28238,24151,4087,11849,45,36000,661,1000,0.661,488,0.488,149,0.149,89
28931,24699,4232,12301,46,37000,693,1000,0.693,452,0.452,145,0.145,89
29576,25183,4393,12817,47,38000,645,1000,0.645,516,0.516,161,0.161,89
30211,25657,4554,13343,48,39000,635,1000,0.635,526,0.526,161,0.161,89
30867,26152,4715,13848,49,40000,656,1000,0.656,505,0.505,161,0.161,89
31496,26616,4880,14384,50,41000,629,1000,0.629,536,0.536,165,0.165,89
32155,27119,5036,14881,51,42000,659,1000,0.659,497,0.497,156,0.156,89
32809,27617,5192,15383,52,43000,654,1000,0.654,502,0.502,156,0.156,89
33424,28050,5374,15950,53,44000,615,1000,0.615,567,0.567,182,0.182,89
34064,28547,5517,16453,54,45000,640,1000,0.64,503,0.503,143,0.143,89
34682,29004,5678,16996,55,46000,618,1000,0.618,543,0.543,161,0.161,89
35294,29454,5840,17546,56,47000,612,1000,0.612,550,0.55,162,0.162,89
35894,29873,6021,18127,57,48000,600,1000,0.6,581,0.581,181,0.181,89
36511,30336,6175,18664,58,49000,617,1000,0.617,537,0.537,154,0.154,89
37119,30788,6331,19212,59,50000,608,1000,0.608,548,0.548,156,0.156,89
37765,31297,6468,19703,60,51000,646,1000,0.646,491,0.491,137,0.137,89
38398,31761,6637,20239,61,52000,633,1000,0.633,536,0.536,169,0.169,89
39015,32229,6786,20771,62,53000,617,1000,0.617,532,0.532,149,0.149,89
39609,32655,6954,21345,63,54000,594,1000,0.594,574,0.574,168,0.168,89
40220,33115,7105,21885,64,55000,611,1000,0.611,540,0.54,151,0.151,89
40801,33529,7272,22471,65,56000,581,1000,0.581,586,0.586,167,0.167,89
41388,33952,7436,23048,66,57000,587,1000,0.587,577,0.577,164,0.164,89
41968,34365,7603,23635,67,58000,580,1000,0.58,587,0.587,167,0.167,89
42573,34812,7761,24188,68,59000,605,1000,0.605,553,0.553,158,0.158,89
43143,35206,7937,24794,69,60000,570,1000,0.57,606,0.606,176,0.176,89
43743,35647,8096,25353,70,61000,600,1000,0.6,559,0.559,159,0.159,89
44341,36078,8263,25922,71,62000,598,1000,0.598,569,0.569,167,0.167,89
44918,36476,8442,26524,72,63000,577,1000,0.577,602,0.602,179,0.179,89
45518,36902,8616,27098,73,64000,600,1000,0.6,574,0.574,174,0.174,89
46101,37318,8783,27682,74,65000,583,1000,0.583,584,0.584,167,0.167,89
46687,37751,8936,28249,75,66000,586,1000,0.586,567,0.567,153,0.153,89
47276,38193,9083,28807,76,67000,589,1000,0.589,558,0.558,147,0.147,89
47853,38596,9257,29404,77,68000,577,1000,0.577,597,0.597,174,0.174,89
48418,38981,9437,30019,78,69000,565,1000,0.565,615,0.615,180,0.18,89
48963,39344,9619,30656,79,70000,545,1000,0.545,637,0.637,182,0.182,89
49541,39755,9786,31245,80,71000,578,1000,0.578,589,0.589,167,0.167,89
50092,40145,9947,31855,81,72000,551,1000,0.551,610,0.61,161,0.161,89
50661,40567,10094,32433,82,73000,569,1000,0.569,578,0.578,147,0.147,89
51243,40980,10263,33020,83,74000,582,1000,0.582,587,0.587,169,0.169,89
51780,41341,10439,33659,84,75000,537,1000,0.537,639,0.639,176,0.176,89
52340,41726,10614,34274,85,76000,560,1000,0.56,615,0.615,175,0.175,89
52916,42140,10776,34860,86,77000,576,1000,0.576,586,0.586,162,0.162,89
53440,42478,10962,35522,87,78000,524,1000,0.524,662,0.662,186,0.186,89
54000,42865,11135,36135,88,79000,560,1000,0.56,613,0.613,173,0.173,89
54541,43223,11318,36777,89,80000,541,1000,0.541,642,0.642,183,0.183,89
55085,43591,11494,37409,90,81000,544,1000,0.544,632,0.632,176,0.176,89
55616,43956,11660,38044,91,82000,531,1000,0.531,635,0.635,166,0.166,89
56187,44358,11829,38642,92,83000,571,1000,0.571,598,0.598,169,0.169,89
56707,44699,12008,39301,93,84000,520,1000,0.52,659,0.659,179,0.179,89
57250,45080,12170,39920,94,85000,543,1000,0.543,619,0.619,162,0.162,89
57772,45448,12324,40552,95,86000,522,1000,0.522,632,0.632,154,0.154,89
58285,45789,12496,41211,96,87000,513,1000,0.513,659,0.659,172,0.172,89
58833,46170,12663,41830,97,88000,548,1000,0.548,619,0.619,167,0.167,89
59361,46529,12832,42471,98,89000,528,1000,0.528,641,0.641,169,0.169,89
59865,46865,13000,43135,99,90000,504,1000,0.504,664,0.664,168,0.168,89
60362,47169,13193,43831,100,91000,497,1000,0.497,696,0.696,193,0.193,89
60862,47488,13374,44512,101,92000,500,1000,0.5,681,0.681,181,0.181,89
61380,47834,13546,45166,102,93000,518,1000,0.518,654,0.654,172,0.172,89
61911,48182,13729,45818,103,94000,531,1000,0.531,652,0.652,183,0.183,89
62430,48534,13896,46466,104,95000,519,1000,0.519,648,0.648,167,0.167,89
62899,48825,14074,47175,105,96000,469,1000,0.469,709,0.709,178,0.178,89
63403,49159,14244,47841,106,97000,504,1000,0.504,666,0.666,170,0.17,89
63884,49443,14441,48557,107,98000,481,1000,0.481,716,0.716,197,0.197,89
64397,49792,14605,49208,108,99000,513,1000,0.513,651,0.651,164,0.164,89
64886,50117,14769,49883,109,100000,489,1000,0.489,675,0.675,164,0.164,89
65382,50437,14945,50563,110,101000,496,1000,0.496,680,0.68,176,0.176,89
65898,50803,15095,51197,111,102000,516,1000,0.516,634,0.634,150,0.15,89
66401,51137,15264,51863,112,103000,503,1000,0.503,666,0.666,169,0.169,89
66908,51473,15435,52527,113,104000,507,1000,0.507,664,0.664,171,0.171,89
67368,51748,15620,53252,114,105000,460,1000,0.46,725,0.725,185,0.185,89
67847,52050,15797,53950,115,106000,479,1000,0.479,698,0.698,177,0.177,89
68323,52338,15985,54662,116,107000,476,1000,0.476,712,0.712,188,0.188,89
68797,52631,16166,55369,117,108000,474,1000,0.474,707,0.707,181,0.181,89
69289,52963,16326,56037,118,109000,492,1000,0.492,668,0.668,160,0.16,89
69773,53279,16494,56721,119,110000,484,1000,0.484,684,0.684,168,0.168,89
70279,53621,16658,57379,120,111000,506,1000,0.506,658,0.658,164,0.164,89
70758,53938,16820,58062,121,112000,479,1000,0.479,683,0.683,162,0.162,89
71241,54247,16994,58753,122,113000,483,1000,0.483,691,0.691,174,0.174,89
71738,54571,17167,59429,123,114000,497,1000,0.497,676,0.676,173,0.173,89
71869,54638,17231,59660,124,114298,131,298,0.4395973154362416,231,0.7751677852348994,64,0.21476510067114093,89
100,100,0,0,1,100,NA,NA,NA,NA,NA,NA,NA,90
199,198,1,2,2,200,99,100,0.99,2,0.02,1,0.01,90
298,296,2,4,3,300,99,100,0.99,2,0.02,1,0.01,90
395,390,5,10,4,400,97,100,0.97,6,0.06,3,0.03,90
495,490,5,10,5,500,100,100,1,0,0,0,0,90
595,590,5,10,6,600,100,100,1,0,0,0,0,90
692,684,8,16,7,700,97,100,0.97,6,0.06,3,0.03,90
790,780,10,20,8,800,98,100,0.98,4,0.04,2,0.02,90
888,876,12,24,9,900,98,100,0.98,4,0.04,2,0.02,90
985,971,14,29,10,1000,97,100,0.97,5,0.05,2,0.02,90
1954,1918,36,82,11,2000,969,1000,0.969,53,0.053,22,0.022,90
2885,2799,86,201,12,3000,931,1000,0.931,119,0.119,50,0.05,90
3793,3651,142,349,13,4000,908,1000,0.908,148,0.148,56,0.056,90
4692,4485,207,515,14,5000,899,1000,0.899,166,0.166,65,0.065,90
5580,5298,282,702,15,6000,888,1000,0.888,187,0.187,75,0.075,90
6445,6070,375,930,16,7000,865,1000,0.865,228,0.228,93,0.093,90
7302,6852,450,1148,17,8000,857,1000,0.857,218,0.218,75,0.075,90
8159,7609,550,1391,18,9000,857,1000,0.857,243,0.243,100,0.1,90
9017,8377,640,1623,19,10000,858,1000,0.858,232,0.232,90,0.09,90
9844,9106,738,1894,20,11000,827,1000,0.827,271,0.271,98,0.098,90
10655,9793,862,2207,21,12000,811,1000,0.811,313,0.313,124,0.124,90
11465,10487,978,2513,22,13000,810,1000,0.81,306,0.306,116,0.116,90
12304,11227,1077,2773,23,14000,839,1000,0.839,260,0.26,99,0.099,90
13099,11910,1189,3090,24,15000,795,1000,0.795,317,0.317,112,0.112,90
13900,12585,1315,3415,25,16000,801,1000,0.801,325,0.325,126,0.126,90
14674,13235,1439,3765,26,17000,774,1000,0.774,350,0.35,124,0.124,90
15441,13874,1567,4126,27,18000,767,1000,0.767,361,0.361,128,0.128,90
16201,14515,1686,4485,28,19000,760,1000,0.76,359,0.359,119,0.119,90
16953,15142,1811,4858,29,20000,752,1000,0.752,373,0.373,125,0.125,90
17697,15759,1938,5241,30,21000,744,1000,0.744,383,0.383,127,0.127,90
18453,16389,2064,5611,31,22000,756,1000,0.756,370,0.37,126,0.126,90
19200,17003,2197,5997,32,23000,747,1000,0.747,386,0.386,133,0.133,90
19922,17593,2329,6407,33,24000,722,1000,0.722,410,0.41,132,0.132,90
20663,18202,2461,6798,34,25000,741,1000,0.741,391,0.391,132,0.132,90
21381,18763,2618,7237,35,26000,718,1000,0.718,439,0.439,157,0.157,90
22078,19294,2784,7706,36,27000,697,1000,0.697,469,0.469,166,0.166,90
22794,19883,2911,8117,37,28000,716,1000,0.716,411,0.411,127,0.127,90
23504,20451,3053,8549,38,29000,710,1000,0.71,432,0.432,142,0.142,90
24208,21029,3179,8971,39,30000,704,1000,0.704,422,0.422,126,0.126,90
24928,21614,3314,9386,40,31000,720,1000,0.72,415,0.415,135,0.135,90
25641,22174,3467,9826,41,32000,713,1000,0.713,440,0.44,153,0.153,90
26340,22730,3610,10270,42,33000,699,1000,0.699,444,0.444,143,0.143,90
27006,23234,3772,10766,43,34000,666,1000,0.666,496,0.496,162,0.162,90
27669,23740,3929,11260,44,35000,663,1000,0.663,494,0.494,157,0.157,90
28330,24250,4080,11750,45,36000,661,1000,0.661,490,0.49,151,0.151,90
29009,24776,4233,12224,46,37000,679,1000,0.679,474,0.474,153,0.153,90
29697,25331,4366,12669,47,38000,688,1000,0.688,445,0.445,133,0.133,90
30377,25845,4532,13155,48,39000,680,1000,0.68,486,0.486,166,0.166,90
31026,26318,4708,13682,49,40000,649,1000,0.649,527,0.527,176,0.176,90
31661,26777,4884,14223,50,41000,635,1000,0.635,541,0.541,176,0.176,90
32302,27256,5046,14744,51,42000,641,1000,0.641,521,0.521,162,0.162,90
32960,27763,5197,15237,52,43000,658,1000,0.658,493,0.493,151,0.151,90
33611,28260,5351,15740,53,44000,651,1000,0.651,503,0.503,154,0.154,90
34251,28761,5490,16239,54,45000,640,1000,0.64,499,0.499,139,0.139,90
34870,29223,5647,16777,55,46000,619,1000,0.619,538,0.538,157,0.157,90
35520,29725,5795,17275,56,47000,650,1000,0.65,498,0.498,148,0.148,90
36126,30166,5960,17834,57,48000,606,1000,0.606,559,0.559,165,0.165,90
36736,30601,6135,18399,58,49000,610,1000,0.61,565,0.565,175,0.175,90
37358,31058,6300,18942,59,50000,622,1000,0.622,543,0.543,165,0.165,90
37993,31529,6464,19471,60,51000,635,1000,0.635,529,0.529,164,0.164,90
38646,32040,6606,19960,61,52000,653,1000,0.653,489,0.489,142,0.142,90
39247,32473,6774,20527,62,53000,601,1000,0.601,567,0.567,168,0.168,90
39834,32891,6943,21109,63,54000,587,1000,0.587,582,0.582,169,0.169,90
40443,33351,7092,21649,64,55000,609,1000,0.609,540,0.54,149,0.149,90
41052,33791,7261,22209,65,56000,609,1000,0.609,560,0.56,169,0.169,90
41642,34207,7435,22793,66,57000,590,1000,0.59,584,0.584,174,0.174,90
42206,34586,7620,23414,67,58000,564,1000,0.564,621,0.621,185,0.185,90
42818,35031,7787,23969,68,59000,612,1000,0.612,555,0.555,167,0.167,90
43432,35486,7946,24514,69,60000,614,1000,0.614,545,0.545,159,0.159,90
44004,35869,8135,25131,70,61000,572,1000,0.572,617,0.617,189,0.189,90
44583,36270,8313,25730,71,62000,579,1000,0.579,599,0.599,178,0.178,90
45156,36679,8477,26321,72,63000,573,1000,0.573,591,0.591,164,0.164,90
45741,37103,8638,26897,73,64000,585,1000,0.585,576,0.576,161,0.161,90
46298,37491,8807,27509,74,65000,557,1000,0.557,612,0.612,169,0.169,90
46884,37919,8965,28081,75,66000,586,1000,0.586,572,0.572,158,0.158,90
47471,38341,9130,28659,76,67000,587,1000,0.587,578,0.578,165,0.165,90
48020,38699,9321,29301,77,68000,549,1000,0.549,642,0.642,191,0.191,90
48585,39067,9518,29933,78,69000,565,1000,0.565,632,0.632,197,0.197,90
49193,39533,9660,30467,79,70000,608,1000,0.608,534,0.534,142,0.142,90
49769,39949,9820,31051,80,71000,576,1000,0.576,584,0.584,160,0.16,90
50329,40340,9989,31660,81,72000,560,1000,0.56,609,0.609,169,0.169,90
50874,40703,10171,32297,82,73000,545,1000,0.545,637,0.637,182,0.182,90
51440,41098,10342,32902,83,74000,566,1000,0.566,605,0.605,171,0.171,90
51989,41453,10536,33547,84,75000,549,1000,0.549,645,0.645,194,0.194,90
52535,41833,10702,34167,85,76000,546,1000,0.546,620,0.62,166,0.166,90
53078,42189,10889,34811,86,77000,543,1000,0.543,644,0.644,187,0.187,90
53623,42576,11047,35424,87,78000,545,1000,0.545,613,0.613,158,0.158,90
54158,42953,11205,36047,88,79000,535,1000,0.535,623,0.623,158,0.158,90
54723,43357,11366,36643,89,80000,565,1000,0.565,596,0.596,161,0.161,90
55228,43682,11546,37318,90,81000,505,1000,0.505,675,0.675,180,0.18,90
55765,44055,11710,37945,91,82000,537,1000,0.537,627,0.627,164,0.164,90
56300,44402,11898,38598,92,83000,535,1000,0.535,653,0.653,188,0.188,90
56828,44762,12066,39238,93,84000,528,1000,0.528,640,0.64,168,0.168,90
57366,45135,12231,39865,94,85000,538,1000,0.538,627,0.627,165,0.165,90
57868,45457,12411,40543,95,86000,502,1000,0.502,678,0.678,180,0.18,90
58382,45797,12585,41203,96,87000,514,1000,0.514,660,0.66,174,0.174,90
58922,46187,12735,41813,97,88000,540,1000,0.54,610,0.61,150,0.15,90
59405,46506,12899,42494,98,89000,483,1000,0.483,681,0.681,164,0.164,90
59941,46864,13077,43136,99,90000,536,1000,0.536,642,0.642,178,0.178,90
60442,47193,13249,43807,100,91000,501,1000,0.501,671,0.671,172,0.172,90
60973,47560,13413,44440,101,92000,531,1000,0.531,633,0.633,164,0.164,90
61488,47902,13586,45098,102,93000,515,1000,0.515,658,0.658,173,0.173,90
61999,48255,13744,45745,103,94000,511,1000,0.511,647,0.647,158,0.158,90
62506,48601,13905,46399,104,95000,507,1000,0.507,654,0.654,161,0.161,90
63010,48960,14050,47040,105,96000,504,1000,0.504,641,0.641,145,0.145,90
63503,49275,14228,47725,106,97000,493,1000,0.493,685,0.685,178,0.178,90
64012,49604,14408,48396,107,98000,509,1000,0.509,671,0.671,180,0.18,90
64492,49931,14561,49069,108,99000,480,1000,0.48,673,0.673,153,0.153,90
64994,50256,14738,49744,109,100000,502,1000,0.502,675,0.675,177,0.177,90
65500,50586,14914,50414,110,101000,506,1000,0.506,670,0.67,176,0.176,90
66008,50905,15103,51095,111,102000,508,1000,0.508,681,0.681,189,0.189,90
66513,51250,15263,51750,112,103000,505,1000,0.505,655,0.655,160,0.16,90
67002,51562,15440,52438,113,104000,489,1000,0.489,688,0.688,177,0.177,90
67494,51885,15609,53115,114,105000,492,1000,0.492,677,0.677,169,0.169,90
67995,52205,15790,53795,115,106000,501,1000,0.501,680,0.68,181,0.181,90
68448,52484,15964,54516,116,107000,453,1000,0.453,721,0.721,174,0.174,90
68939,52810,16129,55190,117,108000,491,1000,0.491,674,0.674,165,0.165,90
69406,53091,16315,55909,118,109000,467,1000,0.467,719,0.719,186,0.186,90
69876,53384,16492,56616,119,110000,470,1000,0.47,707,0.707,177,0.177,90
70330,53641,16689,57359,120,111000,454,1000,0.454,743,0.743,197,0.197,90
70816,53954,16862,58046,121,112000,486,1000,0.486,687,0.687,173,0.173,90
71269,54240,17029,58760,122,113000,453,1000,0.453,714,0.714,167,0.167,90
71728,54548,17180,59452,123,114000,459,1000,0.459,692,0.692,151,0.151,90
71869,54638,17231,59660,124,114298,141,298,0.47315436241610737,208,0.697986577181208,51,0.17114093959731544,90
99,98,1,2,1,100,NA,NA,NA,NA,NA,NA,NA,91
199,198,1,2,2,200,100,100,1,0,0,0,0,91
298,296,2,4,3,300,99,100,0.99,2,0.02,1,0.01,91
395,390,5,10,4,400,97,100,0.97,6,0.06,3,0.03,91
493,486,7,14,5,500,98,100,0.98,4,0.04,2,0.02,91
589,579,10,21,6,600,96,100,0.96,7,0.07,3,0.03,91
688,677,11,23,7,700,99,100,0.99,2,0.02,1,0.01,91
783,768,15,32,8,800,95,100,0.95,9,0.09,4,0.04,91
881,864,17,36,9,900,98,100,0.98,4,0.04,2,0.02,91
978,958,20,42,10,1000,97,100,0.97,6,0.06,3,0.03,91
1929,1870,59,130,11,2000,951,1000,0.951,88,0.088,39,0.039,91
2864,2760,104,240,12,3000,935,1000,0.935,110,0.11,45,0.045,91
3766,3588,178,412,13,4000,902,1000,0.902,172,0.172,74,0.074,91
4663,4413,250,587,14,5000,897,1000,0.897,175,0.175,72,0.072,91
5548,5222,326,778,15,6000,885,1000,0.885,191,0.191,76,0.076,91
6418,6017,401,983,16,7000,870,1000,0.87,205,0.205,75,0.075,91
7266,6766,500,1234,17,8000,848,1000,0.848,251,0.251,99,0.099,91
8115,7520,595,1480,18,9000,849,1000,0.849,246,0.246,95,0.095,91
8952,8266,686,1734,19,10000,837,1000,0.837,254,0.254,91,0.091,91
9787,9012,775,1988,20,11000,835,1000,0.835,254,0.254,89,0.089,91
10604,9712,892,2288,21,12000,817,1000,0.817,300,0.3,117,0.117,91
11435,10447,988,2553,22,13000,831,1000,0.831,265,0.265,96,0.096,91
12237,11138,1099,2862,23,14000,802,1000,0.802,309,0.309,111,0.111,91
13022,11805,1217,3195,24,15000,785,1000,0.785,333,0.333,118,0.118,91
13819,12482,1337,3518,25,16000,797,1000,0.797,323,0.323,120,0.12,91
14603,13157,1446,3843,26,17000,784,1000,0.784,325,0.325,109,0.109,91
15345,13767,1578,4233,27,18000,742,1000,0.742,390,0.39,132,0.132,91
16091,14384,1707,4616,28,19000,746,1000,0.746,383,0.383,129,0.129,91
16842,14993,1849,5007,29,20000,751,1000,0.751,391,0.391,142,0.142,91
17586,15610,1976,5390,30,21000,744,1000,0.744,383,0.383,127,0.127,91
18316,16201,2115,5799,31,22000,730,1000,0.73,409,0.409,139,0.139,91
19046,16787,2259,6213,32,23000,730,1000,0.73,414,0.414,144,0.144,91
19745,17334,2411,6666,33,24000,699,1000,0.699,453,0.453,152,0.152,91
20461,17904,2557,7096,34,25000,716,1000,0.716,430,0.43,146,0.146,91
21191,18487,2704,7513,35,26000,730,1000,0.73,417,0.417,147,0.147,91
21929,19101,2828,7899,36,27000,738,1000,0.738,386,0.386,124,0.124,91
22624,19653,2971,8347,37,28000,695,1000,0.695,448,0.448,143,0.143,91
23329,20211,3118,8789,38,29000,705,1000,0.705,442,0.442,147,0.147,91
24039,20789,3250,9211,39,30000,710,1000,0.71,422,0.422,132,0.132,91
24751,21350,3401,9650,40,31000,712,1000,0.712,439,0.439,151,0.151,91
25446,21896,3550,10104,41,32000,695,1000,0.695,454,0.454,149,0.149,91
26137,22445,3692,10555,42,33000,691,1000,0.691,451,0.451,142,0.142,91
26819,22985,3834,11015,43,34000,682,1000,0.682,460,0.46,142,0.142,91
27513,23523,3990,11477,44,35000,694,1000,0.694,462,0.462,156,0.156,91
28181,24046,4135,11954,45,36000,668,1000,0.668,477,0.477,145,0.145,91
28855,24572,4283,12428,46,37000,674,1000,0.674,474,0.474,148,0.148,91
29495,25064,4431,12936,47,38000,640,1000,0.64,508,0.508,148,0.148,91
30175,25599,4576,13401,48,39000,680,1000,0.68,465,0.465,145,0.145,91
30853,26135,4718,13865,49,40000,678,1000,0.678,464,0.464,142,0.142,91
31485,26600,4885,14400,50,41000,632,1000,0.632,535,0.535,167,0.167,91
32156,27123,5033,14877,51,42000,671,1000,0.671,477,0.477,148,0.148,91
32789,27592,5197,15408,52,43000,633,1000,0.633,531,0.531,164,0.164,91
33430,28060,5370,15940,53,44000,641,1000,0.641,532,0.532,173,0.173,91
34054,28517,5537,16483,54,45000,624,1000,0.624,543,0.543,167,0.167,91
34689,29002,5687,16998,55,46000,635,1000,0.635,515,0.515,150,0.15,91
35354,29534,5820,17466,56,47000,665,1000,0.665,468,0.468,133,0.133,91
35989,30017,5972,17983,57,48000,635,1000,0.635,517,0.517,152,0.152,91
36612,30469,6143,18531,58,49000,623,1000,0.623,548,0.548,171,0.171,91
37260,30974,6286,19026,59,50000,648,1000,0.648,495,0.495,143,0.143,91
37891,31449,6442,19551,60,51000,631,1000,0.631,525,0.525,156,0.156,91
38480,31871,6609,20129,61,52000,589,1000,0.589,578,0.578,167,0.167,91
39088,32345,6743,20655,62,53000,608,1000,0.608,526,0.526,134,0.134,91
39667,32746,6921,21254,63,54000,579,1000,0.579,599,0.599,178,0.178,91
40286,33210,7076,21790,64,55000,619,1000,0.619,536,0.536,155,0.155,91
40881,33637,7244,22363,65,56000,595,1000,0.595,573,0.573,168,0.168,91
41469,34053,7416,22947,66,57000,588,1000,0.588,584,0.584,172,0.172,91
42044,34466,7578,23534,67,58000,575,1000,0.575,587,0.587,162,0.162,91
42601,34857,7744,24143,68,59000,557,1000,0.557,609,0.609,166,0.166,91
43196,35278,7918,24722,69,60000,595,1000,0.595,579,0.579,174,0.174,91
43786,35692,8094,25308,70,61000,590,1000,0.59,586,0.586,176,0.176,91
44370,36106,8264,25894,71,62000,584,1000,0.584,586,0.586,170,0.17,91
44951,36536,8415,26464,72,63000,581,1000,0.581,570,0.57,151,0.151,91
45525,36928,8597,27072,73,64000,574,1000,0.574,608,0.608,182,0.182,91
46092,37332,8760,27668,74,65000,567,1000,0.567,596,0.596,163,0.163,91
46676,37759,8917,28241,75,66000,584,1000,0.584,573,0.573,157,0.157,91
47243,38162,9081,28838,76,67000,567,1000,0.567,597,0.597,164,0.164,91
47779,38544,9235,29456,77,68000,536,1000,0.536,618,0.618,154,0.154,91
48343,38939,9404,30061,78,69000,564,1000,0.564,605,0.605,169,0.169,91
48892,39299,9593,30701,79,70000,549,1000,0.549,640,0.64,189,0.189,91
49444,39681,9763,31319,80,71000,552,1000,0.552,618,0.618,170,0.17,91
50006,40095,9911,31905,81,72000,562,1000,0.562,586,0.586,148,0.148,91
50571,40492,10079,32508,82,73000,565,1000,0.565,603,0.603,168,0.168,91
51151,40909,10242,33091,83,74000,580,1000,0.58,583,0.583,163,0.163,91
51708,41300,10408,33700,84,75000,557,1000,0.557,609,0.609,166,0.166,91
52270,41716,10554,34284,85,76000,562,1000,0.562,584,0.584,146,0.146,91
52833,42097,10736,34903,86,77000,563,1000,0.563,619,0.619,182,0.182,91
53391,42504,10887,35496,87,78000,558,1000,0.558,593,0.593,151,0.151,91
53941,42884,11057,36116,88,79000,550,1000,0.55,620,0.62,170,0.17,91
54484,43258,11226,36742,89,80000,543,1000,0.543,626,0.626,169,0.169,91
55016,43614,11402,37386,90,81000,532,1000,0.532,644,0.644,176,0.176,91
55536,43967,11569,38033,91,82000,520,1000,0.52,647,0.647,167,0.167,91
56089,44354,11735,38646,92,83000,553,1000,0.553,613,0.613,166,0.166,91
56632,44725,11907,39275,93,84000,543,1000,0.543,629,0.629,172,0.172,91
57170,45100,12070,39900,94,85000,538,1000,0.538,625,0.625,163,0.163,91
57694,45471,12223,40529,95,86000,524,1000,0.524,629,0.629,153,0.153,91
58225,45832,12393,41168,96,87000,531,1000,0.531,639,0.639,170,0.17,91
58752,46179,12573,41821,97,88000,527,1000,0.527,653,0.653,180,0.18,91
59289,46544,12745,42456,98,89000,537,1000,0.537,635,0.635,172,0.172,91
59839,46936,12903,43064,99,90000,550,1000,0.55,608,0.608,158,0.158,91
60363,47293,13070,43707,100,91000,524,1000,0.524,643,0.643,167,0.167,91
60861,47618,13243,44382,101,92000,498,1000,0.498,675,0.675,173,0.173,91
61372,47951,13421,45049,102,93000,511,1000,0.511,667,0.667,178,0.178,91
61881,48271,13610,45729,103,94000,509,1000,0.509,680,0.68,189,0.189,91
62392,48606,13786,46394,104,95000,511,1000,0.511,665,0.665,176,0.176,91
62889,48925,13964,47075,105,96000,497,1000,0.497,681,0.681,178,0.178,91
63399,49245,14154,47755,106,97000,510,1000,0.51,680,0.68,190,0.19,91
63908,49575,14333,48425,107,98000,509,1000,0.509,670,0.67,179,0.179,91
64406,49904,14502,49096,108,99000,498,1000,0.498,671,0.671,169,0.169,91
64923,50250,14673,49750,109,100000,517,1000,0.517,654,0.654,171,0.171,91
65420,50560,14860,50440,110,101000,497,1000,0.497,690,0.69,187,0.187,91
65900,50866,15034,51134,111,102000,480,1000,0.48,694,0.694,174,0.174,91
66389,51184,15205,51816,112,103000,489,1000,0.489,682,0.682,171,0.171,91
66857,51477,15380,52523,113,104000,468,1000,0.468,707,0.707,175,0.175,91
67349,51776,15573,53224,114,105000,492,1000,0.492,701,0.701,193,0.193,91
67825,52058,15767,53942,115,106000,476,1000,0.476,718,0.718,194,0.194,91
68306,52356,15950,54644,116,107000,481,1000,0.481,702,0.702,183,0.183,91
68790,52643,16147,55357,117,108000,484,1000,0.484,713,0.713,197,0.197,91
69275,52943,16332,56057,118,109000,485,1000,0.485,700,0.7,185,0.185,91
69761,53260,16501,56740,119,110000,486,1000,0.486,683,0.683,169,0.169,91
70261,53589,16672,57411,120,111000,500,1000,0.5,671,0.671,171,0.171,91
70743,53899,16844,58101,121,112000,482,1000,0.482,690,0.69,172,0.172,91
71227,54219,17008,58781,122,113000,484,1000,0.484,680,0.68,164,0.164,91
71723,54545,17178,59455,123,114000,496,1000,0.496,674,0.674,170,0.17,91
71869,54638,17231,59660,124,114298,146,298,0.4899328859060403,205,0.6879194630872483,53,0.17785234899328858,91
99,98,1,2,1,100,NA,NA,NA,NA,NA,NA,NA,92
199,198,1,2,2,200,100,100,1,0,0,0,0,92
297,294,3,6,3,300,98,100,0.98,4,0.04,2,0.02,92
394,388,6,12,4,400,97,100,0.97,6,0.06,3,0.03,92
494,488,6,12,5,500,100,100,1,0,0,0,0,92
593,586,7,14,6,600,99,100,0.99,2,0.02,1,0.01,92
693,686,7,14,7,700,100,100,1,0,0,0,0,92
791,782,9,18,8,800,98,100,0.98,4,0.04,2,0.02,92
890,880,10,20,9,900,99,100,0.99,2,0.02,1,0.01,92
989,978,11,22,10,1000,99,100,0.99,2,0.02,1,0.01,92
1951,1911,40,89,11,2000,962,1000,0.962,67,0.067,29,0.029,92
2880,2784,96,216,12,3000,929,1000,0.929,127,0.127,56,0.056,92
3793,3630,163,370,13,4000,913,1000,0.913,154,0.154,67,0.067,92
4700,4467,233,533,14,5000,907,1000,0.907,163,0.163,70,0.07,92
5585,5268,317,732,15,6000,885,1000,0.885,199,0.199,84,0.084,92
6457,6051,406,949,16,7000,872,1000,0.872,217,0.217,89,0.089,92
7314,6809,505,1191,17,8000,857,1000,0.857,242,0.242,99,0.099,92
8163,7567,596,1433,18,9000,849,1000,0.849,242,0.242,91,0.091,92
8998,8300,698,1700,19,10000,835,1000,0.835,267,0.267,102,0.102,92
9820,9024,796,1976,20,11000,822,1000,0.822,276,0.276,98,0.098,92
10632,9729,903,2271,21,12000,812,1000,0.812,295,0.295,107,0.107,92
11428,10406,1022,2594,22,13000,796,1000,0.796,323,0.323,119,0.119,92
12237,11109,1128,2891,23,14000,809,1000,0.809,297,0.297,106,0.106,92
13035,11783,1252,3217,24,15000,798,1000,0.798,326,0.326,124,0.124,92
13818,12436,1382,3564,25,16000,783,1000,0.783,347,0.347,130,0.13,92
14617,13122,1495,3878,26,17000,799,1000,0.799,314,0.314,113,0.113,92
15376,13739,1637,4261,27,18000,759,1000,0.759,383,0.383,142,0.142,92
16148,14377,1771,4623,28,19000,772,1000,0.772,362,0.362,134,0.134,92
16885,14994,1891,5006,29,20000,737,1000,0.737,383,0.383,120,0.12,92
17660,15662,1998,5338,30,21000,775,1000,0.775,332,0.332,107,0.107,92
18396,16250,2146,5750,31,22000,736,1000,0.736,412,0.412,148,0.148,92
19140,16862,2278,6138,32,23000,744,1000,0.744,388,0.388,132,0.132,92
19891,17488,2403,6512,33,24000,751,1000,0.751,374,0.374,125,0.125,92
20621,18070,2551,6930,34,25000,730,1000,0.73,418,0.418,148,0.148,92
21336,18648,2688,7352,35,26000,715,1000,0.715,422,0.422,137,0.137,92
22050,19220,2830,7780,36,27000,714,1000,0.714,428,0.428,142,0.142,92
22722,19737,2985,8263,37,28000,672,1000,0.672,483,0.483,155,0.155,92
23405,20278,3127,8722,38,29000,683,1000,0.683,459,0.459,142,0.142,92
24104,20841,3263,9159,39,30000,699,1000,0.699,437,0.437,136,0.136,92
24790,21375,3415,9625,40,31000,686,1000,0.686,466,0.466,152,0.152,92
25491,21926,3565,10074,41,32000,701,1000,0.701,449,0.449,150,0.15,92
26165,22457,3708,10543,42,33000,674,1000,0.674,469,0.469,143,0.143,92
26852,23001,3851,10999,43,34000,687,1000,0.687,456,0.456,143,0.143,92
27546,23560,3986,11440,44,35000,694,1000,0.694,441,0.441,135,0.135,92
28179,24023,4156,11977,45,36000,633,1000,0.633,537,0.537,170,0.17,92
28847,24526,4321,12474,46,37000,668,1000,0.668,497,0.497,165,0.165,92
29490,24997,4493,13003,47,38000,643,1000,0.643,529,0.529,172,0.172,92
30175,25536,4639,13464,48,39000,685,1000,0.685,461,0.461,146,0.146,92
30819,26020,4799,13980,49,40000,644,1000,0.644,516,0.516,160,0.16,92
31469,26510,4959,14490,50,41000,650,1000,0.65,510,0.51,160,0.16,92
32135,27032,5103,14968,51,42000,666,1000,0.666,478,0.478,144,0.144,92
32790,27529,5261,15471,52,43000,655,1000,0.655,503,0.503,158,0.158,92
33441,28027,5414,15973,53,44000,651,1000,0.651,502,0.502,153,0.153,92
34088,28527,5561,16473,54,45000,647,1000,0.647,500,0.5,147,0.147,92
34738,29021,5717,16979,55,46000,650,1000,0.65,506,0.506,156,0.156,92
35366,29476,5890,17524,56,47000,628,1000,0.628,545,0.545,173,0.173,92
35990,29928,6062,18072,57,48000,624,1000,0.624,548,0.548,172,0.172,92
36610,30388,6222,18612,58,49000,620,1000,0.62,540,0.54,160,0.16,92
37230,30832,6398,19168,59,50000,620,1000,0.62,556,0.556,176,0.176,92
37850,31297,6553,19703,60,51000,620,1000,0.62,535,0.535,155,0.155,92
38472,31751,6721,20249,61,52000,622,1000,0.622,546,0.546,168,0.168,92
39078,32186,6892,20814,62,53000,606,1000,0.606,565,0.565,171,0.171,92
39674,32611,7063,21389,63,54000,596,1000,0.596,575,0.575,171,0.171,92
40275,33055,7220,21945,64,55000,601,1000,0.601,556,0.556,157,0.157,92
40856,33477,7379,22523,65,56000,581,1000,0.581,578,0.578,159,0.159,92
41469,33941,7528,23059,66,57000,613,1000,0.613,536,0.536,149,0.149,92
42046,34351,7695,23649,67,58000,577,1000,0.577,590,0.59,167,0.167,92
42628,34738,7890,24262,68,59000,582,1000,0.582,613,0.613,195,0.195,92
43239,35192,8047,24808,69,60000,611,1000,0.611,546,0.546,157,0.157,92
43846,35635,8211,25365,70,61000,607,1000,0.607,557,0.557,164,0.164,92
44441,36063,8378,25937,71,62000,595,1000,0.595,572,0.572,167,0.167,92
45045,36504,8541,26496,72,63000,604,1000,0.604,559,0.559,163,0.163,92
45635,36939,8696,27061,73,64000,590,1000,0.59,565,0.565,155,0.155,92
46201,37350,8851,27650,74,65000,566,1000,0.566,589,0.589,155,0.155,92
46761,37748,9013,28252,75,66000,560,1000,0.56,602,0.602,162,0.162,92
47361,38208,9153,28792,76,67000,600,1000,0.6,540,0.54,140,0.14,92
47896,38559,9337,29441,77,68000,535,1000,0.535,649,0.649,184,0.184,92
48424,38916,9508,30084,78,69000,528,1000,0.528,643,0.643,171,0.171,92
48999,39320,9679,30680,79,70000,575,1000,0.575,596,0.596,171,0.171,92
49576,39744,9832,31256,80,71000,577,1000,0.577,576,0.576,153,0.153,92
50152,40156,9996,31844,81,72000,576,1000,0.576,588,0.588,164,0.164,92
50719,40549,10170,32451,82,73000,567,1000,0.567,607,0.607,174,0.174,92
51276,40952,10324,33048,83,74000,557,1000,0.557,597,0.597,154,0.154,92
51820,41336,10484,33664,84,75000,544,1000,0.544,616,0.616,160,0.16,92
52374,41717,10657,34283,85,76000,554,1000,0.554,619,0.619,173,0.173,92
52941,42134,10807,34866,86,77000,567,1000,0.567,583,0.583,150,0.15,92
53487,42509,10978,35491,87,78000,546,1000,0.546,625,0.625,171,0.171,92
54052,42924,11128,36076,88,79000,565,1000,0.565,585,0.585,150,0.15,92
54585,43294,11291,36706,89,80000,533,1000,0.533,630,0.63,163,0.163,92
55127,43640,11487,37360,90,81000,542,1000,0.542,654,0.654,196,0.196,92
55651,43978,11673,38022,91,82000,524,1000,0.524,662,0.662,186,0.186,92
56174,44359,11815,38641,92,83000,523,1000,0.523,619,0.619,142,0.142,92
56718,44721,11997,39279,93,84000,544,1000,0.544,638,0.638,182,0.182,92
57238,45071,12167,39929,94,85000,520,1000,0.52,650,0.65,170,0.17,92
57778,45430,12348,40570,95,86000,540,1000,0.54,641,0.641,181,0.181,92
58293,45787,12506,41213,96,87000,515,1000,0.515,643,0.643,158,0.158,92
58813,46125,12688,41875,97,88000,520,1000,0.52,662,0.662,182,0.182,92
59349,46502,12847,42498,98,89000,536,1000,0.536,623,0.623,159,0.159,92
59868,46853,13015,43147,99,90000,519,1000,0.519,649,0.649,168,0.168,92
60398,47215,13183,43785,100,91000,530,1000,0.53,638,0.638,168,0.168,92
60916,47563,13353,44437,101,92000,518,1000,0.518,652,0.652,170,0.17,92
61399,47874,13525,45126,102,93000,483,1000,0.483,689,0.689,172,0.172,92
61921,48223,13698,45777,103,94000,522,1000,0.522,651,0.651,173,0.173,92
62406,48547,13859,46453,104,95000,485,1000,0.485,676,0.676,161,0.161,92
62897,48873,14024,47127,105,96000,491,1000,0.491,674,0.674,165,0.165,92
63393,49204,14189,47796,106,97000,496,1000,0.496,669,0.669,165,0.165,92
63922,49551,14371,48449,107,98000,529,1000,0.529,653,0.653,182,0.182,92
64422,49869,14553,49131,108,99000,500,1000,0.5,682,0.682,182,0.182,92
64899,50165,14734,49835,109,100000,477,1000,0.477,704,0.704,181,0.181,92
65398,50475,14923,50525,110,101000,499,1000,0.499,690,0.69,189,0.189,92
65919,50821,15098,51179,111,102000,521,1000,0.521,654,0.654,175,0.175,92
66420,51153,15267,51847,112,103000,501,1000,0.501,668,0.668,169,0.169,92
66899,51440,15459,52560,113,104000,479,1000,0.479,713,0.713,192,0.192,92
67389,51769,15620,53231,114,105000,490,1000,0.49,671,0.671,161,0.161,92
67868,52072,15796,53928,115,106000,479,1000,0.479,697,0.697,176,0.176,92
68347,52373,15974,54627,116,107000,479,1000,0.479,699,0.699,178,0.178,92
68821,52671,16150,55329,117,108000,474,1000,0.474,702,0.702,176,0.176,92
69336,53024,16312,55976,118,109000,515,1000,0.515,647,0.647,162,0.162,92
69814,53333,16481,56667,119,110000,478,1000,0.478,691,0.691,169,0.169,92
70286,53618,16668,57382,120,111000,472,1000,0.472,715,0.715,187,0.187,92
70779,53943,16836,58057,121,112000,493,1000,0.493,675,0.675,168,0.168,92
71246,54237,17009,58763,122,113000,467,1000,0.467,706,0.706,173,0.173,92
71731,54549,17182,59451,123,114000,485,1000,0.485,688,0.688,173,0.173,92
71869,54638,17231,59660,124,114298,138,298,0.46308724832214765,209,0.7013422818791947,49,0.1644295302013423,92
100,100,0,0,1,100,NA,NA,NA,NA,NA,NA,NA,93
200,200,0,0,2,200,100,100,1,0,0,0,0,93
297,294,3,6,3,300,97,100,0.97,6,0.06,3,0.03,93
396,392,4,8,4,400,99,100,0.99,2,0.02,1,0.01,93
495,490,5,10,5,500,99,100,0.99,2,0.02,1,0.01,93
594,588,6,12,6,600,99,100,0.99,2,0.02,1,0.01,93
693,686,7,14,7,700,99,100,0.99,2,0.02,1,0.01,93
788,776,12,24,8,800,95,100,0.95,10,0.1,5,0.05,93
885,870,15,30,9,900,97,100,0.97,6,0.06,3,0.03,93
983,966,17,34,10,1000,98,100,0.98,4,0.04,2,0.02,93
1938,1886,52,114,11,2000,955,1000,0.955,80,0.08,35,0.035,93
2860,2755,105,245,12,3000,922,1000,0.922,131,0.131,53,0.053,93
3780,3618,162,382,13,4000,920,1000,0.92,137,0.137,57,0.057,93
4690,4466,224,534,14,5000,910,1000,0.91,152,0.152,62,0.062,93
5584,5292,292,708,15,6000,894,1000,0.894,174,0.174,68,0.068,93
6468,6103,365,897,16,7000,884,1000,0.884,189,0.189,73,0.073,93
7331,6874,457,1126,17,8000,863,1000,0.863,229,0.229,92,0.092,93
8192,7642,550,1358,18,9000,861,1000,0.861,232,0.232,93,0.093,93
9039,8403,636,1597,19,10000,847,1000,0.847,239,0.239,86,0.086,93
9870,9129,741,1871,20,11000,831,1000,0.831,274,0.274,105,0.105,93
10688,9834,854,2166,21,12000,818,1000,0.818,295,0.295,113,0.113,93
11467,10476,991,2524,22,13000,779,1000,0.779,358,0.358,137,0.137,93
12265,11172,1093,2828,23,14000,798,1000,0.798,304,0.304,102,0.102,93
13041,11833,1208,3167,24,15000,776,1000,0.776,339,0.339,115,0.115,93
13848,12530,1318,3470,25,16000,807,1000,0.807,303,0.303,110,0.11,93
14610,13168,1442,3832,26,17000,762,1000,0.762,362,0.362,124,0.124,93
15376,13800,1576,4200,27,18000,766,1000,0.766,368,0.368,134,0.134,93
16157,14468,1689,4532,28,19000,781,1000,0.781,332,0.332,113,0.113,93
16903,15084,1819,4916,29,20000,746,1000,0.746,384,0.384,130,0.13,93
17623,15655,1968,5345,30,21000,720,1000,0.72,429,0.429,149,0.149,93
18384,16296,2088,5704,31,22000,761,1000,0.761,359,0.359,120,0.12,93
19114,16890,2224,6110,32,23000,730,1000,0.73,406,0.406,136,0.136,93
19837,17457,2380,6543,33,24000,723,1000,0.723,433,0.433,156,0.156,93
20545,18017,2528,6983,34,25000,708,1000,0.708,440,0.44,148,0.148,93
21273,18622,2651,7378,35,26000,728,1000,0.728,395,0.395,123,0.123,93
21994,19200,2794,7800,36,27000,721,1000,0.721,422,0.422,143,0.143,93
22716,19794,2922,8206,37,28000,722,1000,0.722,406,0.406,128,0.128,93
23385,20284,3101,8716,38,29000,669,1000,0.669,510,0.51,179,0.179,93
24071,20829,3242,9171,39,30000,686,1000,0.686,455,0.455,141,0.141,93
24756,21371,3385,9629,40,31000,685,1000,0.685,458,0.458,143,0.143,93
25464,21942,3522,10058,41,32000,708,1000,0.708,429,0.429,137,0.137,93
26150,22459,3691,10541,42,33000,686,1000,0.686,483,0.483,169,0.169,93
26825,22962,3863,11038,43,34000,675,1000,0.675,497,0.497,172,0.172,93
27488,23469,4019,11531,44,35000,663,1000,0.663,493,0.493,156,0.156,93
28165,23994,4171,12006,45,36000,677,1000,0.677,475,0.475,152,0.152,93
28819,24497,4322,12503,46,37000,654,1000,0.654,497,0.497,151,0.151,93
29480,25010,4470,12990,47,38000,661,1000,0.661,487,0.487,148,0.148,93
30166,25573,4593,13427,48,39000,686,1000,0.686,437,0.437,123,0.123,93
30846,26110,4736,13890,49,40000,680,1000,0.68,463,0.463,143,0.143,93
31501,26603,4898,14397,50,41000,655,1000,0.655,507,0.507,162,0.162,93
32137,27060,5077,14940,51,42000,636,1000,0.636,543,0.543,179,0.179,93
32800,27573,5227,15427,52,43000,663,1000,0.663,487,0.487,150,0.15,93
33460,28074,5386,15926,53,44000,660,1000,0.66,499,0.499,159,0.159,93
34126,28598,5528,16402,54,45000,666,1000,0.666,476,0.476,142,0.142,93
34731,29020,5711,16980,55,46000,605,1000,0.605,578,0.578,183,0.183,93
35357,29474,5883,17526,56,47000,626,1000,0.626,546,0.546,172,0.172,93
35967,29925,6042,18075,57,48000,610,1000,0.61,549,0.549,159,0.159,93
36583,30367,6216,18633,58,49000,616,1000,0.616,558,0.558,174,0.174,93
37215,30840,6375,19160,59,50000,632,1000,0.632,527,0.527,159,0.159,93
37837,31306,6531,19694,60,51000,622,1000,0.622,534,0.534,156,0.156,93
38427,31743,6684,20257,61,52000,590,1000,0.59,563,0.563,153,0.153,93
39031,32167,6864,20833,62,53000,604,1000,0.604,576,0.576,180,0.18,93
39632,32600,7032,21400,63,54000,601,1000,0.601,567,0.567,168,0.168,93
40229,33038,7191,21962,64,55000,597,1000,0.597,562,0.562,159,0.159,93
40833,33480,7353,22520,65,56000,604,1000,0.604,558,0.558,162,0.162,93
41438,33917,7521,23083,66,57000,605,1000,0.605,563,0.563,168,0.168,93
42039,34368,7671,23632,67,58000,601,1000,0.601,549,0.549,150,0.15,93
42640,34783,7857,24217,68,59000,601,1000,0.601,585,0.585,186,0.186,93
43227,35205,8022,24795,69,60000,587,1000,0.587,578,0.578,165,0.165,93
43820,35648,8172,25352,70,61000,593,1000,0.593,557,0.557,150,0.15,93
44425,36081,8344,25919,71,62000,605,1000,0.605,567,0.567,172,0.172,93
45018,36514,8504,26486,72,63000,593,1000,0.593,567,0.567,160,0.16,93
45596,36921,8675,27079,73,64000,578,1000,0.578,593,0.593,171,0.171,93
46181,37340,8841,27660,74,65000,585,1000,0.585,581,0.581,166,0.166,93
46749,37737,9012,28263,75,66000,568,1000,0.568,603,0.603,171,0.171,93
47319,38136,9183,28864,76,67000,570,1000,0.57,601,0.601,171,0.171,93
47882,38534,9348,29466,77,68000,563,1000,0.563,602,0.602,165,0.165,93
48412,38875,9537,30125,78,69000,530,1000,0.53,659,0.659,189,0.189,93
48959,39253,9706,30747,79,70000,547,1000,0.547,622,0.622,169,0.169,93
49536,39675,9861,31325,80,71000,577,1000,0.577,578,0.578,155,0.155,93
50097,40057,10040,31943,81,72000,561,1000,0.561,618,0.618,179,0.179,93
50622,40403,10219,32597,82,73000,525,1000,0.525,654,0.654,179,0.179,93
51152,40755,10397,33245,83,74000,530,1000,0.53,648,0.648,178,0.178,93
51695,41135,10560,33865,84,75000,543,1000,0.543,620,0.62,163,0.163,93
52244,41514,10730,34486,85,76000,549,1000,0.549,621,0.621,170,0.17,93
52782,41884,10898,35116,86,77000,538,1000,0.538,630,0.63,168,0.168,93
53309,42241,11068,35759,87,78000,527,1000,0.527,643,0.643,170,0.17,93
53884,42642,11242,36358,88,79000,575,1000,0.575,599,0.599,174,0.174,93
54431,43016,11415,36984,89,80000,547,1000,0.547,626,0.626,173,0.173,93
54957,43376,11581,37624,90,81000,526,1000,0.526,640,0.64,166,0.166,93
55507,43766,11741,38234,91,82000,550,1000,0.55,610,0.61,160,0.16,93
56044,44125,11919,38875,92,83000,537,1000,0.537,641,0.641,178,0.178,93
56607,44530,12077,39470,93,84000,563,1000,0.563,595,0.595,158,0.158,93
57136,44899,12237,40101,94,85000,529,1000,0.529,631,0.631,160,0.16,93
57670,45258,12412,40742,95,86000,534,1000,0.534,641,0.641,175,0.175,93
58190,45603,12587,41397,96,87000,520,1000,0.52,655,0.655,175,0.175,93
58709,45938,12771,42062,97,88000,519,1000,0.519,665,0.665,184,0.184,93
59256,46327,12929,42673,98,89000,547,1000,0.547,611,0.611,158,0.158,93
59748,46638,13110,43362,99,90000,492,1000,0.492,689,0.689,181,0.181,93
60282,47006,13276,43994,100,91000,534,1000,0.534,632,0.632,166,0.166,93
60810,47379,13431,44621,101,92000,528,1000,0.528,627,0.627,155,0.155,93
61329,47741,13588,45259,102,93000,519,1000,0.519,638,0.638,157,0.157,93
61834,48090,13744,45910,103,94000,505,1000,0.505,651,0.651,156,0.156,93
62347,48424,13923,46576,104,95000,513,1000,0.513,666,0.666,179,0.179,93
62861,48764,14097,47236,105,96000,514,1000,0.514,660,0.66,174,0.174,93
63361,49085,14276,47915,106,97000,500,1000,0.5,679,0.679,179,0.179,93
63885,49445,14440,48555,107,98000,524,1000,0.524,640,0.64,164,0.164,93
64393,49782,14611,49218,108,99000,508,1000,0.508,663,0.663,171,0.171,93
64902,50125,14777,49875,109,100000,509,1000,0.509,657,0.657,166,0.166,93
65400,50462,14938,50538,110,101000,498,1000,0.498,663,0.663,161,0.161,93
65889,50795,15094,51205,111,102000,489,1000,0.489,667,0.667,156,0.156,93
66381,51107,15274,51893,112,103000,492,1000,0.492,688,0.688,180,0.18,93
66888,51434,15454,52566,113,104000,507,1000,0.507,673,0.673,180,0.18,93
67393,51781,15612,53219,114,105000,505,1000,0.505,653,0.653,158,0.158,93
67888,52111,15777,53889,115,106000,495,1000,0.495,670,0.67,165,0.165,93
68383,52430,15953,54570,116,107000,495,1000,0.495,681,0.681,176,0.176,93
68877,52757,16120,55243,117,108000,494,1000,0.494,673,0.673,167,0.167,93
69377,53079,16298,55921,118,109000,500,1000,0.5,678,0.678,178,0.178,93
69853,53381,16472,56619,119,110000,476,1000,0.476,698,0.698,174,0.174,93
70315,53646,16669,57354,120,111000,462,1000,0.462,735,0.735,197,0.197,93
70787,53955,16832,58045,121,112000,472,1000,0.472,691,0.691,163,0.163,93
71254,54250,17004,58750,122,113000,467,1000,0.467,705,0.705,172,0.172,93
71720,54532,17188,59468,123,114000,466,1000,0.466,718,0.718,184,0.184,93
71869,54638,17231,59660,124,114298,149,298,0.5,192,0.6442953020134228,43,0.14429530201342283,93
99,98,1,2,1,100,NA,NA,NA,NA,NA,NA,NA,94
198,196,2,4,2,200,99,100,0.99,2,0.02,1,0.01,94
296,292,4,8,3,300,98,100,0.98,4,0.04,2,0.02,94
396,392,4,8,4,400,100,100,1,0,0,0,0,94
495,490,5,10,5,500,99,100,0.99,2,0.02,1,0.01,94
593,586,7,14,6,600,98,100,0.98,4,0.04,2,0.02,94
691,682,9,18,7,700,98,100,0.98,4,0.04,2,0.02,94
791,782,9,18,8,800,100,100,1,0,0,0,0,94
889,878,11,22,9,900,98,100,0.98,4,0.04,2,0.02,94
984,968,16,32,10,1000,95,100,0.95,10,0.1,5,0.05,94
1940,1893,47,107,11,2000,956,1000,0.956,75,0.075,31,0.031,94
2873,2775,98,225,12,3000,933,1000,0.933,118,0.118,51,0.051,94
3770,3605,165,395,13,4000,897,1000,0.897,170,0.17,67,0.067,94
4681,4461,220,539,14,5000,911,1000,0.911,144,0.144,55,0.055,94
5559,5266,293,734,15,6000,878,1000,0.878,195,0.195,73,0.073,94
6421,6038,383,962,16,7000,862,1000,0.862,228,0.228,90,0.09,94
7301,6838,463,1162,17,8000,880,1000,0.88,200,0.2,80,0.08,94
8145,7589,556,1411,18,9000,844,1000,0.844,249,0.249,93,0.093,94
8959,8290,669,1710,19,10000,814,1000,0.814,299,0.299,113,0.113,94
9789,9031,758,1969,20,11000,830,1000,0.83,259,0.259,89,0.089,94
10621,9757,864,2243,21,12000,832,1000,0.832,274,0.274,106,0.106,94
11443,10476,967,2524,22,13000,822,1000,0.822,281,0.281,103,0.103,94
12252,11177,1075,2823,23,14000,809,1000,0.809,299,0.299,108,0.108,94
13076,11902,1174,3098,24,15000,824,1000,0.824,275,0.275,99,0.099,94
13864,12572,1292,3428,25,16000,788,1000,0.788,330,0.33,118,0.118,94
14620,13188,1432,3812,26,17000,756,1000,0.756,384,0.384,140,0.14,94
15400,13841,1559,4159,27,18000,780,1000,0.78,347,0.347,127,0.127,94
16159,14464,1695,4536,28,19000,759,1000,0.759,377,0.377,136,0.136,94
16912,15088,1824,4912,29,20000,753,1000,0.753,376,0.376,129,0.129,94
17648,15684,1964,5316,30,21000,736,1000,0.736,404,0.404,140,0.14,94
18398,16298,2100,5702,31,22000,750,1000,0.75,386,0.386,136,0.136,94
19113,16872,2241,6128,32,23000,715,1000,0.715,426,0.426,141,0.141,94
19843,17463,2380,6537,33,24000,730,1000,0.73,409,0.409,139,0.139,94
20542,18007,2535,6993,34,25000,699,1000,0.699,456,0.456,155,0.155,94
21263,18582,2681,7418,35,26000,721,1000,0.721,425,0.425,146,0.146,94
21966,19136,2830,7864,36,27000,703,1000,0.703,446,0.446,149,0.149,94
22693,19730,2963,8270,37,28000,727,1000,0.727,406,0.406,133,0.133,94
23420,20316,3104,8684,38,29000,727,1000,0.727,414,0.414,141,0.141,94
24130,20884,3246,9116,39,30000,710,1000,0.71,432,0.432,142,0.142,94
24823,21431,3392,9569,40,31000,693,1000,0.693,453,0.453,146,0.146,94
25516,21974,3542,10026,41,32000,693,1000,0.693,457,0.457,150,0.15,94
26219,22540,3679,10460,42,33000,703,1000,0.703,434,0.434,137,0.137,94
26912,23084,3828,10916,43,34000,693,1000,0.693,456,0.456,149,0.149,94
27576,23581,3995,11419,44,35000,664,1000,0.664,503,0.503,167,0.167,94
28252,24088,4164,11912,45,36000,676,1000,0.676,493,0.493,169,0.169,94
28903,24574,4329,12426,46,37000,651,1000,0.651,514,0.514,165,0.165,94
29576,25096,4480,12904,47,38000,673,1000,0.673,478,0.478,151,0.151,94
30227,25586,4641,13414,48,39000,651,1000,0.651,510,0.51,161,0.161,94
30890,26093,4797,13907,49,40000,663,1000,0.663,493,0.493,156,0.156,94
31542,26578,4964,14422,50,41000,652,1000,0.652,515,0.515,167,0.167,94
32188,27068,5120,14932,51,42000,646,1000,0.646,510,0.51,156,0.156,94
32824,27562,5262,15438,52,43000,636,1000,0.636,506,0.506,142,0.142,94
33446,28027,5419,15973,53,44000,622,1000,0.622,535,0.535,157,0.157,94
34073,28500,5573,16500,54,45000,627,1000,0.627,527,0.527,154,0.154,94
34704,28964,5740,17036,55,46000,631,1000,0.631,536,0.536,167,0.167,94
35316,29414,5902,17586,56,47000,612,1000,0.612,550,0.55,162,0.162,94
35977,29927,6050,18073,57,48000,661,1000,0.661,487,0.487,148,0.148,94
36576,30374,6202,18626,58,49000,599,1000,0.599,553,0.553,152,0.152,94
37146,30761,6385,19239,59,50000,570,1000,0.57,613,0.613,183,0.183,94
37768,31216,6552,19784,60,51000,622,1000,0.622,545,0.545,167,0.167,94
38362,31631,6731,20369,61,52000,594,1000,0.594,585,0.585,179,0.179,94
38996,32116,6880,20884,62,53000,634,1000,0.634,515,0.515,149,0.149,94
39635,32608,7027,21392,63,54000,639,1000,0.639,508,0.508,147,0.147,94
40245,33046,7199,21954,64,55000,610,1000,0.61,562,0.562,172,0.172,94
40859,33500,7359,22500,65,56000,614,1000,0.614,546,0.546,160,0.16,94
41439,33900,7539,23100,66,57000,580,1000,0.58,600,0.6,180,0.18,94
42031,34326,7705,23674,67,58000,592,1000,0.592,574,0.574,166,0.166,94
42637,34772,7865,24228,68,59000,606,1000,0.606,554,0.554,160,0.16,94
43223,35209,8014,24791,69,60000,586,1000,0.586,563,0.563,149,0.149,94
43799,35627,8172,25373,70,61000,576,1000,0.576,582,0.582,158,0.158,94
44382,36063,8319,25937,71,62000,583,1000,0.583,564,0.564,147,0.147,94
44980,36490,8490,26510,72,63000,598,1000,0.598,573,0.573,171,0.171,94
45532,36868,8664,27132,73,64000,552,1000,0.552,622,0.622,174,0.174,94
46124,37308,8816,27692,74,65000,592,1000,0.592,560,0.56,152,0.152,94
46706,37729,8977,28271,75,66000,582,1000,0.582,579,0.579,161,0.161,94
47320,38200,9120,28800,76,67000,614,1000,0.614,529,0.529,143,0.143,94
47907,38641,9266,29359,77,68000,587,1000,0.587,559,0.559,146,0.146,94
48476,39041,9435,29959,78,69000,569,1000,0.569,600,0.6,169,0.169,94
49038,39422,9616,30578,79,70000,562,1000,0.562,619,0.619,181,0.181,94
49594,39818,9776,31182,80,71000,556,1000,0.556,604,0.604,160,0.16,94
50144,40194,9950,31806,81,72000,550,1000,0.55,624,0.624,174,0.174,94
50673,40537,10136,32463,82,73000,529,1000,0.529,657,0.657,186,0.186,94
51229,40938,10291,33062,83,74000,556,1000,0.556,599,0.599,155,0.155,94
51784,41329,10455,33671,84,75000,555,1000,0.555,609,0.609,164,0.164,94
52316,41699,10617,34301,85,76000,532,1000,0.532,630,0.63,162,0.162,94
52886,42106,10780,34894,86,77000,570,1000,0.57,593,0.593,163,0.163,94
53422,42474,10948,35526,87,78000,536,1000,0.536,632,0.632,168,0.168,94
53978,42878,11100,36122,88,79000,556,1000,0.556,596,0.596,152,0.152,94
54495,43214,11281,36786,89,80000,517,1000,0.517,664,0.664,181,0.181,94
55059,43598,11461,37402,90,81000,564,1000,0.564,616,0.616,180,0.18,94
55556,43918,11638,38082,91,82000,497,1000,0.497,680,0.68,177,0.177,94
56077,44246,11831,38754,92,83000,521,1000,0.521,672,0.672,193,0.193,94
56611,44600,12011,39400,93,84000,534,1000,0.534,646,0.646,180,0.18,94
57143,44977,12166,40023,94,85000,532,1000,0.532,623,0.623,155,0.155,94
57673,45329,12344,40671,95,86000,530,1000,0.53,648,0.648,178,0.178,94
58184,45675,12509,41325,96,87000,511,1000,0.511,654,0.654,165,0.165,94
58700,46011,12689,41989,97,88000,516,1000,0.516,664,0.664,180,0.18,94
59190,46309,12881,42691,98,89000,490,1000,0.49,702,0.702,192,0.192,94
59723,46661,13062,43339,99,90000,533,1000,0.533,648,0.648,181,0.181,94
60251,47020,13231,43980,100,91000,528,1000,0.528,641,0.641,169,0.169,94
60745,47343,13402,44657,101,92000,494,1000,0.494,677,0.677,171,0.171,94
61288,47731,13557,45269,102,93000,543,1000,0.543,612,0.612,155,0.155,94
61794,48070,13724,45930,103,94000,506,1000,0.506,661,0.661,167,0.167,94
62278,48354,13924,46646,104,95000,484,1000,0.484,716,0.716,200,0.2,94
62807,48705,14102,47295,105,96000,529,1000,0.529,649,0.649,178,0.178,94
63332,49070,14262,47930,106,97000,525,1000,0.525,635,0.635,160,0.16,94
63867,49430,14437,48570,107,98000,535,1000,0.535,640,0.64,175,0.175,94
64384,49765,14619,49235,108,99000,517,1000,0.517,665,0.665,182,0.182,94
64894,50107,14787,49893,109,100000,510,1000,0.51,658,0.658,168,0.168,94
65370,50404,14966,50596,110,101000,476,1000,0.476,703,0.703,179,0.179,94
65901,50788,15113,51212,111,102000,531,1000,0.531,616,0.616,147,0.147,94
66385,51096,15289,51904,112,103000,484,1000,0.484,692,0.692,176,0.176,94
66847,51364,15483,52636,113,104000,462,1000,0.462,732,0.732,194,0.194,94
67315,51656,15659,53344,114,105000,468,1000,0.468,708,0.708,176,0.176,94
67832,52010,15822,53990,115,106000,517,1000,0.517,646,0.646,163,0.163,94
68319,52324,15995,54676,116,107000,487,1000,0.487,686,0.686,173,0.173,94
68793,52614,16179,55386,117,108000,474,1000,0.474,710,0.71,184,0.184,94
69288,52943,16345,56057,118,109000,495,1000,0.495,671,0.671,166,0.166,94
69796,53290,16506,56710,119,110000,508,1000,0.508,653,0.653,161,0.161,94
70287,53628,16659,57372,120,111000,491,1000,0.491,662,0.662,153,0.153,94
70781,53946,16835,58054,121,112000,494,1000,0.494,682,0.682,176,0.176,94
71262,54268,16994,58732,122,113000,481,1000,0.481,678,0.678,159,0.159,94
71741,54564,17177,59436,123,114000,479,1000,0.479,704,0.704,183,0.183,94
71869,54638,17231,59660,124,114298,128,298,0.42953020134228187,224,0.7516778523489933,54,0.18120805369127516,94
100,100,0,0,1,100,NA,NA,NA,NA,NA,NA,NA,95
200,200,0,0,2,200,100,100,1,0,0,0,0,95
300,300,0,0,3,300,100,100,1,0,0,0,0,95
395,390,5,10,4,400,95,100,0.95,10,0.1,5,0.05,95
492,484,8,16,5,500,97,100,0.97,6,0.06,3,0.03,95
589,579,10,21,6,600,97,100,0.97,5,0.05,2,0.02,95
686,673,13,27,7,700,97,100,0.97,6,0.06,3,0.03,95
781,764,17,36,8,800,95,100,0.95,9,0.09,4,0.04,95
881,864,17,36,9,900,100,100,1,0,0,0,0,95
977,957,20,43,10,1000,96,100,0.96,7,0.07,3,0.03,95
1932,1878,54,122,11,2000,955,1000,0.955,79,0.079,34,0.034,95
2888,2802,86,198,12,3000,956,1000,0.956,76,0.076,32,0.032,95
3790,3636,154,364,13,4000,902,1000,0.902,166,0.166,68,0.068,95
4676,4437,239,563,14,5000,886,1000,0.886,199,0.199,85,0.085,95
5588,5291,297,709,15,6000,912,1000,0.912,146,0.146,58,0.058,95
6458,6074,384,926,16,7000,870,1000,0.87,217,0.217,87,0.087,95
7325,6854,471,1146,17,8000,867,1000,0.867,220,0.22,87,0.087,95
8186,7622,564,1378,18,9000,861,1000,0.861,232,0.232,93,0.093,95
9026,8366,660,1634,19,10000,840,1000,0.84,256,0.256,96,0.096,95
9858,9108,750,1892,20,11000,832,1000,0.832,258,0.258,90,0.09,95
10647,9774,873,2226,21,12000,789,1000,0.789,334,0.334,123,0.123,95
11481,10509,972,2491,22,13000,834,1000,0.834,265,0.265,99,0.099,95
12284,11206,1078,2794,23,14000,803,1000,0.803,303,0.303,106,0.106,95
13091,11906,1185,3094,24,15000,807,1000,0.807,300,0.3,107,0.107,95
13867,12557,1310,3443,25,16000,776,1000,0.776,349,0.349,125,0.125,95
14639,13201,1438,3799,26,17000,772,1000,0.772,356,0.356,128,0.128,95
15398,13827,1571,4173,27,18000,759,1000,0.759,374,0.374,133,0.133,95
16168,14478,1690,4522,28,19000,770,1000,0.77,349,0.349,119,0.119,95
16933,15120,1813,4880,29,20000,765,1000,0.765,358,0.358,123,0.123,95
17704,15761,1943,5239,30,21000,771,1000,0.771,359,0.359,130,0.13,95
18449,16364,2085,5636,31,22000,745,1000,0.745,397,0.397,142,0.142,95
19199,16977,2222,6023,32,23000,750,1000,0.75,387,0.387,137,0.137,95
19917,17546,2371,6454,33,24000,718,1000,0.718,431,0.431,149,0.149,95
20632,18110,2522,6890,34,25000,715,1000,0.715,436,0.436,151,0.151,95
21316,18623,2693,7377,35,26000,684,1000,0.684,487,0.487,171,0.171,95
22015,19157,2858,7843,36,27000,699,1000,0.699,466,0.466,165,0.165,95
22703,19694,3009,8306,37,28000,688,1000,0.688,463,0.463,151,0.151,95
23406,20243,3163,8757,38,29000,703,1000,0.703,451,0.451,154,0.154,95
24111,20796,3315,9204,39,30000,705,1000,0.705,447,0.447,152,0.152,95
24821,21378,3443,9622,40,31000,710,1000,0.71,418,0.418,128,0.128,95
25516,21931,3585,10069,41,32000,695,1000,0.695,447,0.447,142,0.142,95
26167,22431,3736,10569,42,33000,651,1000,0.651,500,0.5,151,0.151,95
26846,22943,3903,11057,43,34000,679,1000,0.679,488,0.488,167,0.167,95
27533,23490,4043,11510,44,35000,687,1000,0.687,453,0.453,140,0.14,95
28216,24024,4192,11976,45,36000,683,1000,0.683,466,0.466,149,0.149,95
28885,24543,4342,12457,46,37000,669,1000,0.669,481,0.481,150,0.15,95
29543,25045,4498,12955,47,38000,658,1000,0.658,498,0.498,156,0.156,95
30201,25547,4654,13453,48,39000,658,1000,0.658,498,0.498,156,0.156,95
30847,26023,4824,13977,49,40000,646,1000,0.646,524,0.524,170,0.17,95
31493,26525,4968,14475,50,41000,646,1000,0.646,498,0.498,144,0.144,95
32150,27029,5121,14971,51,42000,657,1000,0.657,496,0.496,153,0.153,95
32776,27484,5292,15516,52,43000,626,1000,0.626,545,0.545,171,0.171,95
33394,27941,5453,16059,53,44000,618,1000,0.618,543,0.543,161,0.161,95
34037,28414,5623,16586,54,45000,643,1000,0.643,527,0.527,170,0.17,95
34662,28877,5785,17123,55,46000,625,1000,0.625,537,0.537,162,0.162,95
35325,29393,5932,17607,56,47000,663,1000,0.663,484,0.484,147,0.147,95
35971,29899,6072,18101,57,48000,646,1000,0.646,494,0.494,140,0.14,95
36589,30341,6248,18659,58,49000,618,1000,0.618,558,0.558,176,0.176,95
37200,30788,6412,19212,59,50000,611,1000,0.611,553,0.553,164,0.164,95
37831,31265,6566,19735,60,51000,631,1000,0.631,523,0.523,154,0.154,95
38449,31726,6723,20274,61,52000,618,1000,0.618,539,0.539,157,0.157,95
39065,32168,6897,20832,62,53000,616,1000,0.616,558,0.558,174,0.174,95
39670,32620,7050,21380,63,54000,605,1000,0.605,548,0.548,153,0.153,95
40262,33053,7209,21947,64,55000,592,1000,0.592,567,0.567,159,0.159,95
40877,33526,7351,22474,65,56000,615,1000,0.615,527,0.527,142,0.142,95
41514,33999,7515,23001,66,57000,637,1000,0.637,527,0.527,164,0.164,95
42095,34430,7665,23570,67,58000,581,1000,0.581,569,0.569,150,0.15,95
42697,34874,7823,24126,68,59000,602,1000,0.602,556,0.556,158,0.158,95
43273,35272,8001,24728,69,60000,576,1000,0.576,602,0.602,178,0.178,95
43865,35700,8165,25300,70,61000,592,1000,0.592,572,0.572,164,0.164,95
44434,36100,8334,25900,71,62000,569,1000,0.569,600,0.6,169,0.169,95
45019,36526,8493,26474,72,63000,585,1000,0.585,574,0.574,159,0.159,95
45589,36939,8650,27061,73,64000,570,1000,0.57,587,0.587,157,0.157,95
46181,37354,8827,27646,74,65000,592,1000,0.592,585,0.585,177,0.177,95
46764,37764,9000,28236,75,66000,583,1000,0.583,590,0.59,173,0.173,95
47350,38204,9146,28796,76,67000,586,1000,0.586,560,0.56,146,0.146,95
47917,38612,9305,29388,77,68000,567,1000,0.567,592,0.592,159,0.159,95
48489,39017,9472,29983,78,69000,572,1000,0.572,595,0.595,167,0.167,95
49065,39424,9641,30576,79,70000,576,1000,0.576,593,0.593,169,0.169,95
49614,39790,9824,31210,80,71000,549,1000,0.549,634,0.634,183,0.183,95
50156,40151,10005,31849,81,72000,542,1000,0.542,639,0.639,181,0.181,95
50695,40510,10185,32490,82,73000,539,1000,0.539,641,0.641,180,0.18,95
51259,40909,10350,33091,83,74000,564,1000,0.564,601,0.601,165,0.165,95
51797,41274,10523,33726,84,75000,538,1000,0.538,635,0.635,173,0.173,95
52350,41659,10691,34341,85,76000,553,1000,0.553,615,0.615,168,0.168,95
52894,42040,10854,34960,86,77000,544,1000,0.544,619,0.619,163,0.163,95
53417,42388,11029,35612,87,78000,523,1000,0.523,652,0.652,175,0.175,95
53975,42805,11170,36195,88,79000,558,1000,0.558,583,0.583,141,0.141,95
54527,43181,11346,36819,89,80000,552,1000,0.552,624,0.624,176,0.176,95
55094,43594,11500,37406,90,81000,567,1000,0.567,587,0.587,154,0.154,95
55635,43980,11655,38020,91,82000,541,1000,0.541,614,0.614,155,0.155,95
56159,44327,11832,38673,92,83000,524,1000,0.524,653,0.653,177,0.177,95
56688,44699,11989,39301,93,84000,529,1000,0.529,628,0.628,157,0.157,95
57222,45059,12163,39941,94,85000,534,1000,0.534,640,0.64,174,0.174,95
57711,45362,12349,40638,95,86000,489,1000,0.489,697,0.697,186,0.186,95
58247,45737,12510,41263,96,87000,536,1000,0.536,625,0.625,161,0.161,95
58815,46150,12665,41850,97,88000,568,1000,0.568,587,0.587,155,0.155,95
59341,46509,12832,42491,98,89000,526,1000,0.526,641,0.641,167,0.167,95
59846,46840,13006,43160,99,90000,505,1000,0.505,669,0.669,174,0.174,95
60355,47184,13171,43816,100,91000,509,1000,0.509,656,0.656,165,0.165,95
60875,47551,13324,44449,101,92000,520,1000,0.52,633,0.633,153,0.153,95
61400,47917,13483,45083,102,93000,525,1000,0.525,634,0.634,159,0.159,95
61886,48224,13662,45776,103,94000,486,1000,0.486,693,0.693,179,0.179,95
62404,48579,13825,46421,104,95000,518,1000,0.518,645,0.645,163,0.163,95
62912,48934,13978,47066,105,96000,508,1000,0.508,645,0.645,153,0.153,95
63418,49262,14156,47738,106,97000,506,1000,0.506,672,0.672,178,0.178,95
63920,49593,14327,48407,107,98000,502,1000,0.502,669,0.669,171,0.171,95
64450,49958,14492,49042,108,99000,530,1000,0.53,635,0.635,165,0.165,95
64921,50243,14678,49757,109,100000,471,1000,0.471,715,0.715,186,0.186,95
65421,50545,14876,50455,110,101000,500,1000,0.5,698,0.698,198,0.198,95
65938,50907,15031,51093,111,102000,517,1000,0.517,638,0.638,155,0.155,95
66450,51250,15200,51750,112,103000,512,1000,0.512,657,0.657,169,0.169,95
66961,51576,15385,52424,113,104000,511,1000,0.511,674,0.674,185,0.185,95
67418,51857,15561,53143,114,105000,457,1000,0.457,719,0.719,176,0.176,95
67914,52181,15733,53819,115,106000,496,1000,0.496,676,0.676,172,0.172,95
68384,52453,15931,54547,116,107000,470,1000,0.47,728,0.728,198,0.198,95
68829,52715,16114,55285,117,108000,445,1000,0.445,738,0.738,183,0.183,95
69312,53034,16278,55966,118,109000,483,1000,0.483,681,0.681,164,0.164,95
69814,53370,16444,56630,119,110000,502,1000,0.502,664,0.664,166,0.166,95
70291,53653,16638,57347,120,111000,477,1000,0.477,717,0.717,194,0.194,95
70790,53981,16809,58019,121,112000,499,1000,0.499,672,0.672,171,0.171,95
71251,54248,17003,58752,122,113000,461,1000,0.461,733,0.733,194,0.194,95
71726,54549,17177,59451,123,114000,475,1000,0.475,699,0.699,174,0.174,95
71869,54638,17231,59660,124,114298,143,298,0.4798657718120805,209,0.7013422818791947,54,0.18120805369127516,95
100,100,0,0,1,100,NA,NA,NA,NA,NA,NA,NA,96
200,200,0,0,2,200,100,100,1,0,0,0,0,96
300,300,0,0,3,300,100,100,1,0,0,0,0,96
398,396,2,4,4,400,98,100,0.98,4,0.04,2,0.02,96
497,494,3,6,5,500,99,100,0.99,2,0.02,1,0.01,96
593,587,6,13,6,600,96,100,0.96,7,0.07,3,0.03,96
691,683,8,17,7,700,98,100,0.98,4,0.04,2,0.02,96
788,778,10,22,8,800,97,100,0.97,5,0.05,2,0.02,96
884,870,14,30,9,900,96,100,0.96,8,0.08,4,0.04,96
984,970,14,30,10,1000,100,100,1,0,0,0,0,96
1934,1880,54,120,11,2000,950,1000,0.95,90,0.09,40,0.04,96
2869,2767,102,233,12,3000,935,1000,0.935,113,0.113,48,0.048,96
3800,3655,145,345,13,4000,931,1000,0.931,112,0.112,43,0.043,96
4718,4525,193,475,14,5000,918,1000,0.918,130,0.13,48,0.048,96
5623,5366,257,634,15,6000,905,1000,0.905,159,0.159,64,0.064,96
6500,6165,335,835,16,7000,877,1000,0.877,201,0.201,78,0.078,96
7368,6944,424,1056,17,8000,868,1000,0.868,221,0.221,89,0.089,96
8233,7721,512,1279,18,9000,865,1000,0.865,223,0.223,88,0.088,96
9058,8433,625,1567,19,10000,825,1000,0.825,288,0.288,113,0.113,96
9898,9174,724,1826,20,11000,840,1000,0.84,259,0.259,99,0.099,96
10702,9873,829,2127,21,12000,804,1000,0.804,301,0.301,105,0.105,96
11520,10590,930,2410,22,13000,818,1000,0.818,283,0.283,101,0.101,96
12301,11249,1052,2751,23,14000,781,1000,0.781,341,0.341,122,0.122,96
13105,11933,1172,3067,24,15000,804,1000,0.804,316,0.316,120,0.12,96
13885,12582,1303,3418,25,16000,780,1000,0.78,351,0.351,131,0.131,96
14674,13259,1415,3741,26,17000,789,1000,0.789,323,0.323,112,0.112,96
15448,13907,1541,4093,27,18000,774,1000,0.774,352,0.352,126,0.126,96
16218,14542,1676,4458,28,19000,770,1000,0.77,365,0.365,135,0.135,96
16972,15185,1787,4815,29,20000,754,1000,0.754,357,0.357,111,0.111,96
17737,15833,1904,5167,30,21000,765,1000,0.765,352,0.352,117,0.117,96
18463,16418,2045,5582,31,22000,726,1000,0.726,415,0.415,141,0.141,96
19203,17016,2187,5984,32,23000,740,1000,0.74,402,0.402,142,0.142,96
19925,17593,2332,6407,33,24000,722,1000,0.722,423,0.423,145,0.145,96
20642,18155,2487,6845,34,25000,717,1000,0.717,438,0.438,155,0.155,96
21377,18750,2627,7250,35,26000,735,1000,0.735,405,0.405,140,0.14,96
22089,19311,2778,7689,36,27000,712,1000,0.712,439,0.439,151,0.151,96
22792,19861,2931,8139,37,28000,703,1000,0.703,450,0.45,153,0.153,96
23498,20427,3071,8573,38,29000,706,1000,0.706,434,0.434,140,0.14,96
24223,21019,3204,8981,39,30000,725,1000,0.725,408,0.408,133,0.133,96
24920,21568,3352,9432,40,31000,697,1000,0.697,451,0.451,148,0.148,96
25627,22133,3494,9867,41,32000,707,1000,0.707,435,0.435,142,0.142,96
26300,22657,3643,10343,42,33000,673,1000,0.673,476,0.476,149,0.149,96
26993,23193,3800,10807,43,34000,693,1000,0.693,464,0.464,157,0.157,96
27678,23733,3945,11267,44,35000,685,1000,0.685,460,0.46,145,0.145,96
28368,24276,4092,11724,45,36000,690,1000,0.69,457,0.457,147,0.147,96
29023,24770,4253,12230,46,37000,655,1000,0.655,506,0.506,161,0.161,96
29676,25259,4417,12741,47,38000,653,1000,0.653,511,0.511,164,0.164,96
30322,25737,4585,13263,48,39000,646,1000,0.646,522,0.522,168,0.168,96
30975,26221,4754,13779,49,40000,653,1000,0.653,516,0.516,169,0.169,96
31617,26693,4924,14307,50,41000,642,1000,0.642,528,0.528,170,0.17,96
32247,27160,5087,14840,51,42000,630,1000,0.63,533,0.533,163,0.163,96
32900,27657,5243,15343,52,43000,653,1000,0.653,503,0.503,156,0.156,96
33546,28151,5395,15849,53,44000,646,1000,0.646,506,0.506,152,0.152,96
34172,28603,5569,16397,54,45000,626,1000,0.626,548,0.548,174,0.174,96
34820,29107,5713,16893,55,46000,648,1000,0.648,496,0.496,144,0.144,96
35462,29588,5874,17412,56,47000,642,1000,0.642,519,0.519,161,0.161,96
36099,30057,6042,17943,57,48000,637,1000,0.637,531,0.531,168,0.168,96
36717,30503,6214,18497,58,49000,618,1000,0.618,554,0.554,172,0.172,96
37325,30957,6368,19043,59,50000,608,1000,0.608,546,0.546,154,0.154,96
37944,31392,6552,19608,60,51000,619,1000,0.619,565,0.565,184,0.184,96
38583,31873,6710,20127,61,52000,639,1000,0.639,519,0.519,158,0.158,96
39189,32315,6874,20685,62,53000,606,1000,0.606,558,0.558,164,0.164,96
39782,32749,7033,21251,63,54000,593,1000,0.593,566,0.566,159,0.159,96
40394,33198,7196,21802,64,55000,612,1000,0.612,551,0.551,163,0.163,96
40986,33635,7351,22365,65,56000,592,1000,0.592,563,0.563,155,0.155,96
41576,34054,7522,22946,66,57000,590,1000,0.59,581,0.581,171,0.171,96
42127,34437,7690,23563,67,58000,551,1000,0.551,617,0.617,168,0.168,96
42739,34904,7835,24096,68,59000,612,1000,0.612,533,0.533,145,0.145,96
43333,35349,7984,24651,69,60000,594,1000,0.594,555,0.555,149,0.149,96
43944,35793,8151,25207,70,61000,611,1000,0.611,556,0.556,167,0.167,96
44495,36175,8320,25825,71,62000,551,1000,0.551,618,0.618,169,0.169,96
45060,36574,8486,26426,72,63000,565,1000,0.565,601,0.601,166,0.166,96
45631,36990,8641,27010,73,64000,571,1000,0.571,584,0.584,155,0.155,96
46210,37407,8803,27593,74,65000,579,1000,0.579,583,0.583,162,0.162,96
46766,37804,8962,28196,75,66000,556,1000,0.556,603,0.603,159,0.159,96
47335,38212,9123,28788,76,67000,569,1000,0.569,592,0.592,161,0.161,96
47912,38623,9289,29377,77,68000,577,1000,0.577,589,0.589,166,0.166,96
48460,38981,9479,30019,78,69000,548,1000,0.548,642,0.642,190,0.19,96
49003,39353,9650,30647,79,70000,543,1000,0.543,628,0.628,171,0.171,96
49563,39732,9831,31268,80,71000,560,1000,0.56,621,0.621,181,0.181,96
50123,40131,9992,31869,81,72000,560,1000,0.56,601,0.601,161,0.161,96
50674,40516,10158,32484,82,73000,551,1000,0.551,615,0.615,166,0.166,96
51240,40930,10310,33070,83,74000,566,1000,0.566,586,0.586,152,0.152,96
51790,41306,10484,33694,84,75000,550,1000,0.55,624,0.624,174,0.174,96
52324,41667,10657,34333,85,76000,534,1000,0.534,639,0.639,173,0.173,96
52888,42052,10836,34948,86,77000,564,1000,0.564,615,0.615,179,0.179,96
53444,42450,10994,35550,87,78000,556,1000,0.556,602,0.602,158,0.158,96
53982,42823,11159,36177,88,79000,538,1000,0.538,627,0.627,165,0.165,96
54560,43243,11317,36757,89,80000,578,1000,0.578,580,0.58,158,0.158,96
55096,43618,11478,37382,90,81000,536,1000,0.536,625,0.625,161,0.161,96
55654,44021,11633,37979,91,82000,558,1000,0.558,597,0.597,155,0.155,96
56189,44397,11792,38603,92,83000,535,1000,0.535,624,0.624,159,0.159,96
56720,44753,11967,39247,93,84000,531,1000,0.531,644,0.644,175,0.175,96
57242,45097,12145,39903,94,85000,522,1000,0.522,656,0.656,178,0.178,96
57767,45468,12299,40532,95,86000,525,1000,0.525,629,0.629,154,0.154,96
58296,45829,12467,41171,96,87000,529,1000,0.529,639,0.639,168,0.168,96
58814,46168,12646,41832,97,88000,518,1000,0.518,661,0.661,179,0.179,96
59328,46513,12815,42487,98,89000,514,1000,0.514,655,0.655,169,0.169,96
59869,46858,13011,43142,99,90000,541,1000,0.541,655,0.655,196,0.196,96
60380,47187,13193,43813,100,91000,511,1000,0.511,671,0.671,182,0.182,96
60911,47548,13363,44452,101,92000,531,1000,0.531,639,0.639,170,0.17,96
61432,47919,13513,45081,102,93000,521,1000,0.521,629,0.629,150,0.15,96
61926,48233,13693,45767,103,94000,494,1000,0.494,686,0.686,180,0.18,96
62408,48518,13890,46482,104,95000,482,1000,0.482,715,0.715,197,0.197,96
62907,48820,14087,47180,105,96000,499,1000,0.499,698,0.698,197,0.197,96
63412,49158,14254,47842,106,97000,505,1000,0.505,662,0.662,167,0.167,96
63921,49479,14442,48521,107,98000,509,1000,0.509,679,0.679,188,0.188,96
64442,49837,14605,49163,108,99000,521,1000,0.521,642,0.642,163,0.163,96
64942,50184,14758,49816,109,100000,500,1000,0.5,653,0.653,153,0.153,96
65444,50500,14944,50500,110,101000,502,1000,0.502,684,0.684,186,0.186,96
65920,50803,15117,51197,111,102000,476,1000,0.476,697,0.697,173,0.173,96
66407,51112,15295,51888,112,103000,487,1000,0.487,691,0.691,178,0.178,96
66917,51476,15441,52524,113,104000,510,1000,0.51,636,0.636,146,0.146,96
67418,51822,15596,53178,114,105000,501,1000,0.501,654,0.654,155,0.155,96
67890,52118,15772,53882,115,106000,472,1000,0.472,704,0.704,176,0.176,96
68425,52481,15944,54519,116,107000,535,1000,0.535,637,0.637,172,0.172,96
68906,52787,16119,55213,117,108000,481,1000,0.481,694,0.694,175,0.175,96
69393,53099,16294,55901,118,109000,487,1000,0.487,688,0.688,175,0.175,96
69857,53384,16473,56616,119,110000,464,1000,0.464,715,0.715,179,0.179,96
70320,53679,16641,57321,120,111000,463,1000,0.463,705,0.705,168,0.168,96
70777,53964,16813,58036,121,112000,457,1000,0.457,715,0.715,172,0.172,96
71253,54263,16990,58737,122,113000,476,1000,0.476,701,0.701,177,0.177,96
71721,54539,17182,59461,123,114000,468,1000,0.468,724,0.724,192,0.192,96
71869,54638,17231,59660,124,114298,148,298,0.49664429530201343,199,0.6677852348993288,49,0.1644295302013423,96
100,100,0,0,1,100,NA,NA,NA,NA,NA,NA,NA,97
199,198,1,2,2,200,99,100,0.99,2,0.02,1,0.01,97
298,296,2,4,3,300,99,100,0.99,2,0.02,1,0.01,97
398,396,2,4,4,400,100,100,1,0,0,0,0,97
496,492,4,8,5,500,98,100,0.98,4,0.04,2,0.02,97
594,588,6,12,6,600,98,100,0.98,4,0.04,2,0.02,97
691,682,9,18,7,700,97,100,0.97,6,0.06,3,0.03,97
787,775,12,25,8,800,96,100,0.96,7,0.07,3,0.03,97
885,872,13,28,9,900,98,100,0.98,3,0.03,1,0.01,97
983,969,14,31,10,1000,98,100,0.98,3,0.03,1,0.01,97
1949,1906,43,94,11,2000,966,1000,0.966,63,0.063,29,0.029,97
2888,2801,87,199,12,3000,939,1000,0.939,105,0.105,44,0.044,97
3808,3667,141,333,13,4000,920,1000,0.92,134,0.134,54,0.054,97
4708,4498,210,502,14,5000,900,1000,0.9,169,0.169,69,0.069,97
5580,5290,290,710,15,6000,872,1000,0.872,208,0.208,80,0.08,97
6446,6072,374,928,16,7000,866,1000,0.866,218,0.218,84,0.084,97
7302,6836,466,1164,17,8000,856,1000,0.856,236,0.236,92,0.092,97
8149,7591,558,1409,18,9000,847,1000,0.847,245,0.245,92,0.092,97
8970,8308,662,1692,19,10000,821,1000,0.821,283,0.283,104,0.104,97
9795,9031,764,1969,20,11000,825,1000,0.825,277,0.277,102,0.102,97
10623,9756,867,2244,21,12000,828,1000,0.828,275,0.275,103,0.103,97
11455,10492,963,2508,22,13000,832,1000,0.832,264,0.264,96,0.096,97
12247,11171,1076,2829,23,14000,792,1000,0.792,321,0.321,113,0.113,97
13040,11846,1194,3154,24,15000,793,1000,0.793,325,0.325,118,0.118,97
13797,12464,1333,3536,25,16000,757,1000,0.757,382,0.382,139,0.139,97
14557,13100,1457,3900,26,17000,760,1000,0.76,364,0.364,124,0.124,97
15344,13770,1574,4230,27,18000,787,1000,0.787,330,0.33,117,0.117,97
16108,14412,1696,4588,28,19000,764,1000,0.764,358,0.358,122,0.122,97
16849,15024,1825,4976,29,20000,741,1000,0.741,388,0.388,129,0.129,97
17567,15596,1971,5404,30,21000,718,1000,0.718,428,0.428,146,0.146,97
18292,16190,2102,5810,31,22000,725,1000,0.725,406,0.406,131,0.131,97
19057,16834,2223,6166,32,23000,765,1000,0.765,356,0.356,121,0.121,97
19794,17442,2352,6558,33,24000,737,1000,0.737,392,0.392,129,0.129,97
20518,18031,2487,6969,34,25000,724,1000,0.724,411,0.411,135,0.135,97
21237,18606,2631,7394,35,26000,719,1000,0.719,425,0.425,144,0.144,97
21974,19218,2756,7782,36,27000,737,1000,0.737,388,0.388,125,0.125,97
22682,19792,2890,8208,37,28000,708,1000,0.708,426,0.426,134,0.134,97
23393,20358,3035,8642,38,29000,711,1000,0.711,434,0.434,145,0.145,97
24126,20963,3163,9037,39,30000,733,1000,0.733,395,0.395,128,0.128,97
24837,21542,3295,9458,40,31000,711,1000,0.711,421,0.421,132,0.132,97
25515,22069,3446,9931,41,32000,678,1000,0.678,473,0.473,151,0.151,97
26209,22599,3610,10401,42,33000,694,1000,0.694,470,0.47,164,0.164,97
26886,23127,3759,10873,43,34000,677,1000,0.677,472,0.472,149,0.149,97
27550,23632,3918,11368,44,35000,664,1000,0.664,495,0.495,159,0.159,97
28221,24146,4075,11854,45,36000,671,1000,0.671,486,0.486,157,0.157,97
28899,24680,4219,12320,46,37000,678,1000,0.678,466,0.466,144,0.144,97
29573,25193,4380,12807,47,38000,674,1000,0.674,487,0.487,161,0.161,97
30225,25694,4531,13306,48,39000,652,1000,0.652,499,0.499,151,0.151,97
30877,26179,4698,13821,49,40000,652,1000,0.652,515,0.515,167,0.167,97
31507,26632,4875,14368,50,41000,630,1000,0.63,547,0.547,177,0.177,97
32164,27133,5031,14867,51,42000,657,1000,0.657,499,0.499,156,0.156,97
32818,27625,5193,15375,52,43000,654,1000,0.654,508,0.508,162,0.162,97
33465,28123,5342,15877,53,44000,647,1000,0.647,502,0.502,149,0.149,97
34068,28563,5505,16437,54,45000,603,1000,0.603,560,0.56,163,0.163,97
34706,29034,5672,16966,55,46000,638,1000,0.638,529,0.529,167,0.167,97
35318,29488,5830,17512,56,47000,612,1000,0.612,546,0.546,158,0.158,97
35940,29929,6011,18071,57,48000,622,1000,0.622,559,0.559,181,0.181,97
36576,30415,6161,18585,58,49000,636,1000,0.636,514,0.514,150,0.15,97
37201,30870,6331,19130,59,50000,625,1000,0.625,545,0.545,170,0.17,97
37793,31294,6499,19706,60,51000,592,1000,0.592,576,0.576,168,0.168,97
38410,31747,6663,20253,61,52000,617,1000,0.617,547,0.547,164,0.164,97
39024,32205,6819,20795,62,53000,614,1000,0.614,542,0.542,156,0.156,97
39620,32640,6980,21360,63,54000,596,1000,0.596,565,0.565,161,0.161,97
40232,33083,7149,21917,64,55000,612,1000,0.612,557,0.557,169,0.169,97
40830,33515,7315,22485,65,56000,598,1000,0.598,568,0.568,166,0.166,97
41427,33947,7480,23053,66,57000,597,1000,0.597,568,0.568,165,0.165,97
42025,34379,7646,23621,67,58000,598,1000,0.598,568,0.568,166,0.166,97
42593,34775,7818,24225,68,59000,568,1000,0.568,604,0.604,172,0.172,97
43180,35205,7975,24795,69,60000,587,1000,0.587,570,0.57,157,0.157,97
43768,35631,8137,25369,70,61000,588,1000,0.588,574,0.574,162,0.162,97
44390,36098,8292,25902,71,62000,622,1000,0.622,533,0.533,155,0.155,97
44984,36532,8452,26468,72,63000,594,1000,0.594,566,0.566,160,0.16,97
45582,36972,8610,27028,73,64000,598,1000,0.598,560,0.56,158,0.158,97
46144,37363,8781,27637,74,65000,562,1000,0.562,609,0.609,171,0.171,97
46710,37779,8931,28221,75,66000,566,1000,0.566,584,0.584,150,0.15,97
47255,38162,9093,28838,76,67000,545,1000,0.545,617,0.617,162,0.162,97
47828,38559,9269,29441,77,68000,573,1000,0.573,603,0.603,176,0.176,97
48372,38926,9446,30074,78,69000,544,1000,0.544,633,0.633,177,0.177,97
48946,39349,9597,30651,79,70000,574,1000,0.574,577,0.577,151,0.151,97
49499,39722,9777,31278,80,71000,553,1000,0.553,627,0.627,180,0.18,97
50033,40074,9959,31926,81,72000,534,1000,0.534,648,0.648,182,0.182,97
50573,40434,10139,32566,82,73000,540,1000,0.54,640,0.64,180,0.18,97
51130,40821,10309,33179,83,74000,557,1000,0.557,613,0.613,170,0.17,97
51657,41188,10469,33812,84,75000,527,1000,0.527,633,0.633,160,0.16,97
52197,41554,10643,34446,85,76000,540,1000,0.54,634,0.634,174,0.174,97
52768,41959,10809,35041,86,77000,571,1000,0.571,595,0.595,166,0.166,97
53317,42343,10974,35657,87,78000,549,1000,0.549,616,0.616,165,0.165,97
53872,42724,11148,36276,88,79000,555,1000,0.555,619,0.619,174,0.174,97
54408,43081,11327,36919,89,80000,536,1000,0.536,643,0.643,179,0.179,97
54937,43433,11504,37567,90,81000,529,1000,0.529,648,0.648,177,0.177,97
55504,43838,11666,38162,91,82000,567,1000,0.567,595,0.595,162,0.162,97
56063,44222,11841,38778,92,83000,559,1000,0.559,616,0.616,175,0.175,97
56580,44548,12032,39452,93,84000,517,1000,0.517,674,0.674,191,0.191,97
57081,44857,12224,40143,94,85000,501,1000,0.501,691,0.691,192,0.192,97
57597,45205,12392,40795,95,86000,516,1000,0.516,652,0.652,168,0.168,97
58146,45573,12573,41427,96,87000,549,1000,0.549,632,0.632,181,0.181,97
58651,45903,12748,42097,97,88000,505,1000,0.505,670,0.67,175,0.175,97
59198,46309,12889,42691,98,89000,547,1000,0.547,594,0.594,141,0.141,97
59723,46661,13062,43339,99,90000,525,1000,0.525,648,0.648,173,0.173,97
60261,47030,13231,43970,100,91000,538,1000,0.538,631,0.631,169,0.169,97
60774,47359,13415,44641,101,92000,513,1000,0.513,671,0.671,184,0.184,97
61267,47680,13587,45320,102,93000,493,1000,0.493,679,0.679,172,0.172,97
61766,48019,13747,45981,103,94000,499,1000,0.499,661,0.661,160,0.16,97
62288,48365,13923,46635,104,95000,522,1000,0.522,654,0.654,176,0.176,97
62818,48723,14095,47277,105,96000,530,1000,0.53,642,0.642,172,0.172,97
63345,49079,14266,47921,106,97000,527,1000,0.527,644,0.644,171,0.171,97
63868,49431,14437,48569,107,98000,523,1000,0.523,648,0.648,171,0.171,97
64353,49728,14625,49272,108,99000,485,1000,0.485,703,0.703,188,0.188,97
64833,50040,14793,49960,109,100000,480,1000,0.48,688,0.688,168,0.168,97
65314,50344,14970,50656,110,101000,481,1000,0.481,696,0.696,177,0.177,97
65809,50682,15127,51318,111,102000,495,1000,0.495,662,0.662,157,0.157,97
66323,51035,15288,51965,112,103000,514,1000,0.514,647,0.647,161,0.161,97
66821,51353,15468,52647,113,104000,498,1000,0.498,682,0.682,180,0.18,97
67318,51657,15661,53343,114,105000,497,1000,0.497,696,0.696,193,0.193,97
67812,51959,15853,54041,115,106000,494,1000,0.494,698,0.698,192,0.192,97
68308,52282,16026,54718,116,107000,496,1000,0.496,677,0.677,173,0.173,97
68795,52593,16202,55407,117,108000,487,1000,0.487,689,0.689,176,0.176,97
69283,52910,16373,56090,118,109000,488,1000,0.488,683,0.683,171,0.171,97
69758,53231,16527,56769,119,110000,475,1000,0.475,679,0.679,154,0.154,97
70272,53581,16691,57419,120,111000,514,1000,0.514,650,0.65,164,0.164,97
70746,53892,16854,58108,121,112000,474,1000,0.474,689,0.689,163,0.163,97
71236,54236,17000,58764,122,113000,490,1000,0.49,656,0.656,146,0.146,97
71732,54556,17176,59444,123,114000,496,1000,0.496,680,0.68,176,0.176,97
71869,54638,17231,59660,124,114298,137,298,0.4597315436241611,216,0.7248322147651006,55,0.18456375838926176,97
100,100,0,0,1,100,NA,NA,NA,NA,NA,NA,NA,98
199,198,1,2,2,200,99,100,0.99,2,0.02,1,0.01,98
296,292,4,8,3,300,97,100,0.97,6,0.06,3,0.03,98
393,386,7,14,4,400,97,100,0.97,6,0.06,3,0.03,98
493,486,7,14,5,500,100,100,1,0,0,0,0,98
591,582,9,18,6,600,98,100,0.98,4,0.04,2,0.02,98
689,678,11,22,7,700,98,100,0.98,4,0.04,2,0.02,98
786,774,12,26,8,800,97,100,0.97,4,0.04,1,0.01,98
886,874,12,26,9,900,100,100,1,0,0,0,0,98
981,966,15,34,10,1000,95,100,0.95,8,0.08,3,0.03,98
1951,1914,37,86,11,2000,970,1000,0.97,52,0.052,22,0.022,98
2886,2802,84,198,12,3000,935,1000,0.935,112,0.112,47,0.047,98
3800,3652,148,348,13,4000,914,1000,0.914,150,0.15,64,0.064,98
4700,4493,207,507,14,5000,900,1000,0.9,159,0.159,59,0.059,98
5597,5319,278,681,15,6000,897,1000,0.897,174,0.174,71,0.071,98
6480,6131,349,869,16,7000,883,1000,0.883,188,0.188,71,0.071,98
7347,6912,435,1088,17,8000,867,1000,0.867,219,0.219,86,0.086,98
8198,7680,518,1320,18,9000,851,1000,0.851,232,0.232,83,0.083,98
9035,8410,625,1590,19,10000,837,1000,0.837,270,0.27,107,0.107,98
9870,9138,732,1862,20,11000,835,1000,0.835,272,0.272,107,0.107,98
10701,9862,839,2138,21,12000,831,1000,0.831,276,0.276,107,0.107,98
11504,10542,962,2458,22,13000,803,1000,0.803,320,0.32,123,0.123,98
12305,11215,1090,2785,23,14000,801,1000,0.801,327,0.327,128,0.128,98
13104,11903,1201,3097,24,15000,799,1000,0.799,312,0.312,111,0.111,98
13881,12553,1328,3447,25,16000,777,1000,0.777,350,0.35,127,0.127,98
14658,13193,1465,3807,26,17000,777,1000,0.777,360,0.36,137,0.137,98
15427,13832,1595,4168,27,18000,769,1000,0.769,361,0.361,130,0.13,98
16223,14525,1698,4475,28,19000,796,1000,0.796,307,0.307,103,0.103,98
16989,15164,1825,4836,29,20000,766,1000,0.766,361,0.361,127,0.127,98
17738,15773,1965,5227,30,21000,749,1000,0.749,391,0.391,140,0.14,98
18489,16394,2095,5606,31,22000,751,1000,0.751,379,0.379,130,0.13,98
19224,16994,2230,6006,32,23000,735,1000,0.735,400,0.4,135,0.135,98
19951,17567,2384,6433,33,24000,727,1000,0.727,427,0.427,154,0.154,98
20675,18161,2514,6839,34,25000,724,1000,0.724,406,0.406,130,0.13,98
21383,18726,2657,7274,35,26000,708,1000,0.708,435,0.435,143,0.143,98
22086,19289,2797,7711,36,27000,703,1000,0.703,437,0.437,140,0.14,98
22816,19894,2922,8106,37,28000,730,1000,0.73,395,0.395,125,0.125,98
23510,20429,3081,8571,38,29000,694,1000,0.694,465,0.465,159,0.159,98
24185,20946,3239,9054,39,30000,675,1000,0.675,483,0.483,158,0.158,98
24870,21482,3388,9518,40,31000,685,1000,0.685,464,0.464,149,0.149,98
25572,22055,3517,9945,41,32000,702,1000,0.702,427,0.427,129,0.129,98
26258,22589,3669,10411,42,33000,686,1000,0.686,466,0.466,152,0.152,98
26938,23105,3833,10895,43,34000,680,1000,0.68,484,0.484,164,0.164,98
27617,23644,3973,11356,44,35000,679,1000,0.679,461,0.461,140,0.14,98
28291,24186,4105,11814,45,36000,674,1000,0.674,458,0.458,132,0.132,98
28949,24683,4266,12317,46,37000,658,1000,0.658,503,0.503,161,0.161,98
29579,25138,4441,12862,47,38000,630,1000,0.63,545,0.545,175,0.175,98
30245,25648,4597,13352,48,39000,666,1000,0.666,490,0.49,156,0.156,98
30910,26169,4741,13831,49,40000,665,1000,0.665,479,0.479,144,0.144,98
31580,26699,4881,14301,50,41000,670,1000,0.67,470,0.47,140,0.14,98
32239,27215,5024,14785,51,42000,659,1000,0.659,484,0.484,143,0.143,98
32878,27691,5187,15309,52,43000,639,1000,0.639,524,0.524,163,0.163,98
33515,28176,5339,15824,53,44000,637,1000,0.637,515,0.515,152,0.152,98
34112,28576,5536,16424,54,45000,597,1000,0.597,600,0.6,197,0.197,98
34757,29075,5682,16925,55,46000,645,1000,0.645,501,0.501,146,0.146,98
35399,29568,5831,17432,56,47000,642,1000,0.642,507,0.507,149,0.149,98
36028,30035,5993,17965,57,48000,629,1000,0.629,533,0.533,162,0.162,98
36668,30506,6162,18494,58,49000,640,1000,0.64,529,0.529,169,0.169,98
37267,30929,6338,19071,59,50000,599,1000,0.599,577,0.577,176,0.176,98
37909,31422,6487,19578,60,51000,642,1000,0.642,507,0.507,149,0.149,98
38523,31878,6645,20122,61,52000,614,1000,0.614,544,0.544,158,0.158,98
39126,32316,6810,20684,62,53000,603,1000,0.603,562,0.562,165,0.165,98
39752,32771,6981,21229,63,54000,626,1000,0.626,545,0.545,171,0.171,98
40382,33268,7114,21732,64,55000,630,1000,0.63,503,0.503,133,0.133,98
40983,33713,7270,22287,65,56000,601,1000,0.601,555,0.555,156,0.156,98
41582,34143,7439,22857,66,57000,599,1000,0.599,570,0.57,169,0.169,98
42178,34547,7631,23453,67,58000,596,1000,0.596,596,0.596,192,0.192,98
42748,34941,7807,24059,68,59000,570,1000,0.57,606,0.606,176,0.176,98
43357,35400,7957,24600,69,60000,609,1000,0.609,541,0.541,150,0.15,98
43960,35848,8112,25152,70,61000,603,1000,0.603,552,0.552,155,0.155,98
44516,36215,8301,25785,71,62000,556,1000,0.556,633,0.633,189,0.189,98
45094,36626,8468,26374,72,63000,578,1000,0.578,589,0.589,167,0.167,98
45681,37042,8639,26958,73,64000,587,1000,0.587,584,0.584,171,0.171,98
46247,37434,8813,27566,74,65000,566,1000,0.566,608,0.608,174,0.174,98
46817,37840,8977,28160,75,66000,570,1000,0.57,594,0.594,164,0.164,98
47394,38239,9155,28761,76,67000,577,1000,0.577,601,0.601,178,0.178,98
47979,38667,9312,29333,77,68000,585,1000,0.585,572,0.572,157,0.157,98
48545,39055,9490,29945,78,69000,566,1000,0.566,612,0.612,178,0.178,98
49091,39432,9659,30568,79,70000,546,1000,0.546,623,0.623,169,0.169,98
49660,39841,9819,31159,80,71000,569,1000,0.569,591,0.591,160,0.16,98
50217,40218,9999,31782,81,72000,557,1000,0.557,623,0.623,180,0.18,98
50767,40601,10166,32399,82,73000,550,1000,0.55,617,0.617,167,0.167,98
51328,40996,10332,33004,83,74000,561,1000,0.561,605,0.605,166,0.166,98
51885,41392,10493,33608,84,75000,557,1000,0.557,604,0.604,161,0.161,98
52433,41780,10653,34220,85,76000,548,1000,0.548,612,0.612,160,0.16,98
52955,42138,10817,34862,86,77000,522,1000,0.522,642,0.642,164,0.164,98
53490,42496,10994,35504,87,78000,535,1000,0.535,642,0.642,177,0.177,98
54038,42866,11172,36134,88,79000,548,1000,0.548,630,0.63,178,0.178,98
54589,43245,11344,36755,89,80000,551,1000,0.551,621,0.621,172,0.172,98
55101,43572,11529,37428,90,81000,512,1000,0.512,673,0.673,185,0.185,98
55660,43973,11687,38027,91,82000,559,1000,0.559,599,0.599,158,0.158,98
56184,44330,11854,38670,92,83000,524,1000,0.524,643,0.643,167,0.167,98
56703,44693,12010,39307,93,84000,519,1000,0.519,637,0.637,156,0.156,98
57222,45034,12188,39966,94,85000,519,1000,0.519,659,0.659,178,0.178,98
57761,45416,12345,40584,95,86000,539,1000,0.539,618,0.618,157,0.157,98
58294,45806,12488,41194,96,87000,533,1000,0.533,610,0.61,143,0.143,98
58804,46140,12664,41860,97,88000,510,1000,0.51,666,0.666,176,0.176,98
59330,46496,12834,42504,98,89000,526,1000,0.526,644,0.644,170,0.17,98
59831,46817,13014,43183,99,90000,501,1000,0.501,679,0.679,180,0.18,98
60357,47166,13191,43834,100,91000,526,1000,0.526,651,0.651,177,0.177,98
60870,47499,13371,44501,101,92000,513,1000,0.513,667,0.667,180,0.18,98
61366,47806,13560,45194,102,93000,496,1000,0.496,693,0.693,189,0.189,98
61850,48134,13716,45866,103,94000,484,1000,0.484,672,0.672,156,0.156,98
62371,48494,13877,46506,104,95000,521,1000,0.521,640,0.64,161,0.161,98
62895,48851,14044,47149,105,96000,524,1000,0.524,643,0.643,167,0.167,98
63375,49133,14242,47867,106,97000,480,1000,0.48,718,0.718,198,0.198,98
63886,49453,14433,48547,107,98000,511,1000,0.511,680,0.68,191,0.191,98
64378,49777,14601,49223,108,99000,492,1000,0.492,676,0.676,168,0.168,98
64885,50119,14766,49881,109,100000,507,1000,0.507,658,0.658,165,0.165,98
65407,50495,14912,50505,110,101000,522,1000,0.522,624,0.624,146,0.146,98
65883,50776,15107,51224,111,102000,476,1000,0.476,719,0.719,195,0.195,98
66374,51097,15277,51903,112,103000,491,1000,0.491,679,0.679,170,0.17,98
66886,51423,15463,52577,113,104000,512,1000,0.512,674,0.674,186,0.186,98
67369,51743,15626,53257,114,105000,483,1000,0.483,680,0.68,163,0.163,98
67864,52066,15798,53934,115,106000,495,1000,0.495,677,0.677,172,0.172,98
68364,52383,15981,54617,116,107000,500,1000,0.5,683,0.683,183,0.183,98
68837,52686,16151,55314,117,108000,473,1000,0.473,697,0.697,170,0.17,98
69317,53001,16316,55999,118,109000,480,1000,0.48,685,0.685,165,0.165,98
69825,53342,16483,56658,119,110000,508,1000,0.508,659,0.659,167,0.167,98
70308,53662,16646,57338,120,111000,483,1000,0.483,680,0.68,163,0.163,98
70795,53979,16816,58021,121,112000,487,1000,0.487,683,0.683,170,0.17,98
71249,54256,16993,58744,122,113000,454,1000,0.454,723,0.723,177,0.177,98
71723,54551,17172,59449,123,114000,474,1000,0.474,705,0.705,179,0.179,98
71869,54638,17231,59660,124,114298,146,298,0.4899328859060403,211,0.7080536912751678,59,0.19798657718120805,98
100,100,0,0,1,100,NA,NA,NA,NA,NA,NA,NA,99
199,198,1,2,2,200,99,100,0.99,2,0.02,1,0.01,99
299,298,1,2,3,300,100,100,1,0,0,0,0,99
397,394,3,6,4,400,98,100,0.98,4,0.04,2,0.02,99
494,488,6,12,5,500,97,100,0.97,6,0.06,3,0.03,99
593,586,7,14,6,600,99,100,0.99,2,0.02,1,0.01,99
692,684,8,16,7,700,99,100,0.99,2,0.02,1,0.01,99
791,782,9,18,8,800,99,100,0.99,2,0.02,1,0.01,99
886,872,14,28,9,900,95,100,0.95,10,0.1,5,0.05,99
984,968,16,32,10,1000,98,100,0.98,4,0.04,2,0.02,99
1956,1913,43,87,11,2000,972,1000,0.972,55,0.055,27,0.027,99
2893,2801,92,199,12,3000,937,1000,0.937,112,0.112,49,0.049,99
3804,3651,153,349,13,4000,911,1000,0.911,150,0.15,61,0.061,99
4707,4489,218,511,14,5000,903,1000,0.903,162,0.162,65,0.065,99
5590,5299,291,701,15,6000,883,1000,0.883,190,0.19,73,0.073,99
6462,6082,380,918,16,7000,872,1000,0.872,217,0.217,89,0.089,99
7316,6847,469,1153,17,8000,854,1000,0.854,235,0.235,89,0.089,99
8160,7590,570,1410,18,9000,844,1000,0.844,257,0.257,101,0.101,99
9008,8342,666,1658,19,10000,848,1000,0.848,248,0.248,96,0.096,99
9829,9059,770,1941,20,11000,821,1000,0.821,283,0.283,104,0.104,99
10651,9775,876,2225,21,12000,822,1000,0.822,284,0.284,106,0.106,99
11458,10463,995,2537,22,13000,807,1000,0.807,312,0.312,119,0.119,99
12264,11166,1098,2834,23,14000,806,1000,0.806,297,0.297,103,0.103,99
13059,11848,1211,3152,24,15000,795,1000,0.795,318,0.318,113,0.113,99
13860,12537,1323,3463,25,16000,801,1000,0.801,311,0.311,112,0.112,99
14633,13173,1460,3827,26,17000,773,1000,0.773,364,0.364,137,0.137,99
15414,13836,1578,4164,27,18000,781,1000,0.781,337,0.337,118,0.118,99
16175,14476,1699,4524,28,19000,761,1000,0.761,360,0.36,121,0.121,99
16907,15057,1850,4943,29,20000,732,1000,0.732,419,0.419,151,0.151,99
17646,15658,1988,5342,30,21000,739,1000,0.739,399,0.399,138,0.138,99
18376,16251,2125,5749,31,22000,730,1000,0.73,407,0.407,137,0.137,99
19109,16844,2265,6156,32,23000,733,1000,0.733,407,0.407,140,0.14,99
19853,17459,2394,6541,33,24000,744,1000,0.744,385,0.385,129,0.129,99
20580,18047,2533,6953,34,25000,727,1000,0.727,412,0.412,139,0.139,99
21299,18618,2681,7382,35,26000,719,1000,0.719,429,0.429,148,0.148,99
21984,19148,2836,7852,36,27000,685,1000,0.685,470,0.47,155,0.155,99
22692,19721,2971,8279,37,28000,708,1000,0.708,427,0.427,135,0.135,99
23404,20300,3104,8700,38,29000,712,1000,0.712,421,0.421,133,0.133,99
24126,20882,3244,9118,39,30000,722,1000,0.722,418,0.418,140,0.14,99
24818,21422,3396,9578,40,31000,692,1000,0.692,460,0.46,152,0.152,99
25536,21995,3541,10005,41,32000,718,1000,0.718,427,0.427,145,0.145,99
26245,22568,3677,10432,42,33000,709,1000,0.709,427,0.427,136,0.136,99
26908,23060,3848,10940,43,34000,663,1000,0.663,508,0.508,171,0.171,99
27563,23559,4004,11441,44,35000,655,1000,0.655,501,0.501,156,0.156,99
28241,24091,4150,11909,45,36000,678,1000,0.678,468,0.468,146,0.146,99
28886,24567,4319,12433,46,37000,645,1000,0.645,524,0.524,169,0.169,99
29562,25096,4466,12904,47,38000,676,1000,0.676,471,0.471,147,0.147,99
30234,25617,4617,13383,48,39000,672,1000,0.672,479,0.479,151,0.151,99
30871,26083,4788,13917,49,40000,637,1000,0.637,534,0.534,171,0.171,99
31528,26584,4944,14416,50,41000,657,1000,0.657,499,0.499,156,0.156,99
32174,27075,5099,14925,51,42000,646,1000,0.646,509,0.509,155,0.155,99
32785,27511,5274,15489,52,43000,611,1000,0.611,564,0.564,175,0.175,99
33413,27979,5434,16021,53,44000,628,1000,0.628,532,0.532,160,0.16,99
34061,28473,5588,16527,54,45000,648,1000,0.648,506,0.506,154,0.154,99
34708,28951,5757,17049,55,46000,647,1000,0.647,522,0.522,169,0.169,99
35333,29407,5926,17593,56,47000,625,1000,0.625,544,0.544,169,0.169,99
35943,29849,6094,18151,57,48000,610,1000,0.61,558,0.558,168,0.168,99
36591,30346,6245,18654,58,49000,648,1000,0.648,503,0.503,151,0.151,99
37239,30839,6400,19161,59,50000,648,1000,0.648,507,0.507,155,0.155,99
37846,31312,6534,19688,60,51000,607,1000,0.607,527,0.527,134,0.134,99
38456,31756,6700,20244,61,52000,610,1000,0.61,556,0.556,166,0.166,99
39061,32196,6865,20804,62,53000,605,1000,0.605,560,0.56,165,0.165,99
39645,32598,7047,21402,63,54000,584,1000,0.584,598,0.598,182,0.182,99
40231,33015,7216,21985,64,55000,586,1000,0.586,583,0.583,169,0.169,99
40826,33442,7384,22558,65,56000,595,1000,0.595,573,0.573,168,0.168,99
41418,33856,7562,23144,66,57000,592,1000,0.592,586,0.586,178,0.178,99
42021,34310,7711,23690,67,58000,603,1000,0.603,546,0.546,149,0.149,99
42610,34742,7868,24258,68,59000,589,1000,0.589,568,0.568,157,0.157,99
43223,35198,8025,24802,69,60000,613,1000,0.613,544,0.544,157,0.157,99
43822,35636,8186,25364,70,61000,599,1000,0.599,562,0.562,161,0.161,99
44393,36039,8354,25961,71,62000,571,1000,0.571,597,0.597,168,0.168,99
44981,36470,8511,26530,72,63000,588,1000,0.588,569,0.569,157,0.157,99
45575,36906,8669,27094,73,64000,594,1000,0.594,564,0.564,158,0.158,99
46155,37317,8838,27683,74,65000,580,1000,0.58,589,0.589,169,0.169,99
46700,37692,9008,28308,75,66000,545,1000,0.545,625,0.625,170,0.17,99
47256,38089,9167,28911,76,67000,556,1000,0.556,603,0.603,159,0.159,99
47829,38510,9319,29490,77,68000,573,1000,0.573,579,0.579,152,0.152,99
48404,38914,9490,30086,78,69000,575,1000,0.575,596,0.596,171,0.171,99
48981,39335,9646,30665,79,70000,577,1000,0.577,579,0.579,156,0.156,99
49546,39716,9830,31284,80,71000,565,1000,0.565,619,0.619,184,0.184,99
50082,40074,10008,31926,81,72000,536,1000,0.536,642,0.642,178,0.178,99
50635,40466,10169,32534,82,73000,553,1000,0.553,608,0.608,161,0.161,99
51203,40871,10332,33129,83,74000,568,1000,0.568,595,0.595,163,0.163,99
51721,41211,10510,33789,84,75000,518,1000,0.518,660,0.66,178,0.178,99
52263,41596,10667,34404,85,76000,542,1000,0.542,615,0.615,157,0.157,99
52843,42025,10818,34975,86,77000,580,1000,0.58,571,0.571,151,0.151,99
53383,42393,10990,35607,87,78000,540,1000,0.54,632,0.632,172,0.172,99
53937,42781,11156,36219,88,79000,554,1000,0.554,612,0.612,166,0.166,99
54456,43123,11333,36877,89,80000,519,1000,0.519,658,0.658,177,0.177,99
54990,43475,11515,37525,90,81000,534,1000,0.534,648,0.648,182,0.182,99
55513,43835,11678,38165,91,82000,523,1000,0.523,640,0.64,163,0.163,99
56041,44186,11855,38814,92,83000,528,1000,0.528,649,0.649,177,0.177,99
56589,44594,11995,39406,93,84000,548,1000,0.548,592,0.592,140,0.14,99
57102,44943,12159,40057,94,85000,513,1000,0.513,651,0.651,164,0.164,99
57627,45303,12324,40697,95,86000,525,1000,0.525,640,0.64,165,0.165,99
58162,45654,12508,41346,96,87000,535,1000,0.535,649,0.649,184,0.184,99
58676,45992,12684,42008,97,88000,514,1000,0.514,662,0.662,176,0.176,99
59203,46357,12846,42643,98,89000,527,1000,0.527,635,0.635,162,0.162,99
59723,46707,13016,43293,99,90000,520,1000,0.52,650,0.65,170,0.17,99
60247,47071,13176,43929,100,91000,524,1000,0.524,636,0.636,160,0.16,99
60751,47392,13359,44608,101,92000,504,1000,0.504,679,0.679,183,0.183,99
61282,47756,13526,45244,102,93000,531,1000,0.531,636,0.636,167,0.167,99
61814,48140,13674,45860,103,94000,532,1000,0.532,616,0.616,148,0.148,99
62348,48512,13836,46488,104,95000,534,1000,0.534,628,0.628,162,0.162,99
62831,48784,14047,47216,105,96000,483,1000,0.483,728,0.728,211,0.211,99
63346,49119,14227,47881,106,97000,515,1000,0.515,665,0.665,180,0.18,99
63840,49422,14418,48578,107,98000,494,1000,0.494,697,0.697,191,0.191,99
64339,49723,14616,49277,108,99000,499,1000,0.499,699,0.699,198,0.198,99
64821,50026,14795,49974,109,100000,482,1000,0.482,697,0.697,179,0.179,99
65314,50358,14956,50642,110,101000,493,1000,0.493,668,0.668,161,0.161,99
65798,50664,15134,51336,111,102000,484,1000,0.484,694,0.694,178,0.178,99
66313,51018,15295,51982,112,103000,515,1000,0.515,646,0.646,161,0.161,99
66795,51321,15474,52679,113,104000,482,1000,0.482,697,0.697,179,0.179,99
67287,51645,15642,53355,114,105000,492,1000,0.492,676,0.676,168,0.168,99
67784,51974,15810,54026,115,106000,497,1000,0.497,671,0.671,168,0.168,99
68260,52282,15978,54718,116,107000,476,1000,0.476,692,0.692,168,0.168,99
68767,52604,16163,55396,117,108000,507,1000,0.507,678,0.678,185,0.185,99
69251,52921,16330,56079,118,109000,484,1000,0.484,683,0.683,167,0.167,99
69759,53264,16495,56736,119,110000,508,1000,0.508,657,0.657,165,0.165,99
70260,53608,16652,57392,120,111000,501,1000,0.501,656,0.656,157,0.157,99
70757,53938,16819,58062,121,112000,497,1000,0.497,670,0.67,167,0.167,99
71246,54262,16984,58738,122,113000,489,1000,0.489,676,0.676,165,0.165,99
71728,54551,17177,59449,123,114000,482,1000,0.482,711,0.711,193,0.193,99
71869,54638,17231,59660,124,114298,141,298,0.47315436241610737,211,0.7080536912751678,54,0.18120805369127516,99
100,100,0,0,1,100,NA,NA,NA,NA,NA,NA,NA,100
200,200,0,0,2,200,100,100,1,0,0,0,0,100
300,300,0,0,3,300,100,100,1,0,0,0,0,100
398,396,2,4,4,400,98,100,0.98,4,0.04,2,0.02,100
497,494,3,6,5,500,99,100,0.99,2,0.02,1,0.01,100
596,592,4,8,6,600,99,100,0.99,2,0.02,1,0.01,100
694,688,6,12,7,700,98,100,0.98,4,0.04,2,0.02,100
790,780,10,20,8,800,96,100,0.96,8,0.08,4,0.04,100
888,877,11,23,9,900,98,100,0.98,3,0.03,1,0.01,100
984,969,15,31,10,1000,96,100,0.96,8,0.08,4,0.04,100
1937,1884,53,116,11,2000,953,1000,0.953,85,0.085,38,0.038,100
2863,2757,106,243,12,3000,926,1000,0.926,127,0.127,53,0.053,100
3776,3611,165,389,13,4000,913,1000,0.913,146,0.146,59,0.059,100
4670,4429,241,571,14,5000,894,1000,0.894,182,0.182,76,0.076,100
5554,5241,313,759,15,6000,884,1000,0.884,188,0.188,72,0.072,100
6421,6026,395,974,16,7000,867,1000,0.867,215,0.215,82,0.082,100
7290,6809,481,1191,17,8000,869,1000,0.869,217,0.217,86,0.086,100
8153,7584,569,1416,18,9000,863,1000,0.863,225,0.225,88,0.088,100
8986,8325,661,1675,19,10000,833,1000,0.833,259,0.259,92,0.092,100
9831,9072,759,1928,20,11000,845,1000,0.845,253,0.253,98,0.098,100
10656,9783,873,2217,21,12000,825,1000,0.825,289,0.289,114,0.114,100
11448,10461,987,2539,22,13000,792,1000,0.792,322,0.322,114,0.114,100
12248,11144,1104,2856,23,14000,800,1000,0.8,317,0.317,117,0.117,100
13032,11810,1222,3190,24,15000,784,1000,0.784,334,0.334,118,0.118,100
13825,12488,1337,3512,25,16000,793,1000,0.793,322,0.322,115,0.115,100
14609,13145,1464,3855,26,17000,784,1000,0.784,343,0.343,127,0.127,100
15382,13791,1591,4209,27,18000,773,1000,0.773,354,0.354,127,0.127,100
16139,14419,1720,4581,28,19000,757,1000,0.757,372,0.372,129,0.129,100
16890,15027,1863,4973,29,20000,751,1000,0.751,392,0.392,143,0.143,100
17643,15634,2009,5366,30,21000,753,1000,0.753,393,0.393,146,0.146,100
18371,16224,2147,5776,31,22000,728,1000,0.728,410,0.41,138,0.138,100
19116,16822,2294,6178,32,23000,745,1000,0.745,402,0.402,147,0.147,100
19856,17425,2431,6575,33,24000,740,1000,0.74,397,0.397,137,0.137,100
20584,18019,2565,6981,34,25000,728,1000,0.728,406,0.406,134,0.134,100
21330,18642,2688,7358,35,26000,746,1000,0.746,377,0.377,123,0.123,100
22021,19199,2822,7801,36,27000,691,1000,0.691,443,0.443,134,0.134,100
22736,19757,2979,8243,37,28000,715,1000,0.715,442,0.442,157,0.157,100
23418,20284,3134,8716,38,29000,682,1000,0.682,473,0.473,155,0.155,100
24106,20809,3297,9191,39,30000,688,1000,0.688,475,0.475,163,0.163,100
24800,21358,3442,9642,40,31000,694,1000,0.694,451,0.451,145,0.145,100
25467,21870,3597,10130,41,32000,667,1000,0.667,488,0.488,155,0.155,100
26176,22435,3741,10565,42,33000,709,1000,0.709,435,0.435,144,0.144,100
26866,22984,3882,11016,43,34000,690,1000,0.69,451,0.451,141,0.141,100
27554,23544,4010,11456,44,35000,688,1000,0.688,440,0.44,128,0.128,100
28252,24098,4154,11902,45,36000,698,1000,0.698,446,0.446,144,0.144,100
28911,24602,4309,12398,46,37000,659,1000,0.659,496,0.496,155,0.155,100
29558,25080,4478,12920,47,38000,647,1000,0.647,522,0.522,169,0.169,100
30235,25616,4619,13384,48,39000,677,1000,0.677,464,0.464,141,0.141,100
30884,26116,4768,13884,49,40000,649,1000,0.649,500,0.5,149,0.149,100
31518,26589,4929,14411,50,41000,634,1000,0.634,527,0.527,161,0.161,100
32154,27065,5089,14935,51,42000,636,1000,0.636,524,0.524,160,0.16,100
32800,27554,5246,15446,52,43000,646,1000,0.646,511,0.511,157,0.157,100
33449,28061,5388,15939,53,44000,649,1000,0.649,493,0.493,142,0.142,100
34113,28589,5524,16411,54,45000,664,1000,0.664,472,0.472,136,0.136,100
34766,29104,5662,16896,55,46000,653,1000,0.653,485,0.485,138,0.138,100
35394,29556,5838,17444,56,47000,628,1000,0.628,548,0.548,176,0.176,100
35991,29982,6009,18018,57,48000,597,1000,0.597,574,0.574,171,0.171,100
36631,30469,6162,18531,58,49000,640,1000,0.64,513,0.513,153,0.153,100
37251,30928,6323,19072,59,50000,620,1000,0.62,541,0.541,161,0.161,100
37889,31422,6467,19578,60,51000,638,1000,0.638,506,0.506,144,0.144,100
38520,31886,6634,20114,61,52000,631,1000,0.631,536,0.536,167,0.167,100
39110,32300,6810,20700,62,53000,590,1000,0.59,586,0.586,176,0.176,100
39702,32716,6986,21284,63,54000,592,1000,0.592,584,0.584,176,0.176,100
40288,33122,7166,21878,64,55000,586,1000,0.586,594,0.594,180,0.18,100
40879,33549,7330,22451,65,56000,591,1000,0.591,573,0.573,164,0.164,100
41448,33943,7505,23057,66,57000,569,1000,0.569,606,0.606,175,0.175,100
42047,34380,7667,23620,67,58000,599,1000,0.599,563,0.563,162,0.162,100
42662,34856,7806,24144,68,59000,615,1000,0.615,524,0.524,139,0.139,100
43237,35272,7965,24728,69,60000,575,1000,0.575,584,0.584,159,0.159,100
43841,35735,8106,25265,70,61000,604,1000,0.604,537,0.537,141,0.141,100
44408,36119,8289,25881,71,62000,567,1000,0.567,616,0.616,183,0.183,100
44951,36472,8479,26528,72,63000,543,1000,0.543,647,0.647,190,0.19,100
45523,36858,8665,27142,73,64000,572,1000,0.572,614,0.614,186,0.186,100
46102,37259,8843,27741,74,65000,579,1000,0.579,599,0.599,178,0.178,100
46690,37693,8997,28307,75,66000,588,1000,0.588,566,0.566,154,0.154,100
47290,38123,9167,28877,76,67000,600,1000,0.6,570,0.57,170,0.17,100
47871,38537,9334,29463,77,68000,581,1000,0.581,586,0.586,167,0.167,100
48424,38931,9493,30069,78,69000,553,1000,0.553,606,0.606,159,0.159,100
48980,39291,9689,30709,79,70000,556,1000,0.556,640,0.64,196,0.196,100
49550,39708,9842,31292,80,71000,570,1000,0.57,583,0.583,153,0.153,100
50089,40068,10021,31932,81,72000,539,1000,0.539,640,0.64,179,0.179,100
50637,40455,10182,32545,82,73000,548,1000,0.548,613,0.613,161,0.161,100
51184,40836,10348,33164,83,74000,547,1000,0.547,619,0.619,166,0.166,100
51758,41237,10521,33763,84,75000,574,1000,0.574,599,0.599,173,0.173,100
52314,41620,10694,34380,85,76000,556,1000,0.556,617,0.617,173,0.173,100
52836,41951,10885,35049,86,77000,522,1000,0.522,669,0.669,191,0.191,100
53404,42362,11042,35638,87,78000,568,1000,0.568,589,0.589,157,0.157,100
53933,42718,11215,36282,88,79000,529,1000,0.529,644,0.644,173,0.173,100
54459,43082,11377,36918,89,80000,526,1000,0.526,636,0.636,162,0.162,100
55004,43457,11547,37543,90,81000,545,1000,0.545,625,0.625,170,0.17,100
55535,43816,11719,38184,91,82000,531,1000,0.531,641,0.641,172,0.172,100
56065,44162,11903,38838,92,83000,530,1000,0.53,654,0.654,184,0.184,100
56553,44472,12081,39528,93,84000,488,1000,0.488,690,0.69,178,0.178,100
57061,44794,12267,40206,94,85000,508,1000,0.508,678,0.678,186,0.186,100
57590,45169,12421,40831,95,86000,529,1000,0.529,625,0.625,154,0.154,100
58088,45477,12611,41523,96,87000,498,1000,0.498,692,0.692,190,0.19,100
58602,45840,12762,42160,97,88000,514,1000,0.514,637,0.637,151,0.151,100
59136,46218,12918,42782,98,89000,534,1000,0.534,622,0.622,156,0.156,100
59688,46608,13080,43392,99,90000,552,1000,0.552,610,0.61,162,0.162,100
60225,46955,13270,44045,100,91000,537,1000,0.537,653,0.653,190,0.19,100
60741,47305,13436,44695,101,92000,516,1000,0.516,650,0.65,166,0.166,100
61266,47664,13602,45336,102,93000,525,1000,0.525,641,0.641,166,0.166,100
61762,47993,13769,46007,103,94000,496,1000,0.496,671,0.671,167,0.167,100
62293,48364,13929,46636,104,95000,531,1000,0.531,629,0.629,160,0.16,100
62819,48731,14088,47269,105,96000,526,1000,0.526,633,0.633,159,0.159,100
63300,49055,14245,47945,106,97000,481,1000,0.481,676,0.676,157,0.157,100
63794,49370,14424,48630,107,98000,494,1000,0.494,685,0.685,179,0.179,100
64323,49730,14593,49270,108,99000,529,1000,0.529,640,0.64,169,0.169,100
64832,50037,14795,49963,109,100000,509,1000,0.509,693,0.693,202,0.202,100
65346,50387,14959,50613,110,101000,514,1000,0.514,650,0.65,164,0.164,100
65818,50659,15159,51341,111,102000,472,1000,0.472,728,0.728,200,0.2,100
66331,51011,15320,51989,112,103000,513,1000,0.513,648,0.648,161,0.161,100
66814,51310,15504,52690,113,104000,483,1000,0.483,701,0.701,184,0.184,100
67303,51630,15673,53370,114,105000,489,1000,0.489,680,0.68,169,0.169,100
67816,51985,15831,54015,115,106000,513,1000,0.513,645,0.645,158,0.158,100
68309,52297,16012,54703,116,107000,493,1000,0.493,688,0.688,181,0.181,100
68795,52616,16179,55384,117,108000,486,1000,0.486,681,0.681,167,0.167,100
69282,52934,16348,56066,118,109000,487,1000,0.487,682,0.682,169,0.169,100
69771,53264,16507,56736,119,110000,489,1000,0.489,670,0.67,159,0.159,100
70260,53576,16684,57424,120,111000,489,1000,0.489,688,0.688,177,0.177,100
70759,53923,16836,58077,121,112000,499,1000,0.499,653,0.653,152,0.152,100
71240,54226,17014,58774,122,113000,481,1000,0.481,697,0.697,178,0.178,100
71716,54534,17182,59466,123,114000,476,1000,0.476,692,0.692,168,0.168,100
71869,54638,17231,59660,124,114298,153,298,0.5134228187919463,194,0.6510067114093959,49,0.1644295302013423,100
